noun	
abbAyi	
*abbAyi	n number eka parsarg 0 
*abbAyI	n number eka parsarg I 
-	n number eka parsarg gA 
*abbAyigAdu	n number eka parsarg gAdu 
*abbAyigawweV	n number eka parsarg gawweV 
*abbAyivAdu	n number eka parsarg vAdu 
*abbAyAyana	n number eka parsarg Ayana 
*abbAyivAru	n number eka parsarg vAru 
*abbAyixi	n number eka parsarg xi 
*abbAyivi/abbAyiy/abbAyiyyi	n number eka parsarg vi 
*abbAyigAru	n number eka parsarg gAru 
*abbAyini/abbAyinu	n number eka parsarg nu 
*abbAyivi/abbAyivu	n number eka parsarg vu 
*abbAyiyoVkka	n number eka parsarg yoVkka 
*abbAyi	n number eka parsarg obl 
*abbAyini/abbAyinu	n number eka parsarg ni 
*abbAyiki/abbAyiku	n number eka parsarg ki 
*abbAyiwo/abbAyiwoda/abbAyiwoti	n number eka parsarg wo 
abbAyilo/abbAyilona/*abbAyilopala	n number eka parsarg lo 
*abbAyiloni/abbAyilopali/abbAyiyaMxali	n number eka parsarg loni 
*abbAyimIxa	n number eka parsarg mIxa 
*abbAyina	n number eka parsarg na 
abbAyiniMci/abbAyinuMci/*abbAyinuMdi	n number eka parsarg niMci 
*abbAyixvArA/abbAyixvAra	n number eka parsarg xvArA 
*abbAyivalana/abbAyivalla	n number eka parsarg valana 
abbAyice/*abbAyicewa	n number eka parsarg batti 
*abbAyiwopAtu/abbAyiwobAtu	n number eka parsarg ce 
*abbAyiwokUdi/abbAyiwokUda/abbAyiwokUdA/abbAyiwogUdi/abbAyiwogUdA/abbAyiwogUda	n number eka parsarg wopAtu 
*abbAyikosaM/abbAyikE/abbAyikArWaM	n number eka parsarg wokUdi 
*abbAyikoVraku/abbAyikoVrYaku	n number eka parsarg kosaM 
*abbAyilonuMdi/abbAyilonuMci/abbAyiloniMci	n number eka parsarg koVraku 
*abbAyimIxanuMdi/abbAyimIxanuMci/abbAyimIxaniMci	n number eka parsarg lonuMdi 
*abbAyixAkA/abbAyixAka/abbAyivaraku	n number eka parsarg mIxanuMdi 
*abbAyinibatti	n number eka parsarg xAkA 
*abbAyimIxaki/abbAyimIxaku/abbAyimIxiki	n number eka parsarg varaku 
*abbAyixaggara/abbAyixaggira	n number eka parsarg mIxaki 
*abbAyivaxxa/abbAyoVxxa	n number eka parsarg xaggara 
*abbAyikAda	n number eka parsarg vaxxa 
*abbAyikeVxurugA/abbAyeVxurugA	n number eka parsarg kAda 
*abbAyimuMxu/abbAyikimuMxu	n number eka parsarg keVxurugA 
*abbAyiguriMci/abbAyiniguriMci/abbAyinigUrci	n number eka parsarg muMxu 
abbAyipE/*abbAyipEna/abbAyipEni	n number eka parsarg guriMci 
*abbAyipEki	n number eka parsarg pE 
*abbAyiguMdA/abbAyiguMda	n number eka parsarg pEki 
abbAyilA/abbAyilAga/*abbAyilAgA	n number eka parsarg guMdA 
*abbAyivaleV/abbAyivale/abbAyimAxiri/abbAyinipolina/abbAyinibolina/abbAyinipoli/abbAyiniboli	n number eka parsarg lA 
*abbAyikimalle/abbAyimalle/abbAyikimalleV/abbAyimalleV	n number eka parsarg vale 
*abbAyikUdA/abbAyinikUdA/abbAyinukUdA/abbAyigUdA/abbAyinigUdA/abbAyinugUdA	n number eka parsarg kimalle 
*abbAyixqRtilo/abbAyixruRtilo	n number eka parsarg kUdA 
*abbAyilekuMdA/abbAyinilekuMdA/abbAyilekuMda/abbAyileka	n number eka parsarg xqRtilo 
*abbAyikAkuMdA/abbAyinikAkuMdA/abbAyikAkuMda/abbAyikAka/abbAyigAkuMdA/abbAyinigAkuMdA/abbAyigAkuMda/abbAyigAka	n number eka parsarg lekuMdA 
*abbAyimoVxalukoVni/abbAyinimoVxalukoVni/abbAyinumoVxalukoVni	n number eka parsarg kAkuMdA 
*abbAyivEpu/abbAyivepu/abbAyikesi	n number eka parsarg moVxalukoVni 
abbAyipakka/abbAyiprakka/abbAyipakkana/*abbAyiprakkana/abbAyipakkani	n number eka parsarg vEpu 
abbAyipakkalo/*abbAyiprakkalo/abbAyipakkalona/abbAyipakkaloni	n number eka parsarg pakka 
*abbAyilopalaki/abbAyilopalaku/abbAyiloki/abbAyiloniki/abbAyilopaliki	n number eka parsarg pakkalo 
abbAyikiMxa/*abbAyikriMxa/abbAyikriMxane/abbAyikiMxane	n number eka parsarg lopalaki 
abbAyaduguna/*abbAyikaduguna	n number eka parsarg kiMxa 
abbAyikeVlla/*abbAyikalla	n number eka parsarg aduguna 
abbAyiveVnuka/*abbAyiveVnakAla/abbAyiveVnakAwala/abbAyiveVnakana	n number eka parsarg kalla 
abbAyiwaravAwa/abbAyiwarvAwa/*abbAyiwaruvAwa/abbAyiwaravAwana/abbAyiwarvAwana/abbAyiwaruvAwana	n number eka parsarg veVnuka 
abbAyeVxuruguMdA/*abbAyikeVxuruguMdA	n number eka parsarg waravAwa 
*abbAyimaXya/abbAyimaXyalo/abbAyimaXyana	n number eka parsarg eVxuruguMdA 
*abbAyinaduma/abbAyinadumana	n number eka parsarg maXya 
abbAyibaxulugA/abbAyibaxulu/abbAyikibaxulu/*abbAyikubaxulu	n number eka parsarg naduma 
*abbAyicotlo/abbAyicotulo/abbAyicotuna/abbAyicota	n number eka parsarg baxulugA 
*abbAyisWAnaMlo/abbAyiswAnaMlo	n number eka parsarg cotlo 
abbAyinerugA/abbAyikunerugA/*abbAyikinerugA	n number eka parsarg sWAnaMlo 
*abbAyiprakAraM/abbAyiprakAramu	n number eka parsarg nerugA 
*abbAyixaggaranuMdi/abbAyixaggaranuMci/abbAyixaggiranuMdi/abbAyixaggiranuMci	n number eka parsarg prakAraM 
*abbAyivaxxanuMdi/abbAyivaxxanuMci/abbAyivaxxaniMci	n number eka parsarg xaggaranuMdi 
*abbAyipakkanuMdi/abbAyipakkanuMci/abbAyipakkaniMci/abbAyipakkalonuMdi/abbAyipakkalonuMci/abbAyipakkaloniMci	n number eka parsarg vaxxanuMdi 
*abbAyilopalanuMdi/abbAyilopalanuMci/abbAyilopalaniMci	n number eka parsarg pakkanuMdi 
*abbAyibEtanuMdi/abbAyibEtanuMci/abbAyibEtaniMci	n number eka parsarg lopalanuMdi 
*abbAyipEnuMdi/abbAyipEnuMci/abbAyipEniMci	n number eka parsarg bEtanuMdi 
abbAyikiMxanuMdi/abbAyikiMxanuMci/abbAyikiMxaniMci/*abbAyikriMxanuMdi/abbAyikriMxanuMci/abbAyikriMxaniMci	n number eka parsarg pEnuMdi 
abbAyadugunuMdi/abbAyadugunuMci/*abbAyikadugunuMdi/abbAyikadugunuMci/abbAyikaduguniMci	n number eka parsarg kriMxanuMdi 
*abbAyimuMxunuMdi/abbAyimuMxunuMci/abbAyimuMxuniMci	n number eka parsarg adugunuMdi 
abbAyiveVnukanuMdi/*abbAyiveVnakAlanuMdi/abbAyiveVnakAwalanuMdi/abbAyiveVnakanuMdi/abbAyiveVnukanuMci/abbAyiveVnakAlanuMci/abbAyiveVnakAwalanuMci/abbAyiveVnakanuMci	n number eka parsarg muMxunuMdi 
abbAyeVxutinuMdi/*abbAyikeVxutinuMdi/abbAyikeVxutinuMci/abbAyeVxutinuMci	n number eka parsarg veVnukanuMdi 
*abbAyimaXyanuMdi/abbAyimaXyanuMci/abbAyimaXyalonuMdi/abbAyimaXyalonuMci	n number eka parsarg eVxutinuMdi 
*abbAyinadumanuMdi/abbAyinadumanuMci	n number eka parsarg maXyanuMdi 
*abbAyiwaravAwanuMdi/abbAyiwarvAwanuMdi/abbAyiwaravAwanuMci/abbAyiwarvAwanuMci	n number eka parsarg nadumanuMdi 
*abbAyicotlonuMdi/abbAyicotunuMdi/abbAyicotlonuMci/abbAyicotunuMci	n number eka parsarg waravAwanuMdi 
abbAyisWAnaMnuMdi/*abbAyisWAnamunuMdi/abbAyisWAnaMnuMci/abbAyisWAnamunuMci/abbAyisWAnaMlonuMdi/abbAyisWAnamulonuMdi/abbAyisWAnaMlonuMci/abbAyiswAnamulonuMci	n number eka parsarg cotlonuMdi 
abbAyaMxu/abbAyinaMxu/*abbAyiyaMxu	n number eka parsarg sWAnaMnuMdi 
*abbAyaMte/abbAyaMteV	n number eka parsarg aMxu 
*abbAyikaMteV/abbAyikaMte/abbAyikanna/abbAyikannA	n number eka parsarg aMte 
*abbAyEna/abbAyayina	n number eka parsarg kaMteV 
*abbAyipAti	n number eka parsarg Ena 
*abbAyilAMti/abbAyilAti	n number eka parsarg pAti 
*abbAyigAnI/abbAyikAnI	n number eka parsarg lAMti 
*abbAyigA	n number eka parsarg gAni 
*abbAyilu	n number eka parsarg gA 
*abbAyilU/AbbAyillArA	n number bahu parsarg 0 
-	n number bahu parsarg I 
*abbAyilagAdu/abbAyilugA	n number bahu parsarg gA 
*abbAyilagawweV	n number bahu parsarg gAdu 
*abbAyilavAdu/abbAyilodu	n number bahu parsarg gawweV 
*abbAyilAyana	n number bahu parsarg vAdu 
*abbAyilavAru/abbAyiloru	n number bahu parsarg Ayana 
*abbAyilaxi/abbAyilxi	n number bahu parsarg vAru 
*abbAyilavi/abbAyiliy/abbAyiliyyi	n number bahu parsarg xi 
*abbAyilugAru	n number bahu parsarg vi 
*abbAyilaM/abbAyilamu	n number bahu parsarg gAru 
*abbAyilu	n number bahu parsarg nu 
*abbAyilayoVkka	n number bahu parsarg vu 
*abbAyila	n number bahu parsarg yoVkka 
*abbAyilani/abbAyilni/abbAyilanu/abbAyilnu	n number bahu parsarg obl 
*abbAyilaki/abbAyilaku	n number bahu parsarg ni 
*abbAyilawo/abbAyilwo/abbAyilawoda/abbAyilawoti/abbAyilwoti/abbAyilwoda	n number bahu parsarg ki 
abbAyilalo/abbAyillo/abbAyilalona/abbAyillona   -- in singular, lopala is given. Here not given	n number bahu parsarg wo 
abbAyilaloni/abbAyilayaMxali/abbAyilloni	n number bahu parsarg lo 
*abbAyilamIxa	n number bahu parsarg loni 
*abbAyilana	n number bahu parsarg mIxa 
abbAyilaniMci/abbAyilniMci/abbAyilanuMci/abbAyilnuMci/*abbAyilanuMdi/abbAyilnuMdi	n number bahu parsarg na 
*abbAyilaxvArA/abbAyilaxvAra	n number bahu parsarg niMci 
*abbAyilavalana/abbAyilavalla	n number bahu parsarg xvArA 
*abbAyilacewa/abbAyilcewa/abbAyilace/abbAyilce	n number bahu parsarg valana 
*abbAyilawopAtu/abbAyilwopAtu/abbAyilawobAtu/abbAyilwobAtu	n number bahu parsarg batti 
*abbAyilawokUdi/abbAyilwokUdi/abbAyilawokUdA/abbAyilawogUdi/abbAyilwogUdi/abbAyilawogUdA/abbAyilwogUdA	n number bahu parsarg ce 
*abbAyilakosaM/abbAyilakE/abbAyilakArWaM	n number bahu parsarg wopAtu 
*abbAyilakoVraku/abbAyilakoVrYaku	n number bahu parsarg wokUdi 
*abbAyilalonuMdi/abbAyilalonuMci/abbAyillonuMdi/abbAyillonuMci/abbAyilloniMci/abbAyilaloniMci	n number bahu parsarg kosaM 
*abbAyilamIxanuMdi/abbAyilamIxanuMci/abbAyilamIxaniMci	n number bahu parsarg koVraku 
*abbAyilaxAkA/abbAyilaxAka/abbAyilavaraku	n number bahu parsarg lonuMdi 
*abbAyilabatti	n number bahu parsarg mIxanuMdi 
*abbAyilamIxaki/abbAyilamIxaku/abbAyilamIxiki	n number bahu parsarg xAkA 
*abbAyilaxaggara/abbAyilaxaggira	n number bahu parsarg varaku 
*abbAyilavaxxa/abbAyiloVxxa	n number bahu parsarg mIxaki 
*abbAyilakAda	n number bahu parsarg xaggara 
abbAyileVxurugA/*abbAyilakeVxurugA	n number bahu parsarg vaxxa 
*abbAyilamuMxu	n number bahu parsarg kAda 
*abbAyilaguriMci/abbAyilagUrci/abbAyilanuguriMci/abbAyilanigUrci	n number bahu parsarg keVxurugA 
abbAyilapE/abbAyilapEni/*abbAyilapEna	n number bahu parsarg muMxu 
*abbAyilapEki	n number bahu parsarg guriMci 
*abbAyilaguMdA	n number bahu parsarg pE 
abbAyilalA/abbAyillA/abbAyilalAga/abbAyillAga/*abbAyillAgA	n number bahu parsarg pEki 
*abbAyilavale/abbAyilavaleV/abbAyilamAxiri/abbAyilapoli/abbAyilabolina	n number bahu parsarg guMdA 
*abbAyilakumalle/abbAyilakumalleV	n number bahu parsarg lA 
*abbAyilukUdA/abbAyilugUdA/abbAyilugUda/abbAyilkUda	n number bahu parsarg vale 
*abbAyilaxqRtilo/abbAyilaxruRtilo	n number bahu parsarg kimalle 
*abbAyilulekuMdA/abbAyillekuMdA/abbAyiluleka	n number bahu parsarg kUdA 
*abbAyilukAkuMdA/abbAyilukAkuMda/abbAyilukAka/abbAyilugAkuMdA/abbAyilugAkuMda/abbAyilugAka	n number bahu parsarg xqRtilo 
*abbAyilumoVxalukoVni/abbAyilanumoVxalukoVni	n number bahu parsarg lekuMdA 
*abbAyilavEpu/abbAyilavepu/abbAyilakesi	n number bahu parsarg kAkuMdA 
abbAyilapakka/abbAyilapakkana/abbAyilaprakka/*abbAyilaprakkana	n number bahu parsarg moVxalukoVni 
abbAyilapakkalo/*abbAyilaprakkalo	n number bahu parsarg vEpu 
abbAyilaloniki/abbAyilaloki/*abbAyilalopalaki/abbAyilalopaliki/abbAyillopaliki/abbAyillopalaku	n number bahu parsarg pakka 
abbAyilakiMxa/*abbAyilakriMxa/abbAyilakriMxane/abbAyilakiMxane	n number bahu parsarg pakkalo 
abbAyiladuguna/*abbAyilakaduguna	n number bahu parsarg lopalaki 
abbAyilakeVlla/*abbAyilakalla	n number bahu parsarg kiMxa 
abbAyilaveVnuka/abbAyilaveVnaka/*abbAyilaveVnakAla/abbAyilaveVnukAla/abbAyilaveVnakAwala/abbAyilaveVnukAwala	n number bahu parsarg aduguna 
*abbAyilawaravAwa/abbAyilawarvAwa/abbAyilwaravAwa	n number bahu parsarg kalla 
abbAyileVxuruguMdA/*abbAyilakeVxuruguMdA	n number bahu parsarg veVnuka 
*abbAyilamaXya/abbAyilamaXyana/abbAyilamaXyalo	n number bahu parsarg waravAwa 
*abbAyilanaduma/abbAyilakinaduma	n number bahu parsarg eVxuruguMdA 
abbAyilabaxulugA/abbAyilakibaxulugA/abbAyilabaxulu/*abbAyilakibaxulu	n number bahu parsarg maXya 
*abbAyilacotlo/abbAyilacotulo	n number bahu parsarg naduma 
abbAyilasWAnaMlo/abbAyilaswAnaMlo/*abbAyilasWAnamulo	n number bahu parsarg baxulugA 
abbAyilanerugA/abbAyilakunerugA/*abbAyilakinerugA	n number bahu parsarg cotlo 
*abbAyilaprakAraM/abbAyilniprakAramu	n number bahu parsarg sWAnaMlo 
*abbAyilaxaggaranuMdi/abbAyilaxaggiranuMdi/abbAyilaxaggaranuMci/abbAyilaxaggiranuMci	n number bahu parsarg nerugA 
*abbAyilavaxxanuMdi/abbAyilavaxxanuMci/abbAyiloVxxanuMdi/abbAyiloVxxanuMci	n number bahu parsarg prakAraM 
*abbAyilapakkanuMdi/abbAyilapakkanuMci/abbAyilapakkalonuMdi/abbAyilapakkalonuMci	n number bahu parsarg xaggaranuMdi 
*abbAyilalopalanuMdi/abbAyillopalanuMdi/abbAyilalopalanuMci/abbAyillopalanuMci/abbAyillopalinuMdi/abbAyilalopalinuMci	n number bahu parsarg vaxxanuMdi 
*abbAyilabEtanuMdi/abbAyilabEtanuMci/abbAyilabEtaniMci	n number bahu parsarg pakkanuMdi 
*abbAyilapEnuMdi/abbAyilapEnuMci/abbAyilapEniMci	n number bahu parsarg lopalanuMdi 
abbAyilakiMxanuMdi/abbAyilakiMxanuMci/abbAyilakiMxaniMci/*abbAyilakriMxanuMdi/abbAyilakriMxanuMci/abbAyilakriMxaniMci	n number bahu parsarg bEtanuMdi 
*abbAyiladugunuMdi/abbAyiladugunuMci/abbAyiladuguniMci	n number bahu parsarg pEnuMdi 
*abbAyilamuMxunuMdi/abbAyilamuMxunuMci/abbAyilamuMxuniMci	n number bahu parsarg kriMxanuMdi 
abbAyilaveVnukanuMdi/abbAyilaveVnakanuMdi/*abbAyilaveVnakAlanuMdi/abbAyilaveVnakAlanuMci/abbAyilaveVnukanuMci/abbAyilaveVnakanuMci/abbAyilaveVnakAwalanuMdi/abbAyilaveVnakAwalanuMci	n number bahu parsarg adugunuMdi 
abbAyileVxutinuMdi/*abbAyilakeVxutinuMdi/abbAyileVxutinuMci/abbAyilakeVxutinuMci	n number bahu parsarg muMxunuMdi 
*abbAyilamaXyanuMdi/abbAyilamaXyanuMci/abbAyilamaXyaniMci/abbAyilamaXyalonuMdi/abbAyilamaXyalonuMci/abbAyilamaXyaloniMci	n number bahu parsarg veVnukanuMdi 
*abbAyilanadumanuMdi/abbAyilanadamanuMdi/abbAyilanadumanuMci/abbAyilanadamanuMci	n number bahu parsarg eVxutinuMdi 
*abbAyilawaravAwanuMdi/abbAyilawarvAwanuMdi/abbAyilawaravAwanuMci/abbAyilawarvAwanuMci	n number bahu parsarg maXyanuMdi 
abbAyilacotunuMdi/abbAyilacotanuMdi/abbAyilacotunuMci/abbAyilacotuniMci/abbAyilacotlonuMci/abbAyilacotloniMci/*abbAyilacotlonuMdi	n number bahu parsarg nadumanuMdi 
*abbAyilasWAnamunuMdi/abbAyilasWAnaMnuMdi/abbAyilasWAnamunuMci/abbAyilasWAnaMnuMci/abbAyilasWAnaMlonuMdi/abbAyilasWAnamulonuMdi/abbAyilasWAnaMlonuMci/abbAyilasWAnamulonuMci	n number bahu parsarg waravAwanuMdi 
*abbAyilayaMxu/abbAyilaMxu	n number bahu parsarg cotlonuMdi 
*abbAyilaMte/abbAyilaMteV	n number bahu parsarg sWAnaMnuMdi 
*abbAyilakaMteV/abbAyilakaMte/abbAyilakanna/abbAyilakannA	n number bahu parsarg aMxu 
*abbAyilEna/abbAyilayina	n number bahu parsarg aMte 
*abbAyilupAti	n number bahu parsarg kaMteV 
*abbAyillAMti/abbAyillAti	n number bahu parsarg Ena 
*abbAyilugAnI/abbAyilukAnI	n number bahu parsarg pAti 
*abbAyilugA	n number bahu parsarg lAMti 
	n number bahu parsarg gAni 
	n number bahu parsarg gA 
