noun	
bAludu	
*bAludu	n number eka parsarg 0 
bAludU/*bAludA	n number eka parsarg I 
*bAludigA	n number eka parsarg gA 
*bAludigAdu/bAludugAdu	n number eka parsarg gAdu 
*bAludigawweV/bAludugawweV	n number eka parsarg gawweV 
*bAludivAdu/bAludodu/bAludAdu	n number eka parsarg vAdu 
*bAludAyana	n number eka parsarg Ayana 
*bAludivAru/bAludoru/bAludAru	n number eka parsarg vAru 
*bAludixi/bAlunixi	n number eka parsarg xi 
*bAludivi/bAludiy/bAludiyyi/bAlunivi	n number eka parsarg vi 
*bAludugAru/bAludigAru	n number eka parsarg gAru 
bAludunu/*bAludini/bAludanu	n number eka parsarg nu 
bAluduvu/*bAludivi/bAludavu/bAlunivi	n number eka parsarg vu 
bAluniyoVkka/*bAludiyoVkka	n number eka parsarg yoVkka 
bAluni/*bAludi	n number eka parsarg obl 
*bAludini/bAluNNi/bAluni	n number eka parsarg ni 
*bAludiki/bAluniki/bAlunaku	n number eka parsarg ki 
*bAludiwo/bAludiwoda/bAludiwoti/bAluniwo/bAluniwoda/bAluniwoti	n number eka parsarg wo 
bAludilo/bAludilona/bAlunilo/bAlunilona/bAlunilopala/*bAludilopala	n number eka parsarg lo 
bAluniloni/bAludiloni/*bAludilopali/bAludiyaMxali/bAlunilopali	n number eka parsarg loni 
*bAludimIxa/bAlunimIxa	n number eka parsarg mIxa 
*bAludina	n number eka parsarg na 
bAludiniMci/bAludinuMci/*bAludinuMdi/bAluNNiMci/bAluNNuMci/bAluNNuMdi	n number eka parsarg niMci 
*bAludixvArA/bAlunixvArA/bAludixvAra/bAlunixvAra	n number eka parsarg xvArA 
*bAludivalana/bAludivalla/bAlunivalana/bAlunivalla	n number eka parsarg valana 
*bAludinibatti/bAlunibatti	n number eka parsarg batti 
bAludice/*bAludicewa/bAlunice/bAlunicewa	n number eka parsarg ce 
*bAludiwopAtu/bAluniwopAtu/bAludiwobAtu/bAluniwobAtu	n number eka parsarg wopAtu 
*bAludiwokUdi/bAludiwokUda/bAludiwokUdA/bAluniwokUdA/bAluniwogUdi/bAluniwogUdA/bAluniwokUdi/bAludiwogUdi/bAludiwogUdA	n number eka parsarg wokUdi 
*bAludikosaM/bAludikE/bAlunikosaM/bAlunikE/bAlunikosamu/bAludikosamu/bAludArWaM	n number eka parsarg kosaM 
*bAludikoVraku/bAludikoVrYaku/bAlunikoraku	n number eka parsarg koVraku 
*bAludilonuMdi/bAludilonuMci/bAludiloniMci/bAlunilonuMdi/bAlunilonuMci/bAluniloniMci	n number eka parsarg lonuMdi 
*bAludimIxanuMdi/bAludimIxanuMci/bAludimIxaniMci/bAlunimIxanuMdi/bAlunimIxanuMci	n number eka parsarg mIxanuMdi 
*bAludixAkA/bAludixAka/bAlunixAka/bAlunixAkA/bAludivaraku/bAlunivaraku	n number eka parsarg xAkA 
*bAludimIxaki/bAludimIxaku/bAludimIxiki/bAlunimIxaku	n number eka parsarg varaku 
*bAludixaggara/bAludixaggira/bAlunixaggara	n number eka parsarg mIxaki 
*bAludivaxxa/bAludoVxxa/bAludiyoVxxa/bAluniyoVxxa/bAlunivaxxa	n number eka parsarg xaggara 
*bAludikAda/bAlunikAda	n number eka parsarg vaxxa 
*bAludikeVxurugA/bAludeVxurugA/bAlunikeVxurugA	n number eka parsarg kAda 
*bAludimuMxu/bAlunimuMxu	n number eka parsarg keVxurugA 
*bAludiguriMci/bAludiniguriMci/bAluNNiguriMci/bAluNNigUrci/bAluniguriMci/bAlunigUrci	n number eka parsarg muMxu 
bAludipE/*bAludipEna/bAludipEni/bAlunipEna/bAlunipEki/bAlunipEni	n number eka parsarg guriMci 
*bAludipEki/bAlunipEki	n number eka parsarg pE 
*bAludiguMdA/bAluniguMdA	n number eka parsarg pEki 
bAludilA/bAludilAga/*bAludilAgA/bAlunilA/bAlunilAgA/bAlunilAga	n number eka parsarg guMdA 
*bAludivale/bAludimAxiri/bAludinipoli/bAluNNipolina/bAludinibolina/bAlunipolina/bAlunivaleV/bAlunimAxiri/bAlunibolina	n number eka parsarg lA 
*bAludikimalle/bAludikimalleV/bAlunikimalle/bAlunikimalleV	n number eka parsarg vale 
*bAludukUdA/bAludinikUdA/bAludugUdA/bAludinigUdA/bAlunigUdA/bAlunikUdA	n number eka parsarg kimalle 
*bAludixqRtilo/bAludixruRtilo/bAlunixqRtilo	n number eka parsarg kUdA 
*bAludulekuMdA/bAludinilekuMdA/bAludulekuMda/bAludinilekuMda	n number eka parsarg xqRtilo 
*bAludukAkuMdA/bAludinikAkuMdA/bAludukAkuMda/bAludugAkuMdA/bAludugAka/bAludugAkuMda	n number eka parsarg lekuMdA 
*bAludumoVxalukoVni/bAludimoVxalukoVni/bAludinimoVxalukoVni/bAludnimoVxalukoVni/bAlunimoVxalukoVni	n number eka parsarg kAkuMdA 
*bAludivEpu/bAludivepu/bAludikesi/bAlunikesi/bAlunivepu/bAlunivEpu	n number eka parsarg moVxalukoVni 
bAludipakka/bAludiprakka/bAludipakkana/*bAludiprakkana/bAludipakkani/bAlunipakka/bAlunipakkana/bAluniprakkana	n number eka parsarg vEpu 
bAludipakkalo/*bAludiprakkalo/bAlunipakkalo/bAluniprakkalo/bAludipakkalona/bAludipakkaloni	n number eka parsarg pakka 
*bAludiloki/bAludiloniki/bAluniloki/bAluniloniki/bAlunilopalaki/bAlunilopalaku/bAludilopalaki/bAludilopalaku/bAludilopaliki/bAlunilopaliki	n number eka parsarg pakkalo 
bAludikiMxa/*bAludikriMxa/bAlunikiMxa/bAlunikriMxa/bAludikriMxana/bAludikiMxana/bAlunikiMxana/bAlunikriMxana	n number eka parsarg lopalaki 
bAludaduguna/*bAludikaduguna/bAlunikaduguna/bAlunaduguna	n number eka parsarg kiMxa 
bAludikeVlla/*bAludikalla/bAlunikalla/bAlunikeVlla	n number eka parsarg aduguna 
bAludiveVnuka/*bAludiveVnakAla/bAludiveVnakAwala/bAludiveVnakana/bAluniveVnaka/bAluniveVnuka	n number eka parsarg kalla 
bAludiwaravAwa/bAludiwarvAwa/*bAludiwaruvAwa/bAludiwaravAwana/bAludiwarvAwana/bAludiwaruvAwana/bAluniwaruvAwa	n number eka parsarg veVnuka 
bAludeVxuruguMdA/*bAludikeVxuruguMdA/bAlunikeVxuruguMdA	n number eka parsarg waravAwa 
*bAludimaXya/bAludimaXyalo/bAludimaXyana/bAlunimaXya	n number eka parsarg eVxuruguMdA 
*bAludinaduma/bAludinadumana/bAluninadumana	n number eka parsarg maXya 
bAludibaxulugA/bAludibaxulu/*bAludikibaxulu/bAlunikibaxulu/bAlunibaxulu	n number eka parsarg naduma 
*bAludicotlo/bAludicotulo/bAludicotuna/bAludicota/bAlunicota	n number eka parsarg baxulugA 
*bAludisWAnaMlo/bAludiswAnaMlo/bAlunisWAnaMlo/bAlunisWAnamulo	n number eka parsarg cotlo 
bAludinerugA/bAluninerugA/*bAludikinerugA/bAlunikinerugA	n number eka parsarg sWAnaMlo 
*bAludiprakAraM/bAluniprakAramu	n number eka parsarg nerugA 
*bAludixaggaranuMdi/bAludixaggaranuMci/bAludixaggiranuMdi/bAludixaggiranuMci	n number eka parsarg prakAraM 
*bAludivaxxanuMdi/bAludivaxxanuMci/bAludivaxxaniMci/bAlunivaxxanuMdi	n number eka parsarg xaggaranuMdi 
*bAludipakkanuMdi/bAludipakkanuMci/bAludipakkaniMci/bAlunipakkanuMdi/bAludipakkalonuMdi/bAludipakkalonuMci/bAludipakkaloniMci/bAlunipakkalonuMdi	n number eka parsarg vaxxanuMdi 
*bAludilopalanuMdi/bAlunilopalanuMdi/bAludilopalanuMci/bAludilopalanuMci/bAludilopalaniMci	n number eka parsarg pakkanuMdi 
*bAludibEtanuMdi/bAludibEtanuMci/bAludibEtaniMci/bAlunibEtanuMdi	n number eka parsarg lopalanuMdi 
*bAludipEnuMdi/bAludipEnuMci/bAludipEniMci/bAlunipEnuMdi	n number eka parsarg bEtanuMdi 
bAludikiMxanuMdi/bAludikiMxanuMci/bAludikiMxaniMci/bAlunikiMxanuMdi/*bAludikriMxanuMdi/bAludikriMxanuMci/bAludikriMxaniMci/bAlunikriMxanuMdi	n number eka parsarg pEnuMdi 
bAludadugunuMdi/bAludadugunuMci/*bAludikadugunuMdi/bAludikadugunuMci/bAludikaduguniMci/bAlunikadugunuMdi	n number eka parsarg kriMxanuMdi 
*bAludimuMxunuMdi/bAludimuMxunuMci/bAludimuMxuniMci/bAlunimuMxunuMdi	n number eka parsarg adugunuMdi 
bAludiveVnukanuMdi/*bAludiveVnakAlanuMdi/bAludiveVnakAwalanuMdi/bAludiveVnakanuMdi/bAluniveVnukanuMdi/bAludiveVnukanuMci/bAludiveVnakAlanuMci/bAludiveVnakAwalanuMci/bAludiveVnakanuMci/bAluniveVnukanuMci	n number eka parsarg muMxunuMdi 
bAludeVxutinuMdi/*bAludikeVxutinuMdi/bAludikeVxutinuMci/bAludeVxutinuMci/bAlunikeVxutinuMdi	n number eka parsarg veVnukanuMdi 
*bAludimaXyanuMdi/bAludimaXyanuMci/bAlunimaXyanuMdi/bAludimaXyalonuMdi/bAludimaXyalonuMci/bAlunimaXyalonuMdi	n number eka parsarg eVxutinuMdi 
*bAludinadumanuMdi/bAludinadumanuMci/bAluninadumanuMdi	n number eka parsarg maXyanuMdi 
*bAludiwaravAwanuMdi/bAludiwarvAwanuMdi/bAludiwaravAwanuMci/bAludiwarvAwanuMci/bAluniwaruvAwanuMdi	n number eka parsarg nadumanuMdi 
*bAludicotlonuMdi/bAludicotunuMdi/bAludicotlonuMci/bAludicotunuMci/bAlunicotunuMdi	n number eka parsarg waravAwanuMdi 
bAludisWAnaMnuMdi/*bAludisWAnamunuMdi/bAludisWAnaMnuMci/bAludisWAnamunuMci/bAlunisWAnamunuMdi/bAludisWAnaMlonuMdi/bAludisWAnamulonuMdi/bAlunisWAnamulonuMdi/bAludisWAnaMlonuMci/bAludiswAnamulonuMci/bAlunisWAnamulonuMci	n number eka parsarg cotlonuMdi 
bAludaMxu/bAlunaMxu/*bAludiyaMxu/bAluniyaMxu	n number eka parsarg sWAnaMnuMdi 
*bAludaMte/bAludaMteV	n number eka parsarg aMxu 
*bAludikaMteV/bAludikaMte/bAlunikaMteV/bAlunikaMte/bAlunikanna/bAlunikannA	n number eka parsarg aMte 
*bAludEna/bAludayina	n number eka parsarg kaMteV 
*bAludupAti	n number eka parsarg Ena 
*bAludulAMti/bAludulAti	n number eka parsarg pAti 
*bAludugAnI/bAludukAnI	n number eka parsarg lAMti 
*bAludugA	n number eka parsarg gAni 
*bAluru	n number eka parsarg gA 
*bAlurU/bAluralArA	n number bahu parsarg 0 
-	n number bahu parsarg I 
*bAluragAdu	n number bahu parsarg gA 
*bAluragawweV	n number bahu parsarg gAdu 
*bAluravAdu/bAlurodu	n number bahu parsarg gawweV 
*bAlurAyana	n number bahu parsarg vAdu 
*bAluravAru/bAluroru	n number bahu parsarg Ayana 
*bAluraxi/bAlulxi	n number bahu parsarg vAru 
*bAluravi/bAlurivi/bAluriy	n number bahu parsarg xi 
*bAlurugAru	n number bahu parsarg vi 
bAluramu/*bAluraM	n number bahu parsarg gAru 
*bAluru	n number bahu parsarg nu 
*bAlurayoVkka	n number bahu parsarg vu 
*bAlura	n number bahu parsarg yoVkka 
bAlurani/bAlurni/*bAluranu/bAlurnu	n number bahu parsarg obl 
bAluraki/*bAluraku	n number bahu parsarg ni 
*bAlurawo/bAlurwo/bAlurawoda/bAlurwoti/bAlurawoti/bAlurwoda	n number bahu parsarg ki 
*bAluralo/bAluralopala/bAluralona	n number bahu parsarg wo 
*bAluraloni/bAluralopali/bAlurayaMxali	n number bahu parsarg lo 
*bAluramIxa	n number bahu parsarg loni 
*bAlurana	n number bahu parsarg mIxa 
bAluraniMci/bAlurniMci/bAluranuMci/bAlurnuMci/*bAluranuMdi/bAlurnuMdi	n number bahu parsarg na 
*bAluraxvArA/bAluraxvAra	n number bahu parsarg niMci 
*bAluravalana/bAluravalla	n number bahu parsarg xvArA 
*bAluracewa/bAlurcewa/bAlurace/bAlurce	n number bahu parsarg valana 
*bAlurawopAtu/bAlurawobAtu	n number bahu parsarg batti 
*bAlurawokUdi/bAlurawogUdi/bAlurawokUdA/bAlurawogUdA	n number bahu parsarg ce 
*bAlurakosaM/bAlurakosamu/bAlurakE/bAlurArWaM	n number bahu parsarg wopAtu 
*bAlurakoVraku/bAlurakoVrYaku	n number bahu parsarg wokUdi 
*bAluralonuMdi/bAluralonuMci/bAlurlonuMdi/bAlurlonuMci/bAluraloniMci/bAluraloniMci	n number bahu parsarg kosaM 
*bAluramIxanuMdi/bAluramIxanuMci/bAluramIxaniMci	n number bahu parsarg koVraku 
*bAluraxAkA/bAluraxAka/bAluravaraku	n number bahu parsarg lonuMdi 
*bAlurinibatti	n number bahu parsarg mIxanuMdi 
*bAluramIxaki/bAluramIxaku/bAluramIxiki	n number bahu parsarg xAkA 
*bAluraxaggara/bAluraxaggira	n number bahu parsarg varaku 
*bAluravaxxa/bAluroVxxa	n number bahu parsarg mIxaki 
*bAlurakAda	n number bahu parsarg xaggara 
bAlureVxurugA/*bAlurakeVxurugA	n number bahu parsarg vaxxa 
*bAluramuMxu	n number bahu parsarg kAda 
*bAluraguriMci/bAluragUrci/bAluranuguriMci/bAluranigUrci	n number bahu parsarg keVxurugA 
bAlurapE/bAlurapEni/*bAlurapEna	n number bahu parsarg muMxu 
*bAlurapEki	n number bahu parsarg guriMci 
*bAluraguMdA	n number bahu parsarg pE 
bAluralA/bAluralA/bAluralAga/bAlurlAga/*bAlurulAgA	n number bahu parsarg pEki 
*bAluravale/bAluravaleV/bAluramAxiri/bAluranupolina/bAluranubolina/bAlurinipolina/bAlurinibolina	n number bahu parsarg guMdA 
*bAlurakumalle/bAlurakumalleV	n number bahu parsarg lA 
*bAlurukUdA/bAluranukUdA/bAlurugUdA/bAluranugUdA	n number bahu parsarg vale 
*bAluraxqRtilo/bAluraxruRtilo	n number bahu parsarg kimalle 
*bAlurulekuMdA/bAlurulekuMda/bAluruleka	n number bahu parsarg kUdA 
*bAlurukAkuMdA/bAlurukAkuMda/bAlurukAka/bAlurugAkuMdA/bAlurugAkuMda/bAlurugAka	n number bahu parsarg xqRtilo 
*bAlurumoVxalukoVni/bAluranumoVxalukoVni	n number bahu parsarg lekuMdA 
*bAluravEpu/bAluravepu/bAlurakesi	n number bahu parsarg kAkuMdA 
bAlurapakka/bAlurapakkana/*bAluraprakka/bAluraprakkana	n number bahu parsarg moVxalukoVni 
bAlurapakkalo/*bAluraprakkalo	n number bahu parsarg vEpu 
*bAluraloki/bAluraloniki/bAluralopalaki/bAluralopaliki/bAlurlopaliki/bAluralopalaku	n number bahu parsarg pakka 
bAlurakiMxa/*bAlurakriMxa/bAlurakriMxane/bAlurakiMxane	n number bahu parsarg pakkalo 
bAluraduguna/*bAlurakaduguna	n number bahu parsarg lopalaki 
bAlurakeVlla/*bAlurakalla	n number bahu parsarg kiMxa 
bAluraveVnuka/bAluraveVnaka/*bAluraveVnakAla/bAluraveVnukAla/bAluraveVnakAwala/bAluraveVnukAwala	n number bahu parsarg aduguna 
*bAlurawaravAwa/bAlurawarvAwa/bAlurwaravAwa	n number bahu parsarg kalla 
bAlureVxuruguMdA/*bAlurakeVxuruguMdA	n number bahu parsarg veVnuka 
*bAluramaXya/bAluramaXyana/bAluramaXyalo	n number bahu parsarg waravAwa 
*bAluranaduma/bAlurakinaduma	n number bahu parsarg eVxuruguMdA 
bAlurabaxulugA/bAlurakibaxulugA/bAlurabaxulu/*bAlurakibaxulu	n number bahu parsarg maXya 
*bAluracotlo/bAluracotulo	n number bahu parsarg naduma 
bAlurasWAnaMlo/bAluraswAnaMlo/*bAlurasWAnamulo	n number bahu parsarg baxulugA 
bAluranerugA/bAlurakunerugA/*bAlurakinerugA	n number bahu parsarg cotlo 
*bAluraprakAraM/bAluranubatti/bAlurabatti/bAluranibatti	n number bahu parsarg sWAnaMlo 
*bAluraxaggaranuMdi/bAluraxaggiranuMdi/bAluraxaggaranuMci/bAluraxaggiranuMci	n number bahu parsarg nerugA 
*bAluravaxxanuMdi/bAluravaxxanuMci	n number bahu parsarg prakAraM 
*bAlurapakkanuMdi/bAlurapakkanuMci/bAlurapakkalonuMdi/bAlurapakkalonuMci	n number bahu parsarg xaggaranuMdi 
*bAluralopalanuMdi/bAluralopalnuMdi/bAluralopalanuMci/bAluralopalnuMci/bAluralopalinuMdi/bAluralopalinuMci	n number bahu parsarg vaxxanuMdi 
*bAlurabEtanuMdi/bAlurabEtanuMci/bAlurabEtaniMci	n number bahu parsarg pakkanuMdi 
*bAlurapEnuMdi/bAlurapEnuMci/bAlurapEniMci	n number bahu parsarg lopalanuMdi 
bAlurakiMxanuMdi/bAlurakiMxanuMci/bAlurakiMxaniMci/*bAlurakriMxanuMdi/bAlurakriMxanuMci/bAlurakriMxaniMci	n number bahu parsarg bEtanuMdi 
*bAluradugunuMdi/bAluradugunuMci/bAluraduguniMci	n number bahu parsarg pEnuMdi 
*bAluramuMxunuMdi/bAluramuMxunuMci/bAluramuMxuniMci	n number bahu parsarg kriMxanuMdi 
bAluraveVnukanuMdi/bAluraveVnakanuMdi/*bAluraveVnakAlanuMdi/bAluraveVnakAlanuMci/bAluraveVnukanuMci/bAluraveVnakanuMci/bAluraveVnakAwalanuMdi/bAluraveVnakAwalanuMci	n number bahu parsarg adugunuMdi 
bAlureVxutinuMdi/*bAlurakeVxutinuMdi/bAlureVxutinuMci/bAlurakeVxutinuMci	n number bahu parsarg muMxunuMdi 
*bAluramaXyanuMdi/bAluramaXyanuMci/bAluramaXyaniMci/bAluramaXyalonuMdi/bAluramaXyalonuMci/bAluramaXyaloniMci	n number bahu parsarg veVnukanuMdi 
*bAluranadumanuMdi/bAluranadamanuMdi/bAluranadumanuMci/bAluranadamanuMci	n number bahu parsarg eVxutinuMdi 
*bAlurawaravAwanuMdi/bAlurawarvAwanuMdi/bAlurawaravAwanuMci/bAlurawarvAwanuMci	n number bahu parsarg maXyanuMdi 
bAluracotunuMci/bAluracotunuMdi/bAluracotlonuMci/*bAluracotlonuMdi/bAluracotulonuMci/bAluracotulonuMdi	n number bahu parsarg nadumanuMdi 
*bAlurasWAnamunuMdi/bAlurasWAnaMnuMdi/bAlurasWAnamunuMci/bAlurasWAnaMnuMci/bAlurasWAnaMlonuMdi/bAlurasWAnamulonuMdi/bAlurasWAnaMlonuMci/bAlurasWAnamulonuMci	n number bahu parsarg waravAwanuMdi 
*bAlurayaMxu/bAluraMxu	n number bahu parsarg cotlonuMdi 
*bAluraMte/bAluraMteV	n number bahu parsarg sWAnaMnuMdi 
*bAlurakaMteV/bAlurakaMte/bAlurakanna/bAlurakannA	n number bahu parsarg aMxu 
*bAlurEna/bAlurayina	n number bahu parsarg aMte 
*bAlurupAti	n number bahu parsarg kaMteV 
*bAlurulAMti/bAlurulAti	n number bahu parsarg Ena 
*bAlurugAnI/bAlurukAnI	n number bahu parsarg pAti 
*bAlurugA	n number bahu parsarg lAMti 
	n number bahu parsarg gAni 
	n number bahu parsarg gA 
