noun	
bonu	
*bonu	n number eka parsarg 0  case d
-	n number eka parsarg I 
-	n number eka parsarg gA 
*bonugAdu	n number eka parsarg gAdu  case d
*bonugawweV	n number eka parsarg gawweV  case d
*bonuvAdu	n number eka parsarg vAdu  case d
*bonAyana	n number eka parsarg Ayana  case d
*bonuvAru	n number eka parsarg vAru  case d
*bonuxi	n number eka parsarg xi  case d
*bonuvi/bonuy/boniy	n number eka parsarg vi  case d
*bonugAru	n number eka parsarg gAru  case d
*bonuni/bonunu	n number eka parsarg nu 
*bonuvu/bonuv	n number eka parsarg vu  case d
*bonuyoVkka	n number eka parsarg yoVkka 
*bonu	n number eka parsarg obl 
*bonuni/bonunu	n number eka parsarg ni 
*bonuki/bonuku	n number eka parsarg ki 
*bonuwo/bonuwoda/bonuwoti	n number eka parsarg wo 
*bonulo/bonulona/bonulopala	n number eka parsarg lo 
*bonuloni/bonulopali/bonunaMxali	n number eka parsarg loni 
*bonumIxa/bonumIxi	n number eka parsarg mIxa 
*bonuna	n number eka parsarg na 
bonuniMci/bonunuMci/*bonunuMdi	n number eka parsarg niMci 
*bonuxvArA/bonuxvAra	n number eka parsarg xvArA 
*bonuvalana/bonuvalla	n number eka parsarg valana 
*bonunubatti/bonunibatti	n number eka parsarg batti 
bonuce/*bonucewa	n number eka parsarg ce 
*bonuwopAtu	n number eka parsarg wopAtu 
*bonuwokUdi/bonuwokUda/bonuwokUdA/bonuwogUdi/bonuwogUda/bonuwogUdA	n number eka parsarg wokUdi 
*bonukosaM/bonukE/bonArWaM	n number eka parsarg kosaM 
*bonukoVraku/bonukoVrYaku	n number eka parsarg koVraku 
*bonulonuMdi/bonulonuMci/bonuloniMci	n number eka parsarg lonuMdi 
*bonumIxanuMdi/bonumIxanuMci/bonumIxaniMci	n number eka parsarg mIxanuMdi 
*bonuxAkA/bonuxAka	n number eka parsarg xAkA 
*bonuvaraku	n number eka parsarg varaku 
*bonumIxaki/bonumIxaku/bonumIxiki	n number eka parsarg mIxaki 
*bonuxaggara/bonuxaggira	n number eka parsarg xaggara 
*bonuvaxxa/bonoVxxa	n number eka parsarg vaxxa 
*bonukAda	n number eka parsarg kAda 
*bonukeVxurugA/boneVxurugA	n number eka parsarg keVxurugA 
*bonumuMxu	n number eka parsarg muMxu 
*bonuguriMci/bonuniguriMci/bonunigUrci	n number eka parsarg guriMci 
bonupE/*bonupEna/bonupEni	n number eka parsarg pE 
*bonupEki	n number eka parsarg pEki 
*bonuguMdA	n number eka parsarg guMdA 
bonulA/bonulAga/*bonulAgA	n number eka parsarg lA 
bonuvale/*bonuvaleV/bonumAxiri/bonunipolina/bonunibolina	n number eka parsarg vale 
bonukimalle/bonukumalle/*bonukimalleV/bonukimalle	n number eka parsarg kimalle 
*bonukUdA/bonunikUdA/bonunukUdA/bonugUdA/bonunigUdA	n number eka parsarg kUdA 
*bonuxqRtilo/bonuxruRtilo	n number eka parsarg xqRtilo 
*bonulekuMdA/bonunilekuMdA/bonulekuMda/bonunilekuMda	n number eka parsarg lekuMdA 
*bonukAkuMdA/bonunikAkuMdA/bonukAkuMda/bonukAka/bonugAka/bonugAkuMdA	n number eka parsarg kAkuMdA 
*bonumoVxalukoVni/bonunimoVxalukoVni/bonunumoVxalukoVni	n number eka parsarg moVxalukoVni 
*bonuvEpu/bonuvepu/bonukesi	n number eka parsarg vEpu 
bonupakka/*bonuprakka/bonupakkana/bonuprakkana/bonupakkani	n number eka parsarg pakka 
bonupakkalo/*bonuprakkalo/bonupakkalona/bonupakkaloni	n number eka parsarg pakkalo 
*bonulopalaki/bonulopalaku/bonulopaliki/bonuloki/bonloki/bonuloniki	n number eka parsarg lopalaki 
bonukiMxa/*bonukriMxa/bonukriMxana/bonukiMxana	n number eka parsarg kiMxa 
bonaduguna/*bonukaduguna	n number eka parsarg aduguna 
bonukeVlla/*bonukalla	n number eka parsarg kalla 
bonuveVnuka/bonuveVnaka/bonuveVnakAwala/*bonuveVnakAla/bonuveVnakana	n number eka parsarg veVnuka 
bonuwarvAwa/*bonuwaruvAwa/bonuwaravAwana/bonuwarvAwana/bonuwaruvAwana	n number eka parsarg waravAwa 
boneVxuruguMdA/*bonukeVxuruguMdA	n number eka parsarg eVxuruguMdA 
*bonumaXya/bonumaXyalo/bonumaXyana	n number eka parsarg maXya 
*bonunaduma/bonunadumana	n number eka parsarg naduma 
bonubaxulugA/bonubaxulu/*bonukibaxulu/bonukubaxulu	n number eka parsarg baxulugA 
*bonucotlo/bonucotulo/bonucotuna/bonucota	n number eka parsarg cotlo 
*bonusWAnaMlo/bonuswAnaMlo	n number eka parsarg sWAnaMlo 
bonunerugA/bonukunerugA/*bonukinerugA	n number eka parsarg nerugA 
*bonuprakAraM/bonuprakAramu	n number eka parsarg prakAraM 
*bonuxaggaranuMdi/bonuxaggaranuMci/bonuxaggiranuMdi/bonuxaggiranuMci	n number eka parsarg xaggaranuMdi 
*bonuvaxxanuMdi/bonuvaxxanuMci/bonuvaxxaniMci	n number eka parsarg vaxxanuMdi 
*bonupakkanuMdi/bonupakkanuMci/bonupakkaniMci/bonupakkalonuMdi/bonupakkalonuMci/bonupakkaloniMci	n number eka parsarg pakkanuMdi 
*bonulopalanuMdi/bonlopalanuMdi/bonulopalanuMci/bonlopalanuMci/bonulopalaniMci	n number eka parsarg lopalanuMdi 
*bonubEtanuMdi/bonubEtanuMci/bonubEtaniMci	n number eka parsarg bEtanuMdi 
*bonupEnuMdi/bonupEnuMci/bonupEniMci	n number eka parsarg pEnuMdi 
bonukiMxanuMdi/bonukiMxanuMci/bonukimIxaniMci/*bonukriMxanuMdi/bonukriMxanuMci/bonukriMxaniMci	n number eka parsarg kriMxanuMdi 
bonadugunuMdi/bonadugunuMci/*bonukadugunuMdi/bonukadugunuMci/bonukaduguniMci	n number eka parsarg adugunuMdi 
*bonumuMxunuMdi/bonumuMxunuMci/bonumuMxuniMci	n number eka parsarg muMxunuMdi 
bonuveVnukanuMdi/*bonuveVnakAlanuMdi/bonuveVnakAwalanuMdi/bonuveVnakanuMdi/bonuveVnukanuMci/bonuveVnakAlanuMci/bonuveVnakAwalanuMci/bonuveVnakanuMci	n number eka parsarg veVnukanuMdi 
boneVxutinuMdi/*bonukeVxutinuMdi/bonukeVxutinuMci/boneVxutinuMci/bonukeVxutiniMci/boneVxutiniMci	n number eka parsarg eVxutinuMdi 
*bonumaXyanuMdi/bonumaXyanuMci/bonumaXyalonuMdi/bonumaXyalonuMci	n number eka parsarg maXyanuMdi 
*bonunadumanuMdi/bonunadumanuMci	n number eka parsarg nadumanuMdi 
*bonuwaravAwanuMdi/bonuwarvAwanuMdi/bonuwaravAwanuMci/bonuwarvAwanuMci	n number eka parsarg waravAwanuMdi 
*bonucotlonuMdi/bonucotunuMdi/bonucotlonuMci/bonucotunuMci	n number eka parsarg cotlonuMdi 
bonusWAnaMnuMdi/*bonusWAnamunuMdi/bonusWAnaMnuMci/bonusWAnamunuMci/bonusWAnaMlonuMdi/bonusWAnamulonuMdi/bonusWAnaMlonuMci/bonusWAnamulonuMci	n number eka parsarg sWAnaMnuMdi 
bonaMxu/bonunaMxu/*bonuyaMxu	n number eka parsarg aMxu 
*bonaMte/bonaMteV	n number eka parsarg aMte 
*bonukaMteV/bonukaMte/bonukanna/bonukannA	n number eka parsarg kaMteV 
*bonEna	n number eka parsarg Ena 
*bonupAti	n number eka parsarg pAti 
*bonulAMti/bonulAti	n number eka parsarg lAMti 
*bonugAnI/bonukAnI	n number eka parsarg gAni 
*bonugA	n number eka parsarg gA 
bonlu/*bonulu	n number bahu parsarg 0  case d
bonlU/*bonulU/bonulArA/bonullArA	n number bahu parsarg I  case d
-	n number bahu parsarg gA 
bonlagAdu/*bonulagAdu	n number bahu parsarg gAdu  case d
bonlagawweV/*bonulagawweV	n number bahu parsarg gawweV  case d
*bonlavAdu/bonulodu	n number bahu parsarg vAdu  case d
bonlAyana/*bonulAyana	n number bahu parsarg Ayana  case d
*bonlavAru/bonuloru	n number bahu parsarg vAru  case d
bonlaxi/*bonulaxi/bonulxi	n number bahu parsarg xi  case d
bonlavi/*bonulavi/bonlay/bonulay	n number bahu parsarg vi  case d
bonlugAru/*bonulugAru	n number bahu parsarg gAru  case d
bonlaM/bonlamu/*bonulaM/bonulamu	n number bahu parsarg nu  case d
bonlu/*bonulu	n number bahu parsarg vu 
*bonulayoVkka/bonlayoVkka	n number bahu parsarg yoVkka 
bonla/*bonula	n number bahu parsarg obl 
bonlani/bonlanu/*bonulani/bonulanu/bonulni	n number bahu parsarg ni 
bonlaki/bonlaku/*bonulaki/bonulaku	n number bahu parsarg ki 
bonlawo/bonlawoda/bonlawoti/bonlawoni/*bonulawo/bonulawoda/bonulawoti/bonulawoni	n number bahu parsarg wo 
bonollo/bonlalo/*bonulalo/bonlalona/bonulalona/bonlalopala/bonulalopala	n number bahu parsarg lo 
bonlaloni/*bonulaloni/bonulalopali/bonulayaMxali/bonlalopali	n number bahu parsarg loni 
bonlamIxa/bonlana/*bonulamIxa	n number bahu parsarg mIxa 
*bonulana	n number bahu parsarg na 
bonlaniMci/bonulaniMci/bonlanuMci/bonulanuMci/*bonulanuMdi/bonlanuMdi	n number bahu parsarg niMci 
bonlaxvArA/bonlaxvAra/*bonulaxvArA/bonulaxvAra	n number bahu parsarg xvArA 
bonlavalana/bonlavalla/*bonulavalana/bonulavalla	n number bahu parsarg valana 
*bonlanubatti	n number bahu parsarg batti 
bonlacewa/*bonulacewa/bonlace/bonulace/bonlacewa/bonulcewa/bonulce/bonulace	n number bahu parsarg ce 
bonlawopAtu/bonulwopAtu/*bonulawopAtu	n number bahu parsarg wopAtu 
bonlawokUdi/*bonulawokUdi/bonlawokUda/bonulawokUdA/bonulawogUdA/bonlawogUdA/bonlawogUdi/bonulawogUdi	n number bahu parsarg wokUdi 
bonlakosaM/bonlakE/*bonulakosaM/bonulakE/bonlArWaM	n number bahu parsarg kosaM 
bonlakoVraku/bonlakoVrYaku/*bonulakoVraku/bonulakoVrYaku	n number bahu parsarg koVraku 
bonlalonuMdi/bonlalonuMci/*bonulalonuMdi/bonulalonuMci/bonulaloniMci/bonlaloniMci/bonullonuMdi/bonullonuMci/bonulloniMci	n number bahu parsarg lonuMdi 
bonlamIxanuMdi/bonlamIxanuMci/bonlamIxaniMci/*bonulamIxanuMdi/bonulamIxanuMci/bonulamIxaniMci	n number bahu parsarg mIxanuMdi 
bonlaxAkA/bonlaxAka/*bonulaxAkA/bonulaxAka	n number bahu parsarg xAkA 
bonlavaraku/*bonulavaraku	n number bahu parsarg varaku 
bonlamIxaki/bonlamIxaku/bonulamIxiki/*bonulamIxaki/bonulamIxaku/bonlamIxiki	n number bahu parsarg mIxaki 
bonlaxaggara/bonlaxaggira/*bonulaxaggara/bonulaxaggira	n number bahu parsarg xaggara 
bonlavaxxa/bonloVxxa/*bonulavaxxa/bonuloVxxa	n number bahu parsarg vaxxa 
bonlakAda/*bonulakAda	n number bahu parsarg kAda 
bonleVxurugA/bonlakeVxurugA/bonuleVxurugA/*bonulakeVxurugA	n number bahu parsarg keVxurugA 
bonlamuMxu/*bonulamuMxu	n number bahu parsarg muMxu 
bonlaguriMci/bonlagUrci/bonlanuguriMci/bonulanigUrci/bonulaniguriMci/*bonulanuguriMci	n number bahu parsarg guriMci 
bonlapE/bonlapEni/bonlapEna/bonulapE/bonulapEni/*bonulapEna	n number bahu parsarg pE 
bonlapEki/*bonulapEki	n number bahu parsarg pEki 
bonlaguMdA/*bonulaguMdA	n number bahu parsarg guMdA 
bonlalA/bonulalA/bonlalAgA/bonulalAgA/*bonullAgA/bonullA	n number bahu parsarg lA 
bonlavale/bonlavaleV/bonlamAxiri/bonlanupolina/bonlanubolina/bonulavale/*bonulavaleV/bonulamAxiri/bonulanupolina/bonulanubolina	n number bahu parsarg vale 
bonulakumalle/*bonulakumalleV	n number bahu parsarg kimalle 
bonlukUdA/bonlugUdA/bonlugUda/bonlakUda/*bonulukUdA/bonulugUdA/bonulugUda/bonulakUda	n number bahu parsarg kUdA 
bonlaxqRtilo/bonlaxruRtilo/*bonulaxqRtilo/bonulaxruRtilo	n number bahu parsarg xqRtilo 
bonlulekuMdA/bonlanulekuMdA/bonluleka/*bonululekuMdA/bonulanulekuMdA/bonululeka	n number bahu parsarg lekuMdA 
bonlukAkuMdA/bonlanukAkuMda/bonlukAka/bonlugAka/*bonulukAkuMdA/bonulanukAkuMda/bonulukAka/bonulugAka	n number bahu parsarg kAkuMdA 
bonlumoVxalukoVni/bonlanumoVxalukoVni/*bonulumoVxalukoVni/bonulanumoVxalukoVni	n number bahu parsarg moVxalukoVni 
bonlavEpu/bonlavepu/*bonulavEpu/bonulavepu/bonulakesi/bonlakesi	n number bahu parsarg vEpu 
bonlapakka/bonlapakkana/*bonulaprakka/bonulaprakkana	n number bahu parsarg pakka 
bonlapakkalo/bonlaprakkalo/bonulapakkalo/*bonulaprakkalo	n number bahu parsarg pakkalo 
bonlaloki/*bonulaloki/bonlaloniki/bonulaloniki/bonlalopalaki/bonlalopaliki/bonulalopaliki/bonulalopalaku/bonulloniki	n number bahu parsarg lopalaki 
bonlakiMxa/bonlakriMxa/bonulakiMxa/*bonulakriMxa/bonlakiMxana/bonlakriMxana/bonulakiMxana/bonulakriMxana	n number bahu parsarg kiMxa 
bonladuguna/bonlakaduguna/bonuladuguna/*bonulakaduguna	n number bahu parsarg aduguna 
bonlakeVlla/bonlakalla/bonulakeVlla/*bonulakalla	n number bahu parsarg kalla 
bonlaveVnuka/bonlaveVnaka/bonlaveVnakAla/bonulaveVnukAla/bonulaveVnuka/bonulaveVnaka/*bonulaveVnakAla/bonulaveVnukAla/bonlaveVnakAwala/bonulaveVnukAwala/bonulaveVnakAwala/bonulaveVnukAwala	n number bahu parsarg veVnuka 
bonlawaravAwa/bonlawarvAwa/*bonulawaravAwa/bonulawarvAwa	n number bahu parsarg waravAwa 
bonleVxuruguMdA/bonlakeVxuruguMdA/bonuleVxuruguMdA/*bonulakeVxuruguMdA	n number bahu parsarg eVxuruguMdA 
bonlamaXya/bonlamaXyana/bonlamaXyalo/*bonulamaXya/bonulamaXyana/bonulamaXyalo	n number bahu parsarg maXya 
bonlanaduma/bonlakinaduma/*bonulanaduma/bonulakinaduma	n number bahu parsarg naduma 
bonlabaxulugA/bonlakibaxulugA/bonlabaxulu/bonlakibaxulu/bonulabaxulu/bonulakubaxulu/*bonulakibaxulu	n number bahu parsarg baxulugA 
bonlacotlo/bonlacotulo/*bonulacotlo/bonulacotulo	n number bahu parsarg cotlo 
bonlasWAnaMlo/bonlaswAnaMlo/*bonulasWAnamulo/bonulasWAnaMlo/bonulaswAnaMlo/bonlasWAnamulo	n number bahu parsarg sWAnaMlo 
bonlanerugA/bonlakunerugA/bonlakinerugA/bonulanerugA/bonulakunerugA/*bonulakinerugA	n number bahu parsarg nerugA 
bonlaprakAraM/bonlanubatti/bonlabatti/bonlanibatti/*bonulaprakAraM/bonulanubatti/bonulabatti/bonulanibatti	n number bahu parsarg prakAraM 
bonlaxaggaranuMdi/bonlaxaggiranuMdi/bonlaxaggaranuMci/bonlaxaggiranuMci/*bonulaxaggaranuMdi/bonulaxaggiranuMdi/bonulaxaggaranuMci/bonulaxaggiranuMci	n number bahu parsarg xaggaranuMdi 
bonlavaxxanuMdi/bonlavaxxanuMci/*bonulavaxxanuMdi/bonulavaxxanuMci	n number bahu parsarg vaxxanuMdi 
bonlapakkanuMdi/bonlapakkanuMci/*bonulapakkanuMdi/bonulapakkanuMci/bonlapakkalonuMdi/bonlapakkalonuMci/bonulapakkalonuMdi/bonulapakkalonuMci	n number bahu parsarg pakkanuMdi 
bonlalopalanuMdi/bonlalopalanuMci/bonlalopalinuMdi/bonulalopalinuMci/*bonulalopalanuMdi/bonulalopalanuMci/bonulalopalinuMdi/bonulalopalinuMci	n number bahu parsarg lopalanuMdi 
bonlabEtanuMdi/bonlabEtanuMci/bonlabEtaniMci/*bonulabEtanuMdi/bonulabEtanuMci/bonulabEtaniMci	n number bahu parsarg bEtanuMdi 
bonlapEnuMdi/bonlapEnuMci/bonlapEniMci/*bonulapEnuMdi/bonulapEnuMci/bonulapEniMci	n number bahu parsarg pEnuMdi 
bonlakiMxanuMdi/bonlakiMxanuMci/bonlakiMxaniMci/bonulakiMxanuMdi/bonulakiMxanuMci/bonulakiMxaniMci/bonlakriMxanuMdi/bonlakriMxanuMci/bonlakriMxaniMci/*bonulakriMxanuMdi/bonulakriMxanuMci/bonulakriMxaniMci	n number bahu parsarg kriMxanuMdi 
bonladugunuMdi/bonladugunuMci/bonladuguniMci/*bonuladugunuMdi/bonuladugunuMci/bonuladuguniMci	n number bahu parsarg adugunuMdi 
bonlamuMxunuMdi/bonlamuMxunuMci/bonlamuMxuniMci/*bonulamuMxunuMdi/bonulamuMxunuMci/bonulamuMxuniMci	n number bahu parsarg muMxunuMdi 
bonlaveVnukanuMdi/bonlaveVnakanuMdi/bonlaveVnakAlanuMdi/bonulaveVnukanuMdi/bonulaveVnakanuMdi/*bonulaveVnakAlanuMdi/bonlaveVnakAlanuMci/bonlaveVnukanuMci/bonlaveVnakanuMci/bonulaveVnakAlanuMci/bonulaveVnukanuMci/bonulaveVnakanuMci/bonlaveVnakAwalanuMdi/bonlaveVnakAwalanuMci/bonulaveVnakAwalanuMdi/bonulaveVnakAwalanuMci	n number bahu parsarg veVnukanuMdi 
bonleVxutinuMdi/bonlakeVxutinuMdi/bonuleVxutinuMdi/bonulakeVxutinuMdi/bonleVxutanuMdi/bonlakeVxutanuMdi/bonuleVxutanuMdi/*bonulakeVxutanuMdi/bonuleVxutinuMci/bonulakeVxutinuMci/bonleVxutinuMci/bonlakeVxutinuMci/bonuleVxutanuMci/bonulakeVxutanuMci/bonleVxutanuMci/bonlakeVxutanuMci	n number bahu parsarg eVxutinuMdi 
bonlamaXyanuMdi/bonlamaXyanuMci/bonlamaXyaniMci/*bonulamaXyanuMdi/bonulamaXyanuMci/bonulamaXyaniMci/bonlamaXyalonuMdi/bonlamaXyalonuMci/bonlamaXyaloniMci/bonulamaXyalonuMdi/bonulamaXyalonuMci/bonulamaXyaloniMci	n number bahu parsarg maXyanuMdi 
bonlanadumanuMci/bonlanadamanuMci/bonulanadumanuMci/bonulanadamanuMci/bonlanadumanuMdi/bonlanadamanuMdi/*bonulanadumanuMdi/bonulanadamanuMdi	n number bahu parsarg nadumanuMdi 
bonlawaravAwanuMdi/bonlawarvAwanuMdi/*bonulawaravAwanuMdi/bonulawarvAwanuMdi/bonlawaravAwanuMci/bonlawarvAwanuMci/bonulawaravAwanuMci/bonulawarvAwanuMci	n number bahu parsarg waravAwanuMdi 
bonlacotunuMdi/bonlacotunuMci/bonlacotuniMci/bonulacotunuMdi/bonulacotunuMci/bonulacotuniMci/bonlacotlonuMci/bonlacotloniMci/bonlacotulonuMci/bonlacotulonuMdi/bonulacotlonuMci/bonulacotloniMci/bonulacotulonuMci/*bonulacotulonuMdi	n number bahu parsarg cotlonuMdi 
bonlasWAnamunuMdi/bonlasWAnaMnuMdi/*bonulasWAnamunuMdi/bonulasWAnaMnuMdi/bonlasWAnamunuMci/bonlasWAnaMnuMci/bonulasWAnamunuMci/bonulasWAnaMnuMci/bonlasWAnaMlonuMdi/bonlasWAnamulonuMdi/bonulasWAnaMlonuMdi/bonulasWAnamulonuMdi/bonlasWAnaMlonuMci/bonlasWAnamulonuMci/bonulasWAnaMlonuMci/bonulasWAnamulonuMci	n number bahu parsarg sWAnaMnuMdi 
bonlayaMxu/bonlaMxu/*bonulayaMxu/bonulaMxu	n number bahu parsarg aMxu 
bonlaMte/bonlaMteV/bonulaMte/*bonulaMteV	n number bahu parsarg aMte 
bonlakaMteV/bonlakaMte/*bonulakaMteV/bonulakaMte/bonlakannA/bonulakanna/bonulakannA	n number bahu parsarg kaMteV 
bonlEna/*bonulEna	n number bahu parsarg Ena 
bonlapAti/*bonulapAti	n number bahu parsarg pAti 
bonlalAMti/bonlalAti/*bonulalAMti/bonulalAti	n number bahu parsarg lAMti 
bonlugAnI/bonlukAnI/*bonulugAnI/bonulukAnI	n number bahu parsarg gAni 
bonlugA/*bonulugA	n number bahu parsarg gA 
