noun	
beVMdu	
*beVMdu	n number eka parsarg 0 
-	n number eka parsarg I 
-	n number eka parsarg gA 
*beVMdugAdu	n number eka parsarg gAdu 
*beVMdugawweV	n number eka parsarg gawweV 
*beVMduvAdu	n number eka parsarg vAdu 
*beVMdAyana	n number eka parsarg Ayana 
*beVMduvAru	n number eka parsarg vAru 
*beVMduxi	n number eka parsarg xi 
*beVMduvi/beVMduy	n number eka parsarg vi 
*beVMdugAru	n number eka parsarg gAru 
*beVMdunu	n number eka parsarg nu 
*beVMduvu	n number eka parsarg vu 
*beVMduyoVkka	n number eka parsarg yoVkka 
*beVMdu	n number eka parsarg obl 
*beVMduni/beVMdunu	n number eka parsarg ni 
*beVMduki/beVMduku	n number eka parsarg ki 
*beVMduwo/beVMduwoda/beVMduwoti	n number eka parsarg wo 
*beVMdulo/beVMdulona/beVMdulopala	n number eka parsarg lo 
*beVMduloni/beVMdulopali/beVMdunaMxali	n number eka parsarg loni 
*beVMdumIxa	n number eka parsarg mIxa 
*beVMduna	n number eka parsarg na 
beVMduniMci/beVMdunuMci/*beVMdunuMdi	n number eka parsarg niMci 
*beVMduxvArA/beVMduxvAra	n number eka parsarg xvArA 
*beVMduvalana/beVMduvalla	n number eka parsarg valana 
*beVMdunubatti/beVMdunibatti	n number eka parsarg batti 
beVMduce/*beVMducewa	n number eka parsarg ce 
*beVMduwopAtu	n number eka parsarg wopAtu 
*beVMduwokUdi/beVMduwokUda/beVMduwokUdA	n number eka parsarg wokUdi 
*beVMdukosaM/beVMdukE/beVMdArWaM	n number eka parsarg kosaM 
*beVMdukoVraku/beVMdukoVrYaku	n number eka parsarg koVraku 
*beVMdulonuMdi/beVMdulonuMci/beVMduloniMci	n number eka parsarg lonuMdi 
*beVMdumIxanuMdi/beVMdumIxanuMci/beVMdumIxaniMci	n number eka parsarg mIxanuMdi 
*beVMduxAkA/beVMduxAka	n number eka parsarg xAkA 
*beVMduvaraku	n number eka parsarg varaku 
*beVMdumIxaki/beVMdumIxaku/beVMdumIxiki	n number eka parsarg mIxaki 
*beVMduxaggara/beVMduxaggira	n number eka parsarg xaggara 
*beVMduvaxxa/beVMdoVxxa	n number eka parsarg vaxxa 
*beVMdukAda	n number eka parsarg kAda 
*beVMdukeVxurugA/beVMdeVxurugA	n number eka parsarg keVxurugA 
*beVMdumuMxu	n number eka parsarg muMxu 
*beVMduguriMci/beVMduniguriMci/beVMdunugUrci	n number eka parsarg guriMci 
beVMdupE/*beVMdupEna/beVMdupEni	n number eka parsarg pE 
*beVMdupEki	n number eka parsarg pEki 
*beVMduguMdA	n number eka parsarg guMdA 
beVMdulA/beVMdulAga/*beVMdulAgA	n number eka parsarg lA 
*beVMduvale/beVMdumAxiri/beVMdunipoli/beVMdunuboli	n number eka parsarg vale 
*beVMdukumalle/beVMdukumalleV	n number eka parsarg kimalle 
*beVMdukUdA/beVMdunikUdA/beVMdunukUdA	n number eka parsarg kUdA 
*beVMduxqRtilo/beVMduxruRtilo	n number eka parsarg xqRtilo 
*beVMdulekuMdA/beVMdunulekuMdA/beVMduleka/beVMdunilekuMdA	n number eka parsarg lekuMdA 
*beVMdukAkuMdA/beVMdunukAkuMdA/beVMdukAka/beVMdunikAkuMdA	n number eka parsarg kAkuMdA 
*beVMdumoVxalukoVni/beVMdunimoVxalukoVni/beVMdunumoVxalukoVni	n number eka parsarg moVxalukoVni 
*beVMduvEpu/beVMduvepu/beVMdukesi	n number eka parsarg vEpu 
beVMdupakka/*beVMduprakka/beVMdupakkana/beVMduprakkana/beVMdupakkani	n number eka parsarg pakka 
beVMdupakkalo/*beVMduprakkalo/beVMdupakkalona/beVMdupakkaloni	n number eka parsarg pakkalo 
*beVMduloki/beVMduloniki/beVMdulopalaki/beVMdulopalaku/beVMdulopaliki	n number eka parsarg lopalaki 
beVMdukiMxa/*beVMdukriMxa/beVMdukriMxana/beVMdukiMxana	n number eka parsarg kiMxa 
beVMdaduguna/*beVMdukaduguna	n number eka parsarg aduguna 
beVMdukeVlla/*beVMdukalla	n number eka parsarg kalla 
beVMduveVnuka/*beVMduveVnakAla/beVMduveVnakAwala/beVMduveVnakana	n number eka parsarg veVnuka 
beVMduwaravAwa/beVMduwarvAwa/*beVMduwaruvAwa/beVMduwaravAwana/beVMduwarvAwana/beVMduwaruvAwana	n number eka parsarg waravAwa 
beVMdeVxuruguMdA/*beVMdukeVxuruguMdA	n number eka parsarg eVxuruguMdA 
*beVMdumaXya/beVMdumaXyalo/beVMdumaXyana	n number eka parsarg maXya 
*beVMdunaduma/beVMdunadumana	n number eka parsarg naduma 
beVMdubaxulugA/beVMdubaxulu/*beVMdukibaxulu/beVMdukubaxulu	n number eka parsarg baxulugA 
*beVMducotlo/beVMducotulo/beVMducotuna/beVMducota	n number eka parsarg cotlo 
*beVMdusWAnaMlo/beVMduswAnaMlo	n number eka parsarg sWAnaMlo 
beVMdunerugA/beVMdukunerugA/*beVMdukinerugA	n number eka parsarg nerugA 
*beVMduprakAraM/beVMduprakAramu	n number eka parsarg prakAraM 
*beVMduxaggaranuMdi/beVMduxaggaranuMci/beVMduxaggiranuMdi/beVMduxaggiranuMci	n number eka parsarg xaggaranuMdi 
*beVMduvaxxanuMdi/beVMduvaxxanuMci/beVMduvaxxaniMci	n number eka parsarg vaxxanuMdi 
*beVMdupakkanuMdi/beVMdupakkanuMci/beVMdupakkaniMci/beVMdupakkalonuMdi/beVMdupakkalonuMci/beVMdupakkaloniMci	n number eka parsarg pakkanuMdi 
*beVMdulopalanuMdi/beVMdulopalanuMci/beVMdulopalaniMci	n number eka parsarg lopalanuMdi 
*beVMdubEtanuMdi/beVMdubEtanuMci/beVMdubEtaniMci	n number eka parsarg bEtanuMdi 
*beVMdupEnuMdi/beVMdupEnuMci/beVMdupEniMci	n number eka parsarg pEnuMdi 
beVMdukiMxanuMdi/beVMdukiMxanuMci/beVMdukiMxaniMci/*beVMdukriMxanuMdi/beVMdukriMxanuMci/beVMdukriMxaniMci	n number eka parsarg kriMxanuMdi 
beVMdadugunuMdi/beVMdadugunuMci/*beVMdukadugunuMdi/beVMdukadugunuMci/beVMdukaduguniMci	n number eka parsarg adugunuMdi 
*beVMdumuMxunuMdi/beVMdumuMxunuMci/beVMdumuMxuniMci	n number eka parsarg muMxunuMdi 
beVMduveVnukanuMdi/*beVMduveVnakAlanuMdi/beVMduveVnakAwalanuMdi/beVMduveVnakanuMdi/beVMduveVnukanuMci/beVMduveVnakAlanuMci/beVMduveVnakAwalanuMci/beVMduveVnakanuMci	n number eka parsarg veVnukanuMdi 
beVMdeVxutinuMdi/*beVMdukeVxutinuMdi/beVMdukeVxutinuMci/beVMdeVxutinuMci	n number eka parsarg eVxutinuMdi 
*beVMdumaXyanuMdi/beVMdumaXyanuMci/beVMdumaXyalonuMdi/beVMdumaXyalonuMci	n number eka parsarg maXyanuMdi 
*beVMdunadumanuMdi/beVMdunadumanuMci	n number eka parsarg nadumanuMdi 
*beVMduwaravAwanuMdi/beVMduwarvAwanuMdi/beVMduwaravAwanuMci/beVMduwarvAwanuMci	n number eka parsarg waravAwanuMdi 
*beVMducotlonuMdi/beVMducotunuMdi/beVMducotlonuMci/beVMducotunuMci	n number eka parsarg cotlonuMdi 
beVMdusWAnaMnuMdi/*beVMdusWAnamunuMdi/beVMdusWAnaMnuMci/beVMdusWAnamunuMci/beVMdusWAnaMlonuMdi/beVMdusWAnamulonuMdi/beVMdusWAnaMlonuMci/beVMduswAnamulonuMci	n number eka parsarg sWAnaMnuMdi 
beVMdaMxu/beVMdunaMxu/*beVMduyaMxu	n number eka parsarg aMxu 
*beVMdaMte/beVMdaMteV	n number eka parsarg aMte 
*beVMdukaMteV/beVMdukaMte/beVMdukanna/beVMdukannA	n number eka parsarg kaMteV 
*beVMdEna/beVMdayina	n number eka parsarg Ena 
*beVMdupAti	n number eka parsarg pAti 
*beVMdulAMti/beVMdulAti	n number eka parsarg lAMti 
*beVMdugAnI/beVMdukAnI	n number eka parsarg gAni 
*beVMdugA	n number eka parsarg gA 
*beVMdlu/beVMdulu	n number bahu parsarg 0 
*beVMdlU/beVMdlulArA/beVMdullArA	n number bahu parsarg I 
-	n number bahu parsarg gA 
*beVMdlagAdu/beVMdulugAdu	n number bahu parsarg gAdu 
*beVMdlagawweV/beVMdulugawweV	n number bahu parsarg gawweV 
*beVMdlavAdu/beVMdlodu	n number bahu parsarg vAdu 
*beVMdlAyana/beVMdulAyana	n number bahu parsarg Ayana 
*beVMdlavAru/beVMdloru	n number bahu parsarg vAru 
*beVMdlaxi/beVMdulxi	n number bahu parsarg xi 
*beVMdlavi/beVMdlay/beVMdluvi	n number bahu parsarg vi 
*beVMdlugAru/beVMdulugAru	n number bahu parsarg gAru 
*beVMdlaM/beVMdlamu	n number bahu parsarg nu 
*beVMdlu/beVMdulu	n number bahu parsarg vu 
*beVMdlayoVkka	n number bahu parsarg yoVkka 
*beVMdla	n number bahu parsarg obl 
*beVMdlani/beVMdulni/beVMdlanu/beVMdulanu	n number bahu parsarg ni 
*beVMdlaki/beVMdlaku	n number bahu parsarg ki 
*beVMdlawo/beVMdulwo/beVMdlawoda/beVMdlawoti/beVMdulwoti/beVMdulwoda	n number bahu parsarg wo 
*beVMdlalo/beVMdlallo/beVMdullo/beVMdlalona/beVMdullona/beVMdlalopala	n number bahu parsarg lo 
*beVMdlaloni/beVMdlayaMxali/beVMdulloni/beVMdlalopali	n number bahu parsarg loni 
*beVMdlamIxa	n number bahu parsarg mIxa 
*beVMdlana	n number bahu parsarg na 
beVMdlaniMci/beVMdulniMci/beVMdlanuMci/beVMdulnuMci/*beVMdlanuMdi/beVMdulnuMdi	n number bahu parsarg niMci 
*beVMdlaxvArA/beVMdlaxvAra	n number bahu parsarg xvArA 
*beVMdlavalana/beVMdlavalla	n number bahu parsarg valana 
*beVMdlacewa/beVMdulacewa/beVMdlace/beVMdulace	n number bahu parsarg batti 
*beVMdlawopAtu/beVMdulwopAtu/beVMdlawobAtu	n number bahu parsarg ce 
*beVMdlawokUdi/beVMdulwokUdi/beVMdlawokUda/beVMdlawokUdA/beVMdulwokUdA/beVMdlawogUdA/beVMdlawogUdi	n number bahu parsarg wopAtu 
*beVMdlakosaM/beVMdlakE/beVMdlArWaM	n number bahu parsarg wokUdi 
*beVMdlakoVraku/beVMdlakoVrYaku	n number bahu parsarg kosaM 
*beVMdlalonuMdi/beVMdlalonuMci/beVMdullonuMdi/beVMdullonuMci/beVMdulloniMci/beVMdlaloniMci	n number bahu parsarg koVraku 
*beVMdlamIxanuMdi/beVMdlamIxanuMci/beVMdlamIxaniMci	n number bahu parsarg lonuMdi 
*beVMdlaxAkA/beVMdlaxAka	n number bahu parsarg mIxanuMdi 
*beVMdlavaraku	n number bahu parsarg xAkA 
*beVMdlamIxaki/beVMdlamIxaku/beVMdlamIxiki	n number bahu parsarg varaku 
*beVMdlaxaggara/beVMdlaxaggira	n number bahu parsarg mIxaki 
*beVMdlavaxxa/beVMdloVxxa	n number bahu parsarg xaggara 
*beVMdlakAda/beVMdulakAda	n number bahu parsarg vaxxa 
beVMdleVxurugA/*beVMdlakeVxurugA	n number bahu parsarg kAda 
*beVMdlamuMxu	n number bahu parsarg keVxurugA 
*beVMdlaguriMci/beVMdlagUrci/beVMdlanuguriMci/beVMdlanigUrci	n number bahu parsarg muMxu 
beVMdlapE/beVMdlapEni/*beVMdlapEna	n number bahu parsarg guriMci 
*beVMdlapEki/beVMdulapEki	n number bahu parsarg pE 
*beVMdlaguMdA	n number bahu parsarg pEki 
beVMdlalA/beVMdullA/*beVMdlalAga/beVMdullAga/beVMdullAgA	n number bahu parsarg guMdA 
*beVMdlavale/beVMdlavaleV/beVMdlamAxiri/beVMdlanupolina/beVMdlanubolina	n number bahu parsarg lA 
*beVMdlakumalle/beVMdlakumalleV	n number bahu parsarg vale 
*beVMdlukUdA/beVMdlugUdA/beVMdlukUda/beVMdlugUda	n number bahu parsarg kimalle 
*beVMdlaxqRtilo/beVMdlaxruRtilo	n number bahu parsarg kUdA 
*beVMdlulekuMdA/beVMdullekuMdA/beVMdluleka	n number bahu parsarg xqRtilo 
*beVMdlukAkuMdA/beVMdlukAkuMda/beVMdlukAka/beVMdlugAka/beVMdlugAkuMdA	n number bahu parsarg lekuMdA 
*beVMdlumoVxalukoVni/beVMdlanumoVxalukoVni	n number bahu parsarg kAkuMdA 
*beVMdlavEpu/beVMdlavepu/beVMdlakesi	n number bahu parsarg moVxalukoVni 
beVMdlapakka/beVMdlapakkana/*beVMdlaprakka/beVMdlaprakkana	n number bahu parsarg vEpu 
beVMdlapakkalo/*beVMdlaprakkalo	n number bahu parsarg pakka 
*beVMdlaloki/beVMdulloki/beVMdlaloniki/beVMdulloniki/beVMdlalopalaki/beVMdlalopaliki/beVMdullopaliki/beVMdullopalaku	n number bahu parsarg pakkalo 
beVMdlakiMxa/*beVMdlakriMxa/beVMdlakriMxana/beVMdlakiMxana	n number bahu parsarg lopalaki 
beVMdladuguna/*beVMdlakaduguna	n number bahu parsarg kiMxa 
beVMdlakeVlla/*beVMdlakalla	n number bahu parsarg aduguna 
beVMdlaveVnuka/beVMdlaveVnaka/*beVMdlaveVnakAla/beVMdlaveVnukAla/beVMdlaveVnakAwala/beVMdlaveVnukAwala	n number bahu parsarg kalla 
*beVMdlawaravAwa/beVMdlawarvAwa/beVMdulwaravAwa	n number bahu parsarg veVnuka 
beVMdleVxuruguMdA/*beVMdlakeVxuruguMdA	n number bahu parsarg waravAwa 
*beVMdlamaXya/beVMdlamaXyana/beVMdlamaXyalo	n number bahu parsarg eVxuruguMdA 
*beVMdlanaduma/beVMdlakinaduma	n number bahu parsarg maXya 
beVMdlabaxulugA/beVMdlakibaxulugA/beVMdlabaxulu/*beVMdlakibaxulu	n number bahu parsarg naduma 
*beVMdlacotlo/beVMdlacotulo	n number bahu parsarg baxulugA 
beVMdlasWAnaMlo/beVMdlaswAnaMlo/*beVMdlasWAnamulo	n number bahu parsarg cotlo 
beVMdlanerugA/beVMdlakunerugA/*beVMdlakinerugA	n number bahu parsarg sWAnaMlo 
*beVMdlaprakAraM/beVMdlanubatti/beVMdlabatti/beVMdlanibatti	n number bahu parsarg nerugA 
*beVMdlaxaggaranuMdi/beVMdlaxaggiranuMdi/beVMdlaxaggaranuMci/beVMdlaxaggiranuMci	n number bahu parsarg prakAraM 
*beVMdlavaxxanuMdi/beVMdlavaxxanuMci	n number bahu parsarg xaggaranuMdi 
*beVMdlapakkanuMdi/beVMdlapakkanuMci/beVMdlapakkalonuMdi/beVMdlapakkalonuMci	n number bahu parsarg vaxxanuMdi 
*beVMdlalopalanuMdi/beVMdullopalanuMdi/beVMdlalopalanuMci/beVMdullopalanuMci/beVMdullopalinuMdi/beVMdlalopalinuMci	n number bahu parsarg pakkanuMdi 
*beVMdlabEtanuMdi/beVMdlabEtanuMci/beVMdlabEtaniMci	n number bahu parsarg lopalanuMdi 
*beVMdlapEnuMdi/beVMdlapEnuMci/beVMdlapEniMci	n number bahu parsarg bEtanuMdi 
beVMdlakiMxanuMdi/beVMdlakiMxanuMci/beVMdlakiMxaniMci/*beVMdlakriMxanuMdi/beVMdlakriMxanuMci/beVMdlakriMxaniMci	n number bahu parsarg pEnuMdi 
*beVMdladugunuMdi/beVMdladugunuMci/beVMdladuguniMci	n number bahu parsarg kriMxanuMdi 
*beVMdlamuMxunuMdi/beVMdlamuMxunuMci/beVMdlamuMxuniMci	n number bahu parsarg adugunuMdi 
beVMdlaveVnukanuMdi/beVMdlaveVnakanuMdi/*beVMdlaveVnakAlanuMdi/beVMdlaveVnakAlanuMci/beVMdlaveVnukanuMci/beVMdlaveVnakanuMci/beVMdlaveVnakAwalanuMdi/beVMdlaveVnakAwalanuMci	n number bahu parsarg muMxunuMdi 
beVMdleVxutinuMdi/*beVMdlakeVxutinuMdi/beVMdleVxutinuMci/beVMdlakeVxutinuMci	n number bahu parsarg veVnukanuMdi 
*beVMdlamaXyanuMdi/beVMdlamaXyanuMci/beVMdlamaXyaniMci/beVMdlamaXyalonuMdi/beVMdlamaXyalonuMci/beVMdlamaXyaloniMci	n number bahu parsarg eVxutinuMdi 
*beVMdlanadumanuMdi/beVMdlanadamanuMdi/beVMdlanadumanuMci/beVMdlanadamanuMci	n number bahu parsarg maXyanuMdi 
*beVMdlawaravAwanuMdi/beVMdlawarvAwanuMdi/beVMdlawaravAwanuMci/beVMdlawarvAwanuMci	n number bahu parsarg nadumanuMdi 
*beVMdlacotlonuMdi/beVMdlacotunuMdi/beVMdlacotlonuMci/beVMdlacotloniMci/beVMdlacotunuMci/beVMdlacotuniMci	n number bahu parsarg waravAwanuMdi 
*beVMdlasWAnamunuMdi/beVMdlasWAnaMnuMdi/beVMdlasWAnamunuMci/beVMdlasWAnaMnuMci/beVMdlasWAnaMlonuMdi/beVMdlasWAnamulonuMdi/beVMdlasWAnaMlonuMci/beVMdlasWAnamulonuMci	n number bahu parsarg cotlonuMdi 
*beVMdlayaMxu/beVMdlaMxu	n number bahu parsarg sWAnaMnuMdi 
*beVMdlaMte/beVMdlaMteV	n number bahu parsarg aMxu 
*beVMdlakaMteV/beVMdlakaMte/beVMdlakanna/beVMdlakannA	n number bahu parsarg aMte 
*beVMdlEna/beVMdlayina	n number bahu parsarg kaMteV 
*beVMdlapAti	n number bahu parsarg Ena 
*beVMdlalAMti/beVMdlalAti	n number bahu parsarg pAti 
*beVMdlugAnI/beVMdlukAnI	n number bahu parsarg lAMti 
*beVMdlugA	n number bahu parsarg gAni 
	n number bahu parsarg gA 
