noun	
buddi	
*buddi	n number eka parsarg 0 
-	n number eka parsarg I 
-	n number eka parsarg gA 
*buddigAdu	n number eka parsarg gAdu 
*buddigawweV	n number eka parsarg gawweV 
*buddivAdu	n number eka parsarg vAdu 
*buddAyana	n number eka parsarg Ayana 
*buddivAru	n number eka parsarg vAru 
*buddixi	n number eka parsarg xi 
*buddivi/buddiy	n number eka parsarg vi 
*buddigAru	n number eka parsarg gAru 
*buddini	n number eka parsarg nu 
*buddivi	n number eka parsarg vu 
*buddiyoVkka	n number eka parsarg yoVkka 
*buddi	n number eka parsarg obl 
*buddini/buddinu	n number eka parsarg ni 
*buddiki/buddiku	n number eka parsarg ki 
*buddiwo/buddiwoda/buddiwoti	n number eka parsarg wo 
*buddilo/buddilona/buddilopala	n number eka parsarg lo 
*buddiloni/buddilopali/buddiyaMxali	n number eka parsarg loni 
*buddimIxa	n number eka parsarg mIxa 
*buddina	n number eka parsarg na 
buddiniMci/buddinuMci/*buddinuMdi	n number eka parsarg niMci 
*buddixvArA/budduxvAra	n number eka parsarg xvArA 
*buddivalana/buddivalla	n number eka parsarg valana 
*buddinibatti	n number eka parsarg batti 
buddice/*buddicewa	n number eka parsarg ce 
*buddiwopAtu/buddiwobAtu	n number eka parsarg wopAtu 
*buddiwokUdi/buddiwokUda/buddiwokUdA/buddiwogUdi/buddiwogUda/buddiwogUdA	n number eka parsarg wokUdi 
*buddikosaM/buddikE/buddArWaM	n number eka parsarg kosaM 
*buddikoVraku/buddikoVrYaku	n number eka parsarg koVraku 
*buddilonuMdi/buddilonuMci/buddiloniMci	n number eka parsarg lonuMdi 
*buddimIxanuMdi/buddimIxanuMci/buddimIxaniMci	n number eka parsarg mIxanuMdi 
*buddixAkA/buddixAka	n number eka parsarg xAkA 
*buddivaraku	n number eka parsarg varaku 
*buddimIxaki/buddimIxaku/buddimIxiki	n number eka parsarg mIxaki 
*buddixaggara/buddixaggira	n number eka parsarg xaggara 
*buddivaxxa/buddoVxxa	n number eka parsarg vaxxa 
*buddikAda	n number eka parsarg kAda 
*buddikeVxurugA/buddeVxurugA	n number eka parsarg keVxurugA 
*buddimuMxu	n number eka parsarg muMxu 
*buddiguriMci/buddiniguriMci/buddinugUrci	n number eka parsarg guriMci 
buddipE/*buddipEna/buddipEni	n number eka parsarg pE 
*buddipEki	n number eka parsarg pEki 
*buddiguMdA	n number eka parsarg guMdA 
buddilA/buddilAga/*buddilAgA	n number eka parsarg lA 
*buddivale/buddimAxiri/buddinipoli/buddinuboli	n number eka parsarg vale 
buddikimalle/*buddikimalleV	n number eka parsarg kimalle 
*buddikUdA/buddinikUdA/buddikUda/buddigUdA/buddinigUdA/buddigUda	n number eka parsarg kUdA 
*buddixqRtilo/buddixruRtilo	n number eka parsarg xqRtilo 
*buddilekuMdA/buddinilekuMdA/buddilekuMda/buddinulekuMdA	n number eka parsarg lekuMdA 
*buddikAkuMdA/buddinikAkuMdA/buddikAka/buddinikAkuMda/buddigAkuMda/buddinigAkuMdA/buddigAka/buddigAkuMdA	n number eka parsarg kAkuMdA 
*buddimoVxalukoVni/buddinimoVxalukoVni/buddinumoVxalukoVni	n number eka parsarg moVxalukoVni 
*buddivEpu/buddivepu/buddikesi	n number eka parsarg vEpu 
buddipakka/*buddiprakka/buddipakkana/buddiprakkana/buddipakkani	n number eka parsarg pakka 
buddipakkalo/*buddiprakkalo/buddipakkalona/buddipakkaloni	n number eka parsarg pakkalo 
*buddiloki/buddiloniki/buddilopalaki/buddilopalaku/buddilopaliki	n number eka parsarg lopalaki 
buddikiMxa/*buddikriMxa/buddikriMxana/buddikiMxana	n number eka parsarg kiMxa 
buddaduguna/*buddikaduguna	n number eka parsarg aduguna 
buddikeVlla/*buddikalla	n number eka parsarg kalla 
buddiveVnuka/*buddiveVnakAla/buddiveVnakAwala/buddiveVnakana	n number eka parsarg veVnuka 
buddiwaravAwa/buddiwarvAwa/*buddiwaruvAwa/buddiwaravAwana/buddiwarvAwana/buddiwaruvAwana	n number eka parsarg waravAwa 
buddeVxuruguMdA/*buddikeVxuruguMdA	n number eka parsarg eVxuruguMdA 
*buddimaXya/buddimaXyalo/buddimaXyana	n number eka parsarg maXya 
*buddinaduma/buddinadumana	n number eka parsarg naduma 
buddibaxulugA/buddibaxulu/*buddikibaxulu/buddikubaxulu	n number eka parsarg baxulugA 
*buddicotlo/buddicotulo/buddicotuna/buddicota	n number eka parsarg cotlo 
*buddisWAnaMlo/buddiswAnaMlo	n number eka parsarg sWAnaMlo 
buddinerugA/buddikunerugA/*buddikinerugA	n number eka parsarg nerugA 
*buddiprakAraM/buddprakAramu	n number eka parsarg prakAraM 
*buddixaggaranuMdi/buddixaggaranuMci/buddixaggiranuMdi/buddixaggiranuMci	n number eka parsarg xaggaranuMdi 
*buddivaxxanuMdi/buddivaxxanuMci/buddivaxxaniMci	n number eka parsarg vaxxanuMdi 
*buddipakkanuMdi/buddipakkanuMci/buddipakkaniMci/buddipakkalonuMdi/buddipakkalonuMci/buddipakkaloniMci	n number eka parsarg pakkanuMdi 
*buddilopalanuMdi/buddilopalanuMci/buddilopalaniMci	n number eka parsarg lopalanuMdi 
*buddibEtanuMdi/buddibEtanuMci/buddibEtaniMci	n number eka parsarg bEtanuMdi 
*buddipEnuMdi/buddipEnuMci/buddipEniMci	n number eka parsarg pEnuMdi 
buddikiMxanuMdi/buddikiMxanuMci/buddikiMxaniMci/*buddikriMxanuMdi/buddikriMxanuMci/buddikriMxaniMci	n number eka parsarg kriMxanuMdi 
buddadugunuMdi/buddadugunuMci/*buddikadugunuMdi/buddikadugunuMci/buddikaduguniMci	n number eka parsarg adugunuMdi 
*buddimuMxunuMdi/buddimuMxunuMci/buddimuMxuniMci	n number eka parsarg muMxunuMdi 
buddiveVnukanuMdi/*buddiveVnakAlanuMdi/buddiveVnakAwalanuMdi/buddiveVnakanuMdi/buddiveVnukanuMci/buddiveVnakAlanuMci/buddiveVnakAwalanuMci/buddiveVnakanuMci	n number eka parsarg veVnukanuMdi 
buddeVxutinuMdi/buddikeVxutinuMdi/buddikeVxutinuMci/buddeVxutinuMci/buddeVxutanuMdi/*buddikeVxutanuMdi/buddikeVxutanuMci/buddeVxutanuMci	n number eka parsarg eVxutinuMdi 
*buddimaXyanuMdi/buddimaXyanuMci/buddimaXyalonuMdi/buddimaXyalonuMci	n number eka parsarg maXyanuMdi 
*buddinadumanuMdi/buddinadumanuMci	n number eka parsarg nadumanuMdi 
*buddiwaravAwanuMdi/buddiwarvAwanuMdi/buddiwaravAwanuMci/buddiwarvAwanuMci	n number eka parsarg waravAwanuMdi 
*buddicotlonuMdi/buddicotunuMdi/buddicotlonuMci/buddicotunuMci	n number eka parsarg cotlonuMdi 
buddisWAnaMnuMdi/*buddisWAnamunuMdi/buddisWAnaMnuMci/buddisWAnamunuMci/buddisWAnaMlonuMdi/buddisWAnamulonuMdi/buddisWAnaMlonuMci/buddiswAnamulonuMci	n number eka parsarg sWAnaMnuMdi 
buddaMxu/buddinaMxu/*buddiyaMxu	n number eka parsarg aMxu 
*buddaMte/buddaMteV	n number eka parsarg aMte 
*buddikaMteV/buddikaMte/buddikanna/buddikannA	n number eka parsarg kaMteV 
*buddEna	n number eka parsarg Ena 
*buddipAti	n number eka parsarg pAti 
*buddilAMti/buddilAti	n number eka parsarg lAMti 
*buddigAnI/buddikAnI	n number eka parsarg gAni 
*buddigA	n number eka parsarg gA 
*budlu	n number bahu parsarg 0 
-	n number bahu parsarg I 
*budlU/budlulArA	n number bahu parsarg gA 
*budlagAdu	n number bahu parsarg gAdu 
*budlagawweV	n number bahu parsarg gawweV 
*budlavAdu/budlodu	n number bahu parsarg vAdu 
*budlAyana	n number bahu parsarg Ayana 
*budlavAru/budloru	n number bahu parsarg vAru 
*budlaxi/buddulxi	n number bahu parsarg xi 
*budlavi/budduliy/budliy	n number bahu parsarg vi 
*budlugAru	n number bahu parsarg gAru 
budlamu/*budlaM	n number bahu parsarg nu 
*budlu	n number bahu parsarg vu 
*budlayoVkka	n number bahu parsarg yoVkka 
*budla	n number bahu parsarg obl 
*budlani/buddulni/budlanu/buddulnu	n number bahu parsarg ni 
*budlaki/budlaku	n number bahu parsarg ki 
*budlawo/buddulwo/budlawoda/budlawoti/buddulwoti/buddulwoda	n number bahu parsarg wo 
*budlalo/buddullo/budlalona/buddullona	n number bahu parsarg lo 
*budlaloni/budlayaMxali/buddulloni	n number bahu parsarg loni 
*budlamIxa	n number bahu parsarg mIxa 
*budlana	n number bahu parsarg na 
budlaniMci/buddulniMci/budlanuMci/buddulnuMci/*budlanuMdi/buddulnuMdi	n number bahu parsarg niMci 
*budlaxvArA/budlaxvAra	n number bahu parsarg xvArA 
*budlavalana/budlavalla	n number bahu parsarg valana 
*budlacewa/buddulcewa/budlace/buddulce	n number bahu parsarg batti 
*budlawopAtu/buddulwopAtu	n number bahu parsarg ce 
*budlawokUdi/buddulwokUdi/budlawokUda/budlawokUdA/buddulwokUdA/budlawogUdi/buddulwogUdi/budlawogUda/budlawogUdA/buddulwogUdA	n number bahu parsarg wopAtu 
*budlakosaM/budlakE/budlArWaM	n number bahu parsarg wokUdi 
*budlakoVraku/budlakoVrYaku	n number bahu parsarg kosaM 
*budlalonuMdi/budlalonuMci/buddullonuMdi/buddullonuMci/buddulloniMci/budlaloniMci	n number bahu parsarg koVraku 
*budlamIxanuMdi/budlamIxanuMci/budlamIxaniMci	n number bahu parsarg lonuMdi 
*budlaxAkA/budlaxAka	n number bahu parsarg mIxanuMdi 
*budlavaraku	n number bahu parsarg xAkA 
*budlamIxaki/budlamIxaku/budlamIxiki	n number bahu parsarg varaku 
*budlaxaggara/budlaxaggira	n number bahu parsarg mIxaki 
*budlavaxxa/budduloVxxa	n number bahu parsarg xaggara 
*budlakAda	n number bahu parsarg vaxxa 
budleVxurugA/*budlakeVxurugA	n number bahu parsarg kAda 
*budlamuMxu	n number bahu parsarg keVxurugA 
*budlaguriMci/budlagUrci/budlanuguriMci/budlanugUrci	n number bahu parsarg muMxu 
budlapE/budlapEni/*budlapEna	n number bahu parsarg guriMci 
*budlapEki	n number bahu parsarg pE 
*budlaguMdA	n number bahu parsarg pEki 
budlalA/buddullA/budlulAgA/buddullAgA/*budlalAgA	n number bahu parsarg guMdA 
*budlavale/budlavaleV/budlamAxiri/budlanupolina/budlanubolina	n number bahu parsarg lA 
*budlakumalle/budlakumalleV	n number bahu parsarg vale 
*budlukUdA/budlanukUdA/budlugUdA/budlanugUdA	n number bahu parsarg kimalle 
*budlaxqRtilo/budlaxruRtilo	n number bahu parsarg kUdA 
*budlulekuMdA/buddullekuMdA	n number bahu parsarg xqRtilo 
*budlukAkuMdA/budlukAkuMda/budlukAka/budlugAkuMda/budlugAkuMdA/budlugAka	n number bahu parsarg lekuMdA 
*budlumoVxalukoVni/budlanumoVxalukoVni	n number bahu parsarg kAkuMdA 
*budlavEpu/budlavepu/budlakesi	n number bahu parsarg moVxalukoVni 
budlapakka/budlapakkana/*budlaprakka/budlaprakkana	n number bahu parsarg vEpu 
budlapakkalo/*budlaprakkalo	n number bahu parsarg pakka 
*budlaloki/buddulloki/budlaloniki/buddulloniki/budlalopalaki/budlalopaliki/buddullopaliki/buddullopalaku	n number bahu parsarg pakkalo 
budlakiMxa/*budlakriMxa/budlakriMxana/budlakiMxana	n number bahu parsarg lopalaki 
budladuguna/*budlakaduguna	n number bahu parsarg kiMxa 
budlakeVlla/*budlakalla	n number bahu parsarg aduguna 
budlaveVnuka/budlaveVnaka/*budlaveVnakAla/budlaveVnukAla/budlaveVnakAwala/budlaveVnukAwala	n number bahu parsarg kalla 
*budlawaravAwa/budlawarvAwa/buddulwaravAwa	n number bahu parsarg veVnuka 
budleVxuruguMdA/*budlakeVxuruguMdA	n number bahu parsarg waravAwa 
*budlamaXya/budlamaXyana/budlamaXyalo	n number bahu parsarg eVxuruguMdA 
*budlanaduma/budlakinaduma	n number bahu parsarg maXya 
budlabaxulugA/budlakibaxulugA/budlabaxulu/*budlakibaxulu	n number bahu parsarg naduma 
*budlacotlo/budlacotulo	n number bahu parsarg baxulugA 
budlasWAnaMlo/budlaswAnaMlo/*budlasWAnamulo	n number bahu parsarg cotlo 
budlanerugA/budlakunerugA/*budlakinerugA	n number bahu parsarg sWAnaMlo 
*budlaprakAraM/budlanubatti/budlabatti/budlanibatti	n number bahu parsarg nerugA 
*budlaxaggaranuMdi/budlaxaggiranuMdi/budlaxaggaranuMci/budlaxaggiranuMci	n number bahu parsarg prakAraM 
*budlavaxxanuMdi/budlavaxxanuMci	n number bahu parsarg xaggaranuMdi 
*budlapakkanuMdi/budlapakkanuMci/budlapakkalonuMdi/budlapakkalonuMci	n number bahu parsarg vaxxanuMdi 
*budlalopalanuMdi/buddullopalanuMdi/budlalopalanuMci/buddullopalanuMci/buddullopalinuMdi/budlalopalinuMci	n number bahu parsarg pakkanuMdi 
*budlabEtanuMdi/budlabEtanuMci/budlabEtaniMci	n number bahu parsarg lopalanuMdi 
*budlapEnuMdi/budlapEnuMci/budlapEniMci	n number bahu parsarg bEtanuMdi 
budlakiMxanuMdi/budlakiMxanuMci/budlakiMxaniMci/*budlakriMxanuMdi/budlakriMxanuMci/budlakriMxaniMci	n number bahu parsarg pEnuMdi 
*budladugunuMdi/budladugunuMci/budladuguniMci	n number bahu parsarg kriMxanuMdi 
*budlamuMxunuMdi/budlamuMxunuMci/budlamuMxuniMci	n number bahu parsarg adugunuMdi 
budlaveVnukanuMdi/budlaveVnakanuMdi/*budlaveVnakAlanuMdi/budlaveVnakAlanuMci/budlaveVnukanuMci/budlaveVnakanuMci/budlaveVnakAwalanuMdi/budlaveVnakAwalanuMci	n number bahu parsarg muMxunuMdi 
budleVxutinuMdi/budlakeVxutinuMdi/budleVxutanuMdi/*budlakeVxutanuMdi/budleVxutinuMci/budlakeVxutinuMci/budleVxutanuMci/budlakeVxutanuMci	n number bahu parsarg veVnukanuMdi 
*budlamaXyanuMdi/budlamaXyanuMci/budlamaXyaniMci/budlamaXyalonuMdi/budlamaXyalonuMci/budlamaXyaloniMci	n number bahu parsarg eVxutinuMdi 
*budlanadumanuMdi/budlanadamanuMdi/budlanadumanuMci/budlanadamanuMci	n number bahu parsarg maXyanuMdi 
*budlawaravAwanuMdi/budlawarvAwanuMdi/budlawaravAwanuMci/budlawarvAwanuMci	n number bahu parsarg nadumanuMdi 
*budlacotlonuMdi/budlacotunuMdi/budlacotlonuMci/budlacotloniMci/budlacotunuMci/budlacotuniMci	n number bahu parsarg waravAwanuMdi 
*budlasWAnamunuMdi/budlasWAnaMnuMdi/budlasWAnamunuMci/budlasWAnaMnuMci/budlasWAnaMlonuMdi/budlasWAnamulonuMdi/budlasWAnaMlonuMci/budlasWAnamulonuMci	n number bahu parsarg cotlonuMdi 
*budlayaMxu/budlaMxu	n number bahu parsarg sWAnaMnuMdi 
*budlaMte/budlaMteV	n number bahu parsarg aMxu 
*budlakaMteV/budlakaMte/budlakanna/budlakannA	n number bahu parsarg aMte 
*budlEna	n number bahu parsarg kaMteV 
*budlapAti/budlupAti	n number bahu parsarg Ena 
*budlulAMti/budlulAti	n number bahu parsarg pAti 
*budlugAnI/budlukAnI	n number bahu parsarg lAMti 
*budlugA	n number bahu parsarg gAni 
	n number bahu parsarg gA 
