noun	
baMdi	
*baMdi	n number eka parsarg 0 
-	n number eka parsarg I 
-	n number eka parsarg gA 
*baMdigAdu	n number eka parsarg gAdu 
*baMdigawweV	n number eka parsarg gawweV 
*baMdivAdu/baMdodu/baMdAdu	n number eka parsarg vAdu 
*baMdAyana	n number eka parsarg Ayana 
*baMdivAru/baMdoru/baMdAru	n number eka parsarg vAru 
*baMdixi	n number eka parsarg xi 
*baMdivi/baMdiy/baMdiyyi	n number eka parsarg vi 
*baMdigAru	n number eka parsarg gAru 
*baMdini	n number eka parsarg nu 
baMdivu/*baMdivi	n number eka parsarg vu 
*baMdiyoVkka	n number eka parsarg yoVkka 
*baMdi	n number eka parsarg obl 
*baMdini	n number eka parsarg ni 
*baMdiki/baMdiku	n number eka parsarg ki 
*baMdiwo/baMdiwoda/baMdiwoti	n number eka parsarg wo 
*baMdilo/baMdilona/baMdilopala	n number eka parsarg lo 
*baMdiloni/baMdilopali/baMdiyaMxali	n number eka parsarg loni 
*baMdimIxa	n number eka parsarg mIxa 
*baMdina	n number eka parsarg na 
baMdiniMci/baMdinuMci/*baMdinuMdi	n number eka parsarg niMci 
*baMdixvArA/baMdixvAra	n number eka parsarg xvArA 
*baMdivalana/baMdivalla	n number eka parsarg valana 
*baMdinibatti/baMdibatti	n number eka parsarg batti 
baMdice/*baMdicewa	n number eka parsarg ce 
*baMdiwopAtu	n number eka parsarg wopAtu 
*baMdiwokUdi/baMdiwokUda/baMdiwokUdA/baMdiwogUdi/baMdiwogUdA	n number eka parsarg wokUdi 
*baMdikosaM/baMdikE/baMdArWaM	n number eka parsarg kosaM 
*baMdikoVraku/baMdikoVrYaku	n number eka parsarg koVraku 
*baMdilonuMdi/baMdilonuMci	n number eka parsarg lonuMdi 
*baMdimIxanuMdi/baMdimIxanuMci/baMdimIxinuMci	n number eka parsarg mIxanuMdi 
*baMdixAkA/baMdixAka	n number eka parsarg xAkA 
*baMdivaraku	n number eka parsarg varaku 
*baMdimIxaki/baMdimIxaku/baMdimIxiki	n number eka parsarg mIxaki 
*baMdixaggara/baMdixaggira	n number eka parsarg xaggara 
*baMdivaxxa	n number eka parsarg vaxxa 
*baMdikAda	n number eka parsarg kAda 
*baMdikeVxurugA/baMdeVxurugA	n number eka parsarg keVxurugA 
*baMdimuMxu	n number eka parsarg muMxu 
*baMdiguriMci/baMdiniguriMci/baMdinigUrci	n number eka parsarg guriMci 
baMdipE/*baMdipEna/baMdipEni	n number eka parsarg pE 
*baMdipEki	n number eka parsarg pEki 
*baMdiguMdA	n number eka parsarg guMdA 
baMdilA/baMdilAga/*baMdilAgA	n number eka parsarg lA 
*baMdivale/baMdimAxiri/baMdinipolina/baMdivaleV/baMdinibolina	n number eka parsarg vale 
*baMdikimalle/baMdikimalleV	n number eka parsarg kimalle 
*baMdikUdA/baMdinikUdA/baMdigUdA/baMdinigUdA	n number eka parsarg kUdA 
*baMdixqRtilo/baMdixruRtilo	n number eka parsarg xqRtilo 
*baMdilekuMdA/baMdinilekuMdA/baMdileka	n number eka parsarg lekuMdA 
*baMdikAkuMdA/baMdinikAkuMdA/baMdikAka	n number eka parsarg kAkuMdA 
*baMdimoVxalukoVni/baMdinimoVxalukoVni	n number eka parsarg moVxalukoVni 
*baMdivEpu/baMdivepu/baMdikesi	n number eka parsarg vEpu 
baMdipakka/*baMdiprakka/baMdipakkana/baMdipakkani	n number eka parsarg pakka 
baMdipakkalo/*baMdiprakkalo	n number eka parsarg pakkalo 
*baMdiloki/baMdiloniki/baMdilopalaki/baMdilopalaku/baMdilopaliki	n number eka parsarg lopalaki 
baMdikiMxa/*baMdikriMxa/baMdikriMxane/baMdikiMxane	n number eka parsarg kiMxa 
baMdaduguna/*baMdikaduguna	n number eka parsarg aduguna 
baMdikeVlla/*baMdikalla	n number eka parsarg kalla 
baMdiveVnuka/*baMdiveVnakAla/baMdiveVnakAwala/baMdivenakana	n number eka parsarg veVnuka 
baMdiwaravAwa/baMdiwarvAwa/*baMdiwaruvAwa	n number eka parsarg waravAwa 
baMdeVxuruguMdA/*baMdikeVxuruguMdA	n number eka parsarg eVxuruguMdA 
*baMdimaXya/baMdimaXyalo/baMdimaXyana	n number eka parsarg maXya 
*baMdinaduma/baMdinadama	n number eka parsarg naduma 
baMdibaxulugA/baMdibaxulu/*baMdikibaxulu/baMdinibaxulu	n number eka parsarg baxulugA 
*baMdicotlo/baMdicotulo/baMdicotuna	n number eka parsarg cotlo 
baMdisWAnaMlo/*baMdisWAnamulo	n number eka parsarg sWAnaMlo 
baMdinerugA/baMdikunerugA/*baMdikinerugA	n number eka parsarg nerugA 
*baMdiprakAraM/baMdiprakAramu	n number eka parsarg prakAraM 
*baMdixaggaranuMdi/baMdixaggaranuMci/baMdixaggiranuMdi/baMdixaggiranuMci	n number eka parsarg xaggaranuMdi 
*baMdivaxxanuMdi/baMdivaxxanuMci	n number eka parsarg vaxxanuMdi 
*baMdipakkanuMdi/baMdipakkanuMci/baMdipakkalonuMdi/baMdipakkalonuMci	n number eka parsarg pakkanuMdi 
*baMdilopalanuMdi/baMdilopalanuMci/baMdilopalinuMci/baMdilopalinuMdi	n number eka parsarg lopalanuMdi 
*baMdibEtanuMdi/baMdibEtanuMci	n number eka parsarg bEtanuMdi 
*baMdipEnuMdi/baMdipEnuMci	n number eka parsarg pEnuMdi 
baMdikiMxanuMdi/baMdikiMxanuMci/*baMdikriMxanuMdi/baMdikriMxanuMci	n number eka parsarg kriMxanuMdi 
baMdadugunuMdi/baMdadugunuMci/*baMdikadugunuMdi/baMdikadugunuMci	n number eka parsarg adugunuMdi 
*baMdimuMxunuMdi/baMdimuMxunuMci	n number eka parsarg muMxunuMdi 
baMdiveVnukanuMdi/*baMdiveVnakAlanuMdi/baMdiveVnakAwalanuMdi/baMdiveVnakanuMdi/baMdiveVnukanuMci/baMdiveVnakAlanuMci/baMdiveVnakAwalanuMci/baMdiveVnakanuMci	n number eka parsarg veVnukanuMdi 
baMdeVxutinuMdi/baMdeVxutanuMdi/*baMdikeVxutanuMdi/baMdikeVxutinuMdi/baMdeVxutanuMci/baMdikeVxutanuMci	n number eka parsarg eVxutinuMdi 
*baMdimaXyanuMdi/baMdimaXyanuMci/baMdimaXyalonuMdi/baMdimaXyalonuMci	n number eka parsarg maXyanuMdi 
*baMdinadumanuMdi/baMdinadumanuMci	n number eka parsarg nadumanuMdi 
*baMdiwaravAwanuMdi/baMdiwarvAwanuMdi/baMdiwaravAwanuMci/baMdiwarvAwanuMci	n number eka parsarg waravAwanuMdi 
*baMdicotlonuMdi/baMdicotunuMdi/baMdicotlonuMci/baMdicotunuMci	n number eka parsarg cotlonuMdi 
*baMdisWAnamunuMdi/baMdisWAnaMnuMdi/baMdisWAnamunuMci/baMdisWAnaMnuMci/baMdisWAnaMlonuMdi/baMdisWAnamulonuMdi/baMdisWAnaMlonuMci/baMdiswAnamulonuMci	n number eka parsarg sWAnaMnuMdi 
baMdaMxu/baMdinaMxu/*baMdiyaMxu	n number eka parsarg aMxu 
*baMdaMte/baMdaMteV	n number eka parsarg aMte 
*baMdikaMteV/baMdikaMte/baMdikanna/baMdikannA	n number eka parsarg kaMteV 
*baMdEna	n number eka parsarg Ena 
*baMdipAti	n number eka parsarg pAti 
*baMdilAMti/baMdilAti	n number eka parsarg lAMti 
*baMdigAnI/baMdikAnI	n number eka parsarg gAni 
*baMdigA	n number eka parsarg gA 
*balYlYu/balYlu/baMdlu	n number bahu parsarg 0 
*balYlYU/balYlU/balYlalArA	n number bahu parsarg I 
-	n number bahu parsarg gA 
*balYlYagAdu/balYlagAdu/baMdlagAdu	n number bahu parsarg gAdu 
*balYlYagawweV/balYlagawweV/baMdlagawweV	n number bahu parsarg gawweV 
*balYlYavAdu/balYlavAdu/baMdlavAdu	n number bahu parsarg vAdu 
*balYlYAyana/balYlAyana/baMdlAyana	n number bahu parsarg Ayana 
*balYlYavAru/balYlavAru/baMdlavAru	n number bahu parsarg vAru 
*balYlYaxi/balYlaxi/baMdlaxi	n number bahu parsarg xi 
*balYlYavi/balYlavi/baMdlavi/balYlay/balYlayyi	n number bahu parsarg vi 
*balYlYugAru/balYlugAru/baMdlugAru	n number bahu parsarg gAru 
balYlamu/*balYlYaM/balYaM/baMdlamu/baMdlaM	n number bahu parsarg nu 
*balYlYu/balYlu/baMdlu	n number bahu parsarg vu 
*balYlYayoVkka/balYlayoVkka/baMdlayoVkka	n number bahu parsarg yoVkka 
*balYlYa/balYla/baMdla	n number bahu parsarg obl 
*balYlYani/balYlani/baMdlani/baMdlanu/baMdilni	n number bahu parsarg ni 
*balYlYaki/balYlaki/baMdlaki/balYlaku/baMdlaku	n number bahu parsarg ki 
*balYlYawo/balYlawo/baMdlawoti/balYlawoda/balYlawoti/baMdlawo/baMdlawoda	n number bahu parsarg wo 
*balYlYalo/balYlalo/balYlallo/baMdlalo/baMdlallo/balYlalona/baMdlalona	n number bahu parsarg lo 
*balYlYaloni/balYlaloni/balYlalloni/baMdlaloni/baMdlayaMxali	n number bahu parsarg loni 
*balYlYamIxa/balYlamIxa/baMdlamIxa/balYamIxi	n number bahu parsarg mIxa 
*balYlYana/balYlana/baMdlana/balYana	n number bahu parsarg na 
balYlaniMci/baMdlaniMci/balYlanuMci/baMdlanuMci/*balYlYanuMdi/balYlanuMdi/baMdlanuMdi	n number bahu parsarg niMci 
*balYlYaxvArA/balYlaxvArA/baMdlaxvArA	n number bahu parsarg xvArA 
*balYlYavalana/balYlavalana/balYlavalla/baMdlavalla/baMdlavalana	n number bahu parsarg valana 
*balYlYanubatti	n number bahu parsarg batti 
*balYlYacewa/balYlacewa/baMdlacewa/balYlace/baMdlace	n number bahu parsarg ce 
*balYlYawopAtu/balYlawopAtu/baMdlawopAtu/balYlawobAtu/baMdlawobAtu	n number bahu parsarg wopAtu 
*balYlYawokUdi/balYlawokUdi/baMdlawokUdi/balYlawokUda/baMdlawokUda/balYlawokUdA/baMdlawokUdA/baMdlawogUdA/baMdlawogUdi/balYlawogUdA	n number bahu parsarg wokUdi 
*balYlYakosaM/balYlakosaM/baMdlakosaM/balYlakE/baMdlakE/balYlArWaM	n number bahu parsarg kosaM 
*balYlYakoVraku/balYlakoVraku/baMdlakoVraku/balYlakoVrYaku/baMdlakoVrYaku	n number bahu parsarg koVraku 
*balYlYalonuMdi/balYlalonuMdi/balYlalonuMci/baMdlalonuMdi/baMdlalonuMci/balYlaloniMci/baMdlaloniMci	n number bahu parsarg lonuMdi 
*balYlYamIxanuMdi/balYlamIxanuMdi/baMdlamIxanuMdi/balYlamIxanuMci/baMdlamIxanuMci	n number bahu parsarg mIxanuMdi 
*balYlYaxAkA/balYlaxAkA/baMdlaxAkA/balYlaxAka/baMdlaxAka	n number bahu parsarg xAkA 
*balYlYavaraku/balYlavaraku/baMdlavaraku	n number bahu parsarg varaku 
*balYlYamIxaki/balYlamIxaki/baMdlamIxaki/balYlamIxaku/baMdlamIxaku	n number bahu parsarg mIxaki 
*balYlYaxaggara/balYlaxaggara/baMdlaxaggara/baMdlaxaggira/balYlaxaggira	n number bahu parsarg xaggara 
*balYlYavaxxa/balYlavaxxa/baMdlavaxxa	n number bahu parsarg vaxxa 
*balYlYakAda/balYlakAda/baMdlakAda	n number bahu parsarg kAda 
*balYlYeVxurugA/balYleVxurugA/baMdlakeVxurugA	n number bahu parsarg keVxurugA 
*balYlYamuMxu/balYlamuMxu	n number bahu parsarg muMxu 
*balYlYaguriMci/balYlaguriMci/balYlagUrci/balYlanuguriMci/balYlanigUrci	n number bahu parsarg guriMci 
balYlapE/balYlapEni/*balYlYapEna/balYlapEna	n number bahu parsarg pE 
*balYlYapEki/balYlapEki/baMdlapEki	n number bahu parsarg pEki 
*balYlYaguMdA/balYlaguMdA	n number bahu parsarg guMdA 
balYlalA/baMdlalA/*balYlYalAgA/balYlallAgA/baMdlallAgA/baMdlalAgA/balYlallA/baMdlallA	n number bahu parsarg lA 
*balYlYavale/balYlavale/balYlavaleV/balYlamAxiri/balYlanupolina/balYlanibolina	n number bahu parsarg vale 
*balYlYakumalle/balYlakumalle/baMdlakumalle/balYlakumalle/baMdlakumalleV	n number bahu parsarg kimalle 
*balYlYukUdA/balYlukUdA/baMdlukUdA/baMdlugUdA/balYlugUdA/balYlugUda/baMdlukUda	n number bahu parsarg kUdA 
*balYlYaxqRtilo/balYlaxqRtilo/balYlaxruRtilo/baMdlaxqRtilo/baMdlaxruRtilo	n number bahu parsarg xqRtilo 
*balYlYulekuMdA/balYlulekuMdA/baMdlulekuMdA/balYluleka/baMdluleka	n number bahu parsarg lekuMdA 
*balYlYukAkuMdA/balYlukAkuMdA/baMdlukAkuMda/baMdlukAka/balYlukAka/balYlugAkuMdA/baMdlugAkuMda/baMdlugAka/balYlugAka	n number bahu parsarg kAkuMdA 
baMdlumoVxalukoVni/balYlanumoVxalukoVni/*balYlYumoVxalukoVni	n number bahu parsarg moVxalukoVni 
*balYlYavEpu/balYlavEpu/balYlavepu/baMdlakesi/balYlakesi	n number bahu parsarg vEpu 
balYlapakka/balYlapakkana/*balYlYaprakka/balYlaprakka/balYlaprakkana	n number bahu parsarg pakka 
balYlapakkalo/balYlaprakkalo/*balYlYaprakkalo	n number bahu parsarg pakkalo 
baMdlaloniki/baMdlaloki/*balYlYaloki/balYlaloki/balYlaloniki/balYlalopalaku/balYlalopalaki/balYlalopaliki/baMdlalopaliki/baMdlalopalaku/baMdlalopalaki/baMdlloniki	n number bahu parsarg lopalaki 
balYlakiMxa/*balYlYakriMxa/balYlakriMxa/baMdlakiMxa/balYlakriMxana/balYlakiMxana	n number bahu parsarg kiMxa 
balYladuguna/*balYlYakaduguna/balYlakaduguna/baMdladuguna/baMdlakaduguna	n number bahu parsarg aduguna 
balYlakeVlla/balYlakalla/*balYlYakalla	n number bahu parsarg kalla 
balYlaveVnuka/balYlaveVnaka/*balYlYaveVnakAla/balYlaveVnakAla/baMdlaveVnakAla/baMdlaveVnaka/balYlaveVnakAwala/balYlaveVnukAwala/baMdlaveVnakAwala	n number bahu parsarg veVnuka 
*balYlYawaravAwa/balYlawaravAwa/balYlawarvAwa/baMdlawaravAwa	n number bahu parsarg waravAwa 
baMdleVxuruguMdA/balYlakeVxuruguMdA/*balYlYakeVxuruguMdA	n number bahu parsarg eVxuruguMdA 
*balYlYamaXya/balYlamaXya/balYlamaXyana/balYlamaXyalo/baMdlamaXyalo	n number bahu parsarg maXya 
*balYlYanaduma/balYlanaduma/balYlakinaduma/baMdlanaduma	n number bahu parsarg naduma 
balYlabaxulugA/balYlakibaxulugA/balYlabaxulu/balYlakibaxulu/*balYlYakibaxulu	n number bahu parsarg baxulugA 
*balYlYacotlo/balYlacotlo/balYlacotulo/baMdlacotulo	n number bahu parsarg cotlo 
balYlasWAnaMlo/balYlaswAnaMlo/balYlasWAnamulo/*balYlYasWAnamulo	n number bahu parsarg sWAnaMlo 
balYlanerugA/balYlakunerugA/balYlakinerugA/*balYlYakinerugA	n number bahu parsarg nerugA 
*balYlYaprakAraM/balYlaprakAraM/balYlanubatti/balYlabatti/balYlanibatti/baMdlanubatti	n number bahu parsarg prakAraM 
*balYlYaxaggaranuMdi/balYlaxaggaranuMdi/balYlaxaggiranuMdi/balYlaxaggaranuMci/balYlaxaggiranuMci	n number bahu parsarg xaggaranuMdi 
*balYlYavaxxanuMdi/balYlavaxxanuMdi/balYlavaxxanuMci/baMdlavaxxanuMdi	n number bahu parsarg vaxxanuMdi 
*balYlYapakkanuMdi/balYlapakkanuMdi/balYlapakkanuMci/baMdlapakkanuMci/balYlapakkalonuMdi/balYlapakkalonuMci	n number bahu parsarg pakkanuMdi 
*balYlYalopalanuMdi/balYlalopalanuMdi/baMdlalopalanuMdi/balYlalopalanuMci/baMdlalopalanuMci/baMdlalopalinuMdi/balYlalopalinuMci	n number bahu parsarg lopalanuMdi 
*balYlYabEtanuMdi/balYlabEtanuMdi/balYlabEtanuMci/balYlabEtaniMci	n number bahu parsarg bEtanuMdi 
*balYlYapEnuMdi/balYlapEnuMdi/balYlapEnuMci/balYlapEniMci	n number bahu parsarg pEnuMdi 
balYlakiMxanuMdi/balYlakiMxanuMci/balYlakiMxaniMci/*balYlakriMxanuMdi/balYlakriMxanuMdi/balYlakriMxanuMci/balYlakriMxaniMci	n number bahu parsarg kriMxanuMdi 
*balYlYadugunuMdi/balYladugunuMdi/balYladugunuMci/balYladuguniMci	n number bahu parsarg adugunuMdi 
*balYlYamuMxunuMdi/balYlamuMxunuMdi/balYlamuMxunuMci/balYlamuMxuniMci	n number bahu parsarg muMxunuMdi 
balYlaveVnukanuMdi/balYlaveVnakanuMdi/baMdlaveVnakAlanuMdi/balYlaveVnakAlanuMci/balYlaveVnukanuMci/baMdlaveVnakanuMci/*balYlYaveVnakAlanuMdi/balYlaveVnakAlanuMdi/baMdlaveVnakAwalanuMci	n number bahu parsarg veVnukanuMdi 
baMdleVxutinuMdi/balYlakeVxutinuMdi/baMdleVxutinuMdi/baMdleVxutanuMdi/*balYlYakeVxutanuMdi/balYlakeVxutanuMdi/baMdleVxutanuMdi/baMdleVxutinuMci/balYlakeVxutinuMci/baMdlakeVxutinuMci/baMdleVxutanuMci/balYlakeVxutanuMci/baMdlakeVxutanuMci	n number bahu parsarg eVxutinuMdi 
*balYlYamaXyanuMdi/balYlamaXyanuMdi/balYlamaXyanuMci/balYlamaXyaniMci/balYlamaXyalonuMdi/balYlamaXyalonuMci/balYlamaXyaloniMci	n number bahu parsarg maXyanuMdi 
*balYlYanadumanuMdi/balYlanadumanuMdi/balYlanadamanuMdi/balYlanadumanuMci/balYlanadamanuMci	n number bahu parsarg nadumanuMdi 
*balYlYawaravAwanuMdi/balYlawaravAwanuMdi/balYlawarvAwanuMdi/baMdlawaravAwanuMdi/balYlawaravAwanuMci/balYlawarvAwanuMci/baMdlawarvAwanuMci	n number bahu parsarg waravAwanuMdi 
balYlacotunuMdi/balYlacotunuMci/balYlacotuniMci/baMdlacotunuMdi/baMdlacotunuMci/*balYlYacotlonuMdi/balYlacotlonuMdi/balYlacotlonuMci/balYlacotloniMci/baMdlacotlonuMdi/baMdlacotlonuMci	n number bahu parsarg cotlonuMdi 
*balYlYasWAnamunuMdi/balYlasWAnamunuMdi/balYlasWAnaMnuMdi/balYlasWAnamunuMci/balYlasWAnaMnuMci/balYlasWAnaMlonuMdi/balYlasWAnamulonuMdi/balYlasWAnaMlonuMci/balYlasWAnamulonuMci	n number bahu parsarg sWAnaMnuMdi 
*balYlYayaMxu/balYlayaMxu/balYlaMxu/baMdlaMxu/baMdlayaMxu	n number bahu parsarg aMxu 
*balYlYaMte/balYlaMte/balYlaMteV/baMdlaMte/baMdlaMteV	n number bahu parsarg aMte 
*balYlYakaMteV/balYlakaMteV/balYlakaMte/baMdlakaMte/baMdlakaMteV/baMdlakanna/baMdlakannA/balYlakanna/balYlakannA	n number bahu parsarg kaMteV 
*balYlYEna/balYlEna	n number bahu parsarg Ena 
*balYlYupAti/balYlupAti	n number bahu parsarg pAti 
*balYlYulAMti/balYlulAMti/balYlulAti	n number bahu parsarg lAMti 
*balYlYugAnI/balYlugAnI/balYlukAnI	n number bahu parsarg gAni 
*balYlYugA/balYlugA	n number bahu parsarg gA 
