noun	
cillu	
*cillu	n number eka parsarg 0  case d
-	n number eka parsarg I 
-	n number eka parsarg gA 
*cillugAdu	n number eka parsarg gAdu  case d
*cillugawweV	n number eka parsarg gawweV  case d
*cilluvAdu	n number eka parsarg vAdu  case d
*cilluAyana	n number eka parsarg Ayana  case d
*cilluvAru	n number eka parsarg vAru  case d
*cilluxi	n number eka parsarg xi  case d
*cilluvi	n number eka parsarg vi  case d
*cillugAru	n number eka parsarg gAru  case d
*cillunu	n number eka parsarg nu 
*cilluvu	n number eka parsarg vu  case d
*cilluyoVkka	n number eka parsarg yoVkka 
*cillu	n number eka parsarg obl 
*cilluni/cillunu	n number eka parsarg ni 
*cilluki/cilluku	n number eka parsarg ki 
*cilluwo/cilluwoda/cilluwoti	n number eka parsarg wo 
*cillulo/cillulona/cillulopala	n number eka parsarg lo 
*cilluloni/cillulopali/cillunaMxali	n number eka parsarg loni 
*cillumIxa	n number eka parsarg mIxa 
*cilluna	n number eka parsarg na 
cilluniMci/cillunuMci/*cillunuMdi	n number eka parsarg niMci 
*cilluxvArA	n number eka parsarg xvArA 
*cilluvalana/cilluvalla	n number eka parsarg valana 
*cillunibatti/cillunubatti	n number eka parsarg batti 
cilluce/*cillucewa	n number eka parsarg ce 
*cilluwopAtu	n number eka parsarg wopAtu 
*cilluwokUdi/cilluwokUda/cilluwokUdA/cilluwogUdi/cilluwogUda/cilluwogUdA	n number eka parsarg wokUdi 
*cillukosaM/cillukE/cillArWaM	n number eka parsarg kosaM 
*cillukoVraku/cillukoVrYaku	n number eka parsarg koVraku 
*cillulonuMdi/cillulonuMci	n number eka parsarg lonuMdi 
*cillumIxanuMdi/cillumIxanuMci	n number eka parsarg mIxanuMdi 
*cilluxAkA/cilluxAka	n number eka parsarg xAkA 
*cilluvaraku	n number eka parsarg varaku 
*cillumIxaki/cillumIxaku	n number eka parsarg mIxaki 
*cilluxaggara/cilluxaggira	n number eka parsarg xaggara 
*cilluvaxxa/cilluyoVxxa/cilloVxxa	n number eka parsarg vaxxa 
*cillukAda	n number eka parsarg kAda 
*cillukeVxurugA/cilleVxurugA	n number eka parsarg keVxurugA 
*cillumuMxu	n number eka parsarg muMxu 
*cilluguriMci/cilluguriMci/cilluniguriMci	n number eka parsarg guriMci 
cillupE/*cillupEna/cillupEni	n number eka parsarg pE 
*cillupEki	n number eka parsarg pEki 
*cilluguMdA	n number eka parsarg guMdA 
cillulA/cillulAga/*cillulAgA/cillugA	n number eka parsarg lA 
*cilluvale/cillumAxiri/cillunipolina/cilluvaleV/cillunibolina	n number eka parsarg vale 
*cillukimalle/cillukimalleV	n number eka parsarg kimalle 
*cillukUdA/cillunikUdA/cillugUdA/cillunigUdA	n number eka parsarg kUdA 
*cilluxqRtilo/cilluxruRtilo	n number eka parsarg xqRtilo 
*cillulekuMdA/cillunilekuMdA	n number eka parsarg lekuMdA 
*cillukAkuMdA/cillunikAkuMdA	n number eka parsarg kAkuMdA 
*cillumoVxalukoVni/cillunimoVxalukoVni	n number eka parsarg moVxalukoVni 
*cilluvEpu/cilluvepu/cillukesi	n number eka parsarg vEpu 
cillupakka/*cilluprakka/cillupakkana	n number eka parsarg pakka 
cillupakkalo/*cilluprakkalo	n number eka parsarg pakkalo 
*cilluloki/cilluloniki/cillulopalaki/cillulopaliki/cillulopalaku	n number eka parsarg lopalaki 
cillukiMxa/*cillukriMxa/cillukriMxana/cillukiMxana	n number eka parsarg kiMxa 
cilladuguna/*cillukaduguna	n number eka parsarg aduguna 
cillukeVlla/*cillukalla	n number eka parsarg kalla 
cilluveVnuka/*cilluveVnakAla/cilluveVnakAwala	n number eka parsarg veVnuka 
cilluwaravAwa/cilluwarvAwa/*cilluwaruvAwa	n number eka parsarg waravAwa 
cilleVxuruguMdA/*cillukeVxuruguMdA	n number eka parsarg eVxuruguMdA 
*cillumaXya/cillumaXyalo/cillumaXyana	n number eka parsarg maXya 
*cillunaduma/cillunadama	n number eka parsarg naduma 
cillubaxulugA/cillubaxulu/*cillukibaxulu/cillunibaxulu	n number eka parsarg baxulugA 
*cillucotlo/cillucotulo/cillucotuna	n number eka parsarg cotlo 
*cillusWAnaMlo/cillusWAnamulo	n number eka parsarg sWAnaMlo 
cillunerugA/cillukunerugA/*cillukinerugA	n number eka parsarg nerugA 
*cilluprakAraM/cilluprakAramu	n number eka parsarg prakAraM 
*cilluxaggaranuMdi/cilluxaggaranuMci/cilluxaggiranuMdi/cilluxaggaraniMci	n number eka parsarg xaggaranuMdi 
*cilluvaxxanuMdi/cilluvaxxanuMci	n number eka parsarg vaxxanuMdi 
*cillupakkanuMdi/cillupakkanuMci/cillupakkalonuMdi/cillupakkalonuMci	n number eka parsarg pakkanuMdi 
*cillulopalanuMdi/cillulopalinuMdi/cillulopalanuMci/cillulopalinuMdi	n number eka parsarg lopalanuMdi 
*cillubEtanuMdi/cillubEtanuMci	n number eka parsarg bEtanuMdi 
*cillupEnuMdi/cillupEnuMci	n number eka parsarg pEnuMdi 
cillukiMxanuMdi/cillukiMxanuMci/*cillukriMxanuMdi/cillukriMxanuMci	n number eka parsarg kriMxanuMdi 
cilladuguniMci/cilladugunuMdi/*cillukadugunuMdi/cillukadugunuMci	n number eka parsarg adugunuMdi 
*cillukimuMxunuMdi/cillumuMxunuMci	n number eka parsarg muMxunuMdi 
cilluveVnakanuMdi/cilluveVnukanuMci/cilluveVnakAwalanuMdi/cilluveVnakAwalanuMci/cilluveVnakanuMci/cilluveVnukanuMci/*cilluveVnakAlanuMdi/cilluveVnakAlanuMci/cilluveVnakAwalanuMdi	n number eka parsarg veVnukanuMdi 
cilleVxutinuMdi/cilleVxutanuMci/cillukeVxutinuMci/*cillukeVxutanuMdi	n number eka parsarg eVxutinuMdi 
*cillumaXyanuMdi/cillumaXyanuMci/cillumaXyalonuMdi/cillumaXyalonuMci	n number eka parsarg maXyanuMdi 
*cillunadumanuMdi/cillunadumanuMci	n number eka parsarg nadumanuMdi 
*cilluwaravAwanuMdi/cilluwarvAwanuMdi/cilluwarvAwanuMdi/cilluwarvAwanuMci	n number eka parsarg waravAwanuMdi 
*cillucotlonuMdi/cillucotunuMdi/cillucotlonuMci/cillucotunuMci	n number eka parsarg cotlonuMdi 
cillusWAnaMnuMdi/*cillusWAnamunuMdi/cillusWAnaMnuMci/cillusWAnamunuMci/cillusWAnaMlonuMdi/cillusWAnamulonuMdi/cillusWAnaMlonuMci/cillusWAnamulonuMci	n number eka parsarg sWAnaMnuMdi 
cillaMxu/cillunaMxu/*cilluyaMxu	n number eka parsarg aMxu 
*cillaMte/cillaMteV	n number eka parsarg aMte 
*cillukaMteV/cillukaMte/cillukanna/cillukannA	n number eka parsarg kaMteV 
*cillEna	n number eka parsarg Ena 
*cillupAti	n number eka parsarg pAti 
*cillulAMti/cillulAti	n number eka parsarg lAMti 
*cillugAnI/cillukAnI	n number eka parsarg gAni 
*cillugA	n number eka parsarg gA 
*cillulu	n number bahu parsarg 0  case d
*cillulU/cillulArA	n number bahu parsarg I  case d
-	n number bahu parsarg gA 
*cillulagAdu	n number bahu parsarg gAdu  case d
*cillulagawweV	n number bahu parsarg gawweV  case d
*cillulavAdu	n number bahu parsarg vAdu  case d
*cillulAyana	n number bahu parsarg Ayana  case d
*cillulavAru	n number bahu parsarg vAru  case d
*cillulaxi/cillulxi	n number bahu parsarg xi  case d
*cillulavi/cilluliy	n number bahu parsarg vi  case d
*cillulugAru	n number bahu parsarg gAru  case d
cillulamu/*cillulaM	n number bahu parsarg nu  case d
*cillulu	n number bahu parsarg vu 
*cillulayoVkka	n number bahu parsarg yoVkka 
*cillula	n number bahu parsarg obl 
*cillulani/cillulanu/cillulni	n number bahu parsarg ni 
*cillulaki/cillulaku	n number bahu parsarg ki 
*cillulawo/cillulawoda/cillulawoti	n number bahu parsarg wo 
*cillulalo/cillulalona/cillulalopala	n number bahu parsarg lo 
*cillulaloni/cillulalopali/cillulayaMxali	n number bahu parsarg loni 
*cillulamIxa	n number bahu parsarg mIxa 
*cillulana	n number bahu parsarg na 
cillulaniMci/cillulanuMci/*cillulanuMdi	n number bahu parsarg niMci 
*cillulaxvArA	n number bahu parsarg xvArA 
*cillulavalana/cillulavalla	n number bahu parsarg valana 
*cillulanubatti	n number bahu parsarg batti 
*cillulacewa/cillulace	n number bahu parsarg ce 
*cillulawopAtu/cillulawobAtu	n number bahu parsarg wopAtu 
*cillulawokUdi/cillulawokUda/cillulawokUdA/cillulawogUdi/cillulawogUda/cillulawogUdA	n number bahu parsarg wokUdi 
*cillulakosaM/cillulakE/cillulArWaM	n number bahu parsarg kosaM 
*cillulakoVraku/cillulakoVrYaku	n number bahu parsarg koVraku 
*cillulalonuMdi/cillulalonuMci/cillulaloniMci	n number bahu parsarg lonuMdi 
*cillulamIxanuMdi/cillulamIxanuMci	n number bahu parsarg mIxanuMdi 
*cillulaxAkA	n number bahu parsarg xAkA 
*cillulavaraku	n number bahu parsarg varaku 
*cillulamIxaki/cillulamIxaku	n number bahu parsarg mIxaki 
*cillulaxaggara/cillulaxaggira	n number bahu parsarg xaggara 
*cillulavaxxa	n number bahu parsarg vaxxa 
*cillulakAda	n number bahu parsarg kAda 
*cillulakeVxurugA/cilluleVxurugA	n number bahu parsarg keVxurugA 
*cillulamuMxu	n number bahu parsarg muMxu 
*cillulaguriMci/cillulagUrci/cillulanuguriMci/cillulanigUrci	n number bahu parsarg guriMci 
cillulapE/cillulapEni/*cillulapEna	n number bahu parsarg pE 
*cillulapEki	n number bahu parsarg pEki 
*cillulaguMdA	n number bahu parsarg guMdA 
cillulalA/cillulalAga/*cillulalAgA	n number bahu parsarg lA 
*cillulavale/cillulavaleV/cillulamAxiri/cillulapolina/cillulabolina/cillulanupolina/cillulanubolina	n number bahu parsarg vale 
*cillulakumalle/cillulakumalleV	n number bahu parsarg kimalle 
cillulanukUdA/*cillulukUdA/cillulanugUdA/cillulugUdA/cillulnigUdA/cillulnikUdA	n number bahu parsarg kUdA 
*cillulaxqRtilo/cillulaxruRtilo	n number bahu parsarg xqRtilo 
*cillululekuMdA/cillululekuMdA	n number bahu parsarg lekuMdA 
*cillulukAkuMdA/cillulukAkuMda/cillulugAkuMdA	n number bahu parsarg kAkuMdA 
*cillulumoVxalukoVni	n number bahu parsarg moVxalukoVni 
*cillulavEpu/cillulavepu/cillulakesi	n number bahu parsarg vEpu 
cillulapakka/cillulapakkana/*cillulaprakka/cillulaprakkana	n number bahu parsarg pakka 
cillulapakkalo	n number bahu parsarg pakkalo 
*cillulaloki/cillulaloniki/cillulalopalaki/cillulalopaliki/cillulalopalaku/cillulloniki	n number bahu parsarg lopalaki 
cillulakiMxa/*cillulakriMxa/cillulakriMxana/cillulakiMxana	n number bahu parsarg kiMxa 
cilluladuguna/*cillulakaduguna	n number bahu parsarg aduguna 
cillulakeVlla/*cillulakalla	n number bahu parsarg kalla 
cillulaveVnuka/cillulaveVnaka/*cillulaveVnakAla/cillulaveVnukAla/cillulaveVnakAwala/cillulaveVnukAwala	n number bahu parsarg veVnuka 
cillulawaravAwa/cillulawarvAwa/*cillulawaruvAwa	n number bahu parsarg waravAwa 
cilluleVxuruguMdA/*cillulakeVxuruguMdA	n number bahu parsarg eVxuruguMdA 
*cillulamaXya/cillulamaXyana/cillulamaXyalo	n number bahu parsarg maXya 
*cillulanaduma/cillulakinaduma	n number bahu parsarg naduma 
cillulabaxulugA/cillulakibaxulugA/cillulabaxulu/*cillulakibaxulu	n number bahu parsarg baxulugA 
*cillulacotlo/cillulacotulo	n number bahu parsarg cotlo 
*cillulasWAnaMlo/cillulaswAnaMlo/cillulasWAnamulo	n number bahu parsarg sWAnaMlo 
cillulanerugA/cillulakunerugA/*cillulakinerugA	n number bahu parsarg nerugA 
*cillulaprakAraM/cillulanubatti/cillulabatti/cillulanibatti	n number bahu parsarg prakAraM 
*cillulaxaggaranuMdi/cillulaxaggiranuMdi/cillulaxaggaranuMci/cillulaxaggiranuMci	n number bahu parsarg xaggaranuMdi 
*cillulavaxxanuMdi/cillulavaxxanuMci	n number bahu parsarg vaxxanuMdi 
*cillulapakkanuMdi/cillulapakkanuMci/cillulapakkalonuMdi/cillulapakkalonuMci	n number bahu parsarg pakkanuMdi 
*cillulalopalanuMdi/cillulalopalanuMdi/cillulalopalanuMci/cillulalopalanuMci/cillulalopalinuMdi/cillulalopalinuMci	n number bahu parsarg lopalanuMdi 
*cillulabEtanuMdi/cillulabEtanuMci/cillulabEtaniMci	n number bahu parsarg bEtanuMdi 
*cillulapEnuMdi/cillulapEnuMci/cillulapEniMci	n number bahu parsarg pEnuMdi 
cillulakiMxanuMdi/cillulakiMxanuMci/cillulakiMxaniMci/*cillulakriMxanuMdi/cillulakriMxanuMci/cillulakriMxaniMci	n number bahu parsarg kriMxanuMdi 
*cilluladugunuMdi/cilluladugunuMci/cilluladuguniMci	n number bahu parsarg adugunuMdi 
*cillulamuMxunuMdi/cillulamuMxunuMci/cillulamuMxuniMci	n number bahu parsarg muMxunuMdi 
cillulaveVnukanuMdi/cillulaveVnakanuMdi/*cillulaveVnakAlanuMdi/cillulaveVnakAlanuMci/cillulaveVnukanuMci/cillulaveVnakanuMci/cillulaveVnakAwalanuMdi/cillulaveVnakAwalanuMci	n number bahu parsarg veVnukanuMdi 
cilluleVxutinuMdi/cillulakeVxutinuMdi/cilluleVxutanuMdi/*cillulakeVxutanuMdi/cilluleVxutinuMci/cillulakeVxutinuMci/cilluleVxutanuMci/cillulakeVxutanuMci	n number bahu parsarg eVxutinuMdi 
*cillulamaXyanuMdi/cillulamaXyanuMci/cillulamaXyaniMci/cillulamaXyalonuMdi/cillulamaXyalonuMci/cillulamaXyaloniMci	n number bahu parsarg maXyanuMdi 
*cillulanadumanuMdi/cillulanadamanuMdi/cillulanadumanuMci/cillulanadamanuMci	n number bahu parsarg nadumanuMdi 
*cillulawaravAwanuMdi/cillulawarvAwanuMdi/cillulawaravAwanuMci/cillulawarvAwanuMci	n number bahu parsarg waravAwanuMdi 
cillulacotunuMdi/cillulacotunuMci/cillulacotuniMci/*cillulacotlonuMdi/cillulacotlonuMci/cillulacotloniMci	n number bahu parsarg cotlonuMdi 
*cillulasWAnamunuMdi/cillulasWAnaMnuMdi/cillulasWAnamunuMci/cillulasWAnaMnuMci/cillulasWAnaMlonuMdi/cillulasWAnamulonuMdi/cillulasWAnaMlonuMci/cillulasWAnamulonuMci	n number bahu parsarg sWAnaMnuMdi 
*cillulayaMxu/cillulaMxu	n number bahu parsarg aMxu 
*cillulaMte/cillulaMteV	n number bahu parsarg aMte 
*cillulakaMteV/cillulakaMte/cillulakanna/cillulakannA	n number bahu parsarg kaMteV 
*cillulEna	n number bahu parsarg Ena 
*cillulupAti	n number bahu parsarg pAti 
*cillululAMti/cillululAti	n number bahu parsarg lAMti 
*cillulugAnI/cillulukAnI	n number bahu parsarg gAni 
*cillulugA	n number bahu parsarg gA 
