noun	
cenu	
*cenu	n number eka parsarg 0  case d
-	n number eka parsarg I 
-	n number eka parsarg gA 
*cenugAdu	n number eka parsarg gAdu  case d
*cenugawweV	n number eka parsarg gawweV  case d
*cenuvAdu/cenodu	n number eka parsarg vAdu  case d
*cenAyana	n number eka parsarg Ayana  case d
*cenuvAru/cenoru	n number eka parsarg vAru  case d
cenixi/*cenuxi	n number eka parsarg xi  case d
cenivi/*cenuvi/ceniy	n number eka parsarg vi  case d
*cenugAru	n number eka parsarg gAru  case d
*cenuni	n number eka parsarg nu 
*cenuvu	n number eka parsarg vu  case d
*cenuyoVkka/ceniyoVkka	n number eka parsarg yoVkka 
*cenu/ceni	n number eka parsarg obl 
cenini/*cenunu	n number eka parsarg ni 
ceniki/*cenuku	n number eka parsarg ki 
ceniwo/ceniwoda/ceniwoti/*cenuwo/cenuwoda/cenuwoti	n number eka parsarg wo 
celo/celona/*cenulo/cenulona/cenulopala	n number eka parsarg lo 
*celoni/cenuloni/cenulopali/cenunaMxali	n number eka parsarg loni 
cenimIxa/*cenumIxa	n number eka parsarg mIxa 
*cenuna/cenina	n number eka parsarg na 
ceniniMci/ceninuMci/ceninuMdi/*cenunuMdi/cenunuMci	n number eka parsarg niMci 
cenixvArA/*cenuxvArA/cenixvAra/cenuxvAra	n number eka parsarg xvArA 
cenivalana/cenivalla/cenuvalla/*cenuvalana	n number eka parsarg valana 
ceninibatti/*cenunubatti	n number eka parsarg batti 
cenice/cenicewa/*cenucewa/cenuce	n number eka parsarg ce 
ceniwopAtu/*cenuwopAtu	n number eka parsarg wopAtu 
ceniwokUdi/ceniwokUdA/*cenuwogUdA/cenuwogUdi/ceniwogUdi/ceniwogUdA	n number eka parsarg wokUdi 
cenikosaM/cenikE/*cenukosaM/cenArWaM	n number eka parsarg kosaM 
cenikoVraku/cenikoVrYaku/*cenukoVraku	n number eka parsarg koVraku 
cenilonuMdi/cenilonuMci/ceniloniMci/cenulonuMci/*cenulonuMdi	n number eka parsarg lonuMdi 
cenimIxanuMdi/cenimIxanuMci/cenimIxaniMci/*cenumIxanuMdi/cenumIxanuMci	n number eka parsarg mIxanuMdi 
cenixAkA/cenixAka/cenuxAka/*cenuxAkA	n number eka parsarg xAkA 
cenivaraku/*cenuvaraku	n number eka parsarg varaku 
cenimIxaki/cenimIxaku/cenimIxiki/*cenumIxaku	n number eka parsarg mIxaki 
cenixaggara/cenixaggira/*cenuxaggara/cenuxaggira	n number eka parsarg xaggara 
cenivaxxa/cenoVxxa/*cenuvaxxa	n number eka parsarg vaxxa 
cenikAda/*cenukAda	n number eka parsarg kAda 
cenikeVxurugA/ceneVxurugA/*cenukeVxurugA	n number eka parsarg keVxurugA 
cenimuMxu/*cenumuMxu	n number eka parsarg muMxu 
*cenuguriMci/ceniniguriMci/ceninigUrci/ceniguriMci/cenugUrci/cenunuguriMci	n number eka parsarg guriMci 
cenipE/cenipEna/cenipEni/cenupE/*cenupEna/cenupEni	n number eka parsarg pE 
cenipEki/*cenupEki	n number eka parsarg pEki 
ceniguMdA/*cenuguMdA	n number eka parsarg guMdA 
cenilA/cenilAga/cenilAgA/cenulA/*cenulAgA	n number eka parsarg lA 
cenivale/cenimAxiri/ceninipolina/ceninibolina/cenunubolina/*cenuvale/cenumAxiri	n number eka parsarg vale 
cenikimalle/cenikumalle/*cenukumalle	n number eka parsarg kimalle 
cenikUdA/ceninikUdA/ceninikUda/*cenugUdA/cenunugUdA/cenunigUdA	n number eka parsarg kUdA 
*cenuxqRtilo/cenixqRtilo/cenixruRtilo	n number eka parsarg xqRtilo 
*cenulekuMdA/ceninilekuMdA/cenuleka/cenunulekuMdA	n number eka parsarg lekuMdA 
*cenukAkuMdA/cenugAkuMdA/cenukAka/cenugAka	n number eka parsarg kAkuMdA 
cenimoVxalukoVni/ceninimoVxalukoVni/cenunumoVxalukoVni/*cenumoVxalukoVni	n number eka parsarg moVxalukoVni 
cenivEpu/cenivepu/*cenuvEpu/cenuvepu/cenikesi/cenukesi	n number eka parsarg vEpu 
cenipakka/ceniprakka/cenipakkana/ceniprakkana/cenipakkani/*cenupakka/cenupakkana/cenupakkani	n number eka parsarg pakka 
cenipakkalo/*cenuprakkalo/ceniprakkalo/cenipakkalona/cenipakkaloni	n number eka parsarg pakkalo 
ceniloki/ceniloniki/*cenuloki/cenuloniki/cenilopalaki/cenilopalaku/cenilopaliki/cenulopalaku/cenulopaliki	n number eka parsarg lopalaki 
cenikiMxa/*cenukriMxa/cenikriMxa/cenukiMxa/cenikriMxana/cenikiMxana/cenukiMxana	n number eka parsarg kiMxa 
cenaduguna/cenikaduguna/*cenukaduguna	n number eka parsarg aduguna 
cenikeVlla/cenikalla/*cenukalla	n number eka parsarg kalla 
ceniveVnuka/*cenuveVnakAla/ceniveVnakAla/ceniveVnakAwala/ceniveVnakana/cenuveVnaka/cenuveVnakana	n number eka parsarg veVnuka 
ceniwaravAwa/ceniwarvAwa/*cenuwaruvAwa/ceniwaruvAwa/ceniwaravAwana/ceniwarvAwana/ceniwaruvAwana/cenuwarvAwa/cenuwarvAwana	n number eka parsarg waravAwa 
ceneVxuruguMdA/cenikeVxuruguMdA/*cenukeVxuruguMdA	n number eka parsarg eVxuruguMdA 
cenimaXya/cenimaXyalo/cenimaXyana/*cenumaXyana	n number eka parsarg maXya 
ceninaduma/ceninadumana/*cenunaduma	n number eka parsarg naduma 
cenibaxulugA/cenibaxulu/cenikibaxulu/*cenukubaxulu/cenubaxulu	n number eka parsarg baxulugA 
cenicotlo/cenicotulo/cenicotuna/cenicota/cenucota/cenucotulo/*cenucotlo	n number eka parsarg cotlo 
cenisWAnaMlo/ceniswAnaMlo/*cenusWAnaMlo	n number eka parsarg sWAnaMlo 
ceninerugA/cenikunerugA/cenikinerugA/*cenukunerugA	n number eka parsarg nerugA 
ceniprakAraM/*cenuprakAramu	n number eka parsarg prakAraM 
cenixaggaranuMdi/cenixaggaranuMci/cenixaggiranuMdi/cenixaggiranuMci/*cenuxaggaranuMdi/cenuxaggiranuMdi/cenuxaggaranuMci	n number eka parsarg xaggaranuMdi 
cenivaxxanuMdi/cenivaxxanuMci/cenivaxxaniMci/*cenuvaxxanuMdi/cenuvaxxanuMci	n number eka parsarg vaxxanuMdi 
cenipakkanuMdi/cenipakkanuMci/cenipakkaniMci/*cenupakkanuMdi/cenupakkanuMci/cenipakkalonuMdi/cenipakkalonuMci/cenipakkaloniMci/cenupakkalonuMci/cenupakkalonuMdi	n number eka parsarg pakkanuMdi 
cenilopalanuMdi/cenilopalanuMci/cenilopalaniMci/*cenulopalanuMdi/cenulopalanuMci	n number eka parsarg lopalanuMdi 
cenibEtanuMdi/cenibEtanuMci/cenibEtaniMci/*cenubEtanuMdi/cenubEtanuMci	n number eka parsarg bEtanuMdi 
cenipEnuMdi/cenipEnuMci/cenipEniMci/*cenupEnuMdi/cenupEnuMci	n number eka parsarg pEnuMdi 
cenikiMxanuMdi/cenikiMxanuMci/cenikiMxaniMci/cenukiMxanuMdi/cenukiMxanuMci/cenikriMxanuMdi/*cenukriMxanuMdi/cenikriMxanuMci/cenikriMxaniMci	n number eka parsarg kriMxanuMdi 
*cenadugunuMdi/cenadugunuMci/cenikadugunuMdi/cenikadugunuMci/cenikaduguniMci	n number eka parsarg adugunuMdi 
cenimuMxunuMdi/cenimuMxunuMci/cenimuMxuniMci/*cenumuMxunuMdi/cenumuMxunuMci	n number eka parsarg muMxunuMdi 
ceniveVnukanuMdi/ceniveVnakAlanuMdi/ceniveVnakAwalanuMdi/ceniveVnakanuMdi/*cenuveVnakanuMdi/ceniveVnukanuMci/ceniveVnakAlanuMci/ceniveVnakAwalanuMci/ceniveVnakanuMci/cenuveVnakanuMci	n number eka parsarg veVnukanuMdi 
ceneVxutinuMdi/cenikeVxutinuMdi/cenikeVxutinuMci/ceneVxutinuMci/cenukeVxutinuMdi/ceneVxutanuMdi/cenikeVxutanuMdi/cenikeVxutanuMci/ceneVxutanuMci/*cenukeVxutanuMdi	n number eka parsarg eVxutinuMdi 
cenimaXyanuMdi/cenimaXyanuMci/*cenumaXyanuMdi/cenumaXyanuMci/cenimaXyalonuMdi/cenimaXyalonuMci/cenumaXyalonuMdi/cenumaXyalonuMci	n number eka parsarg maXyanuMdi 
ceninadumanuMdi/ceninadumanuMci/*cenunadumanuMdi	n number eka parsarg nadumanuMdi 
*cenuwaravAwanuMdi/ceniwaravAwanuMdi/ceniwarvAwanuMdi/ceniwaravAwanuMci/ceniwarvAwanuMci	n number eka parsarg waravAwanuMdi 
*cenucotlonuMdi/cenicotlonuMdi/cenicotunuMdi/cenicotlonuMci/cenicotunuMci	n number eka parsarg cotlonuMdi 
cenisWAnaMnuMdi/*cenusWAnamunuMdi/cenisWAnamunuMdi/cenisWAnaMnuMci/cenisWAnamunuMci/cenisWAnaMlonuMdi/cenisWAnamulonuMdi/cenisWAnaMlonuMci/cenisWAnamulonuMci	n number eka parsarg sWAnaMnuMdi 
cenaMxu/ceninaMxu/ceniyaMxu/*cenuyaMxu/cenunaMxu	n number eka parsarg aMxu 
*cenaMte/cenaMteV	n number eka parsarg aMte 
cenikaMteV/cenikaMte/*cenukaMte/cenukanna/cenukannA/cenikanna/cenikannA	n number eka parsarg kaMteV 
*cenEna	n number eka parsarg Ena 
cenipAti/*cenupAti	n number eka parsarg pAti 
*cenulAMti/cenulAti	n number eka parsarg lAMti 
*cenugAnI/cenukAnI	n number eka parsarg gAni 
*cenugA	n number eka parsarg gA 
*celu/cenlu	n number bahu parsarg 0  case d
*celU/celalArA/cenlArA/cenlU	n number bahu parsarg I  case d
-	n number bahu parsarg gA 
*celugAdu/cenlagAdu	n number bahu parsarg gAdu  case d
*celugawweV/cenlagawweV	n number bahu parsarg gawweV  case d
*celavAdu/cenlodu	n number bahu parsarg vAdu  case d
*celAyana/cenlAyana	n number bahu parsarg Ayana  case d
*celavAru/cenloru	n number bahu parsarg vAru  case d
*celaxi/cenlaxi	n number bahu parsarg xi  case d
*celavi/celayyi/celay	n number bahu parsarg vi  case d
*celugAru/cenlugAru	n number bahu parsarg gAru  case d
celamu/*celaM/cenulamu/cenulaM/cenlaM	n number bahu parsarg nu  case d
*celu/cenlu	n number bahu parsarg vu 
*celayoVkka	n number bahu parsarg yoVkka 
*cela	n number bahu parsarg obl 
*celani/cenulni/celanu/celnu	n number bahu parsarg ni 
*celaki/celaku	n number bahu parsarg ki 
*celawo/celwo/celawoda/celawoti/celwoti/celwoda	n number bahu parsarg wo 
*celalo/celallo/celalona/celallona	n number bahu parsarg lo 
*celaloni/celayaMxali/celalloni	n number bahu parsarg loni 
*celamIxa	n number bahu parsarg mIxa 
*celana	n number bahu parsarg na 
celaniMci/celniMci/celanuMci/celnuMci/*celanuMdi/celnuMdi	n number bahu parsarg niMci 
*celaxvArA/celaxvAra	n number bahu parsarg xvArA 
*celavalana/celavalla	n number bahu parsarg valana 
*celanubatti	n number bahu parsarg batti 
*celacewa/celcewa/celace/celce	n number bahu parsarg ce 
*celawopAtu/celawobAtu	n number bahu parsarg wopAtu 
*celawokUdi/celwokUdi/celawokUdA/celawogUdi/celawogUdA/celwogUdA	n number bahu parsarg wokUdi 
*celakosaM/celakE/celArWaM	n number bahu parsarg kosaM 
*celakoVraku/celakoVrYaku	n number bahu parsarg koVraku 
*celalonuMdi/celalonuMci/celallonuMdi/celallonuMci/celalloniMci/celaloniMci	n number bahu parsarg lonuMdi 
*celamIxanuMdi/celamIxanuMci/celamIxaniMci	n number bahu parsarg mIxanuMdi 
*celaxAkA/celaxAka	n number bahu parsarg xAkA 
*celavaraku	n number bahu parsarg varaku 
*celamIxaki/celamIxaku/celamIxiki	n number bahu parsarg mIxaki 
*celaxaggara/celaxaggira	n number bahu parsarg xaggara 
*celavaxxa/celoVxxa	n number bahu parsarg vaxxa 
*celakAda/cenlakAda	n number bahu parsarg kAda 
celeVxurugA/*celakeVxurugA	n number bahu parsarg keVxurugA 
*celamuMxu	n number bahu parsarg muMxu 
*celaguriMci/celagUrci/celanuguriMci/celanigUrci	n number bahu parsarg guriMci 
celapE/celapEni/*celapEna	n number bahu parsarg pE 
*celapEki/cenlapEki	n number bahu parsarg pEki 
*celaguMdA	n number bahu parsarg guMdA 
celalA/celallA/celalAga/celallAga/*celallAgA	n number bahu parsarg lA 
*celavale/celavaleV/celamAxiri/celanupolina/celanubolina	n number bahu parsarg vale 
*celakumalle/cenlakumalle/celakumalleV/cenlakumalleV	n number bahu parsarg kimalle 
*celukUdA/celugUdA/celugUda/celukUda	n number bahu parsarg kUdA 
*celaxqRtilo/celaxruRtilo	n number bahu parsarg xqRtilo 
*celulekuMdA/cellekuMdA/celuleka	n number bahu parsarg lekuMdA 
*celukAkuMdA/celukAkuMda/celukAka	n number bahu parsarg kAkuMdA 
*celumoVxalukoVni/celanumoVxalukoVni	n number bahu parsarg moVxalukoVni 
*celavEpu/celavepu/celakesi	n number bahu parsarg vEpu 
celapakka/celapakkana/*celaprakka/celaprakkana	n number bahu parsarg pakka 
celapakkalo/*celaprakkalo	n number bahu parsarg pakkalo 
*celaloki/celaloniki/celalopalaki/celalopaliki/celalloki/celalloniki/celallopaliki/celallopalaku	n number bahu parsarg lopalaki 
celakiMxa/*celakriMxa/celakriMxana/celakiMxana	n number bahu parsarg kiMxa 
celaduguna/*celakaduguna	n number bahu parsarg aduguna 
celakeVlla/*celakalla	n number bahu parsarg kalla 
celaveVnuka/celaveVnaka/*celaveVnakAla/celaveVnukAla/celaveVnakAwala/celaveVnukAwala	n number bahu parsarg veVnuka 
*celawaruvAwa/celawarvAwa/celawaravAwa	n number bahu parsarg waravAwa 
celeVxuruguMdA/*celakeVxuruguMdA	n number bahu parsarg eVxuruguMdA 
*celamaXya/celamaXyana/celamaXyalo	n number bahu parsarg maXya 
*celanaduma/celakinaduma/celakunaduma	n number bahu parsarg naduma 
celabaxulugA/celakibaxulugA/celabaxulu/*celakibaxulu/celakubaxulu	n number bahu parsarg baxulugA 
*celacotlo/celacotulo	n number bahu parsarg cotlo 
celasWAnaMlo/celaswAnaMlo/*celasWAnamulo	n number bahu parsarg sWAnaMlo 
celanerugA/celakunerugA/*celakinerugA	n number bahu parsarg nerugA 
*celaprakAraM/celanubatti/celabatti/celanibatti	n number bahu parsarg prakAraM 
*celaxaggaranuMdi/celaxaggiranuMdi/celaxaggaranuMci/celaxaggiranuMci	n number bahu parsarg xaggaranuMdi 
*celavaxxanuMdi/celavaxxanuMci	n number bahu parsarg vaxxanuMdi 
*celapakkanuMdi/celapakkanuMci/celapakkalonuMdi/celapakkalonuMci	n number bahu parsarg pakkanuMdi 
*celalopalanuMdi/celallopalanuMdi/celalopalanuMci/celallopalanuMci/celallopalinuMdi/celalopalinuMci	n number bahu parsarg lopalanuMdi 
*celabEtanuMdi/celabEtanuMci/celabEtaniMci	n number bahu parsarg bEtanuMdi 
*celapEnuMdi/celapEnuMci/celapEniMci	n number bahu parsarg pEnuMdi 
celakiMxanuMdi/celakiMxanuMci/celakiMxaniMci/*celakriMxanuMdi/celakriMxanuMci/celakriMxaniMci	n number bahu parsarg kriMxanuMdi 
*celadugunuMdi/celadugunuMci/celaduguniMci	n number bahu parsarg adugunuMdi 
*celamuMxunuMdi/celamuMxunuMci/celamuMxuniMci	n number bahu parsarg muMxunuMdi 
celaveVnukanuMdi/celaveVnakanuMdi/*celaveVnakAlanuMdi/celaveVnukanuMci/celaveVnakAlanuMci/celaveVnakanuMci/celaveVnakAwalanuMci/celaveVnakAwalanuMci	n number bahu parsarg veVnukanuMdi 
celeVxutinuMdi/celakeVxutinuMdi/celeVxutanuMdi/*celakeVxutanuMdi/celeVxutinuMci/celakeVxutinuMci/celeVxutanuMci/celakeVxutanuMci	n number bahu parsarg eVxutinuMdi 
*celamaXyanuMdi/celamaXyanuMci/celamaXyaniMci/celamaXyalonuMdi/celamaXyalonuMci/celamaXyaloniMci	n number bahu parsarg maXyanuMdi 
*celanadumanuMdi/celanadamanuMdi/celanadumanuMci/celanadamanuMci	n number bahu parsarg nadumanuMdi 
*celawaravAwanuMdi/celawarvAwanuMdi/celawaravAwanuMci/celawarvAwanuMci	n number bahu parsarg waravAwanuMdi 
celacotunuMdi/celacotanuMdi/*celacotlonuMdi/celacotlonuMci/celacotloniMci/celacotulonuMci/celacotloniMci	n number bahu parsarg cotlonuMdi 
*celasWAnamunuMdi/celasWAnaMnuMdi/celasWAnamunuMci/celasWAnaMnuMci/celasWAnaMlonuMdi/celasWAnamulonuMdi/celasWAnaMlonuMci/celasWAnamulonuMci	n number bahu parsarg sWAnaMnuMdi 
*celayaMxu/celaMxu	n number bahu parsarg aMxu 
*celaMte/celaMteV	n number bahu parsarg aMte 
*celakaMteV/celakaMte/celakanna/celakannA/cenlakaMte/cenlakannA/cenlakanna	n number bahu parsarg kaMteV 
cenulEna/*celEna	n number bahu parsarg Ena 
cenulupAti/*celapAti	n number bahu parsarg pAti 
cenululAMti/cenululAti/*celalAMti/celalAti	n number bahu parsarg lAMti 
cenulugAnI/cenulukAnI/*celugAnI/celukAnI	n number bahu parsarg gAni 
cenulugA/*celugA	n number bahu parsarg gA 
