noun	
eVn?m?xi	
*eVnimixi	n number eka parsarg 0 
-	n number eka parsarg I 
-	n number eka parsarg gA 
*eVnimixigAdu	n number eka parsarg gAdu 
*eVnimixigawweV	n number eka parsarg gawweV 
*eVnimixivAdu	n number eka parsarg vAdu 
*eVnimixAyana	n number eka parsarg Ayana 
*eVnimixivAru	n number eka parsarg vAru 
*eVnimixixi	n number eka parsarg xi 
*eVnimixivi/eVnimixiy	n number eka parsarg vi 
*eVnimixigAru	n number eka parsarg gAru 
*eVnimixini	n number eka parsarg nu 
*eVnimixivi	n number eka parsarg vu 
*eVnimixiyoVkka	n number eka parsarg yoVkka 
*eVnimixi	n number eka parsarg obl 
*eVnimixini/eVnimixinu	n number eka parsarg ni 
*eVnimixiki/eVnimixiku	n number eka parsarg ki 
*eVnimixiwo/eVnimixiwoda/eVnimixiwoti	n number eka parsarg wo 
*eVnimixilo/eVnimixilona/eVnimixilopala	n number eka parsarg lo 
*eVnimixiloni/eVnimixilopali/eVnimixiyaMxali	n number eka parsarg loni 
*eVnimiximIxa	n number eka parsarg mIxa 
*eVnimixina	n number eka parsarg na 
eVnimixiniMci/eVnimixinuMci/*eVnimixinuMdi	n number eka parsarg niMci 
*eVnimixixvArA/eVnimixixvAra	n number eka parsarg xvArA 
*eVnimixivalana/eVnimixivalla	n number eka parsarg valana 
*eVnimixinibatti	n number eka parsarg batti 
eVnimixice/*eVnimixicewa	n number eka parsarg ce 
eVnimixiwopAtu/eVnimixiwobAtu	n number eka parsarg wopAtu 
*eVnimixiwokUdi/eVnimixiwokUda/eVnimixiwokUdA/eVnimixiwogUdi/eVnimixiwogUda/eVnimixiwogUdA	n number eka parsarg wokUdi 
*eVnimixikosaM/eVnimixikE/eVnimixArWaM	n number eka parsarg kosaM 
*eVnimixikoVraku/eVnimixikoVrYaku	n number eka parsarg koVraku 
*eVnimixilonuMdi/eVnimixilonuMci/eVnimixiloniMci	n number eka parsarg lonuMdi 
*eVnimiximIxanuMdi/eVnimiximIxanuMci/eVnimiximIxaniMci	n number eka parsarg mIxanuMdi 
*eVnimixixAkA/eVnimixixAka	n number eka parsarg xAkA 
*eVnimixivaraku	n number eka parsarg varaku 
*eVnimiximIxaki/eVnimiximIxaku/eVnimiximIxiki	n number eka parsarg mIxaki 
*eVnimixixaggara/eVnimixixaggira	n number eka parsarg xaggara 
*eVnimixivaxxa/eVnimixoVxxa	n number eka parsarg vaxxa 
*eVnimixikAda	n number eka parsarg kAda 
*eVnimixikeVxurugA/eVnimixeVxurugA	n number eka parsarg keVxurugA 
*eVnimiximuMxu	n number eka parsarg muMxu 
*eVnimixiguriMci/eVnimixiniguriMci/eVnimixinugUrci	n number eka parsarg guriMci 
eVnimixipE/*eVnimixipEna/eVnimixipEni	n number eka parsarg pE 
*eVnimixipEki	n number eka parsarg pEki 
*eVnimixiguMdA	n number eka parsarg guMdA 
eVnimixilA/eVnimixilAga/*eVnimixilAgA	n number eka parsarg lA 
*eVnimixivale/eVnimiximAxiri/eVnimixinipolina/eVnimixinibolina	n number eka parsarg vale 
*eVnimixikimalle/eVnimixikimalleV	n number eka parsarg kimalle 
*eVnimixikUdA/eVnimixinikUdA/eVnimixikUda/eVnimixigUdA/eVnimixinigUdA/eVnimixigUda	n number eka parsarg kUdA 
*eVnimixixqRtilo/eVnimixixruRtilo	n number eka parsarg xqRtilo 
*eVnimixilekuMdA/eVnimixinilekuMdA/eVnimixileka/eVnimixileka	n number eka parsarg lekuMdA 
*eVnimixikAkuMdA/eVnimixinikAkuMdA/eVnimixikAka/eVnimixigAka/eVnimixigAkuMdA/eVnimixigAkuMda	n number eka parsarg kAkuMdA 
*eVnimiximoVxalukoVni/eVnimixinimoVxalukoVni/eVnimixinumoVxalukoVni	n number eka parsarg moVxalukoVni 
*eVnimixivEpu/eVnimixivepu/eVnimixikesi	n number eka parsarg vEpu 
eVnimixipakka/eVnimixiprakka/eVnimixipakkana/*eVnimixiprakkana/eVnimixipakkani	n number eka parsarg pakka 
eVnimixipakkalo/*eVnimixiprakkalo/eVnimixipakkalona/eVnimixipakkaloni	n number eka parsarg pakkalo 
*eVnimixiloki/eVnimixiloniki/eVnimixilopalaki/eVnimixilopalaku/eVnimixilopaliki	n number eka parsarg lopalaki 
eVnimixikiMxa/*eVnimixikriMxa/eVnimixikriMxana/eVnimixikiMxana	n number eka parsarg kiMxa 
eVnimixaduguna/*eVnimixikaduguna	n number eka parsarg aduguna 
eVnimixikeVlla/*eVnimixikalla	n number eka parsarg kalla 
eVnimixiveVnuka/*eVnimixiveVnakAla/eVnimixiveVnakAwala/eVnimixiveVnakana	n number eka parsarg veVnuka 
eVnimixiwaravAwa/eVnimixiwarvAwa/*eVnimixiwaruvAwa/eVnimixiwaravAwana/eVnimixiwarvAwana/eVnimixiwaruvAwana	n number eka parsarg waravAwa 
eVnimixeVxuruguMdA/*eVnimixikeVxuruguMdA	n number eka parsarg eVxuruguMdA 
*eVnimiximaXya/eVnimiximaXyalo/eVnimiximaXyana	n number eka parsarg maXya 
*eVnimixinaduma/eVnimixinadumana	n number eka parsarg naduma 
eVnimixibaxulugA/eVnimixibaxulu/*eVnimixikibaxulu/eVnimixikubaxulu	n number eka parsarg baxulugA 
*eVnimixicotlo/eVnimixicotulo/eVnimixicotuna/eVnimixicota	n number eka parsarg cotlo 
*eVnimixisWAnaMlo/eVnimixiswAnaMlo	n number eka parsarg sWAnaMlo 
eVnimixinerugA/eVnimixikunerugA/*eVnimixikinerugA	n number eka parsarg nerugA 
*eVnimixiprakAraM/eVnimixiprakAramu	n number eka parsarg prakAraM 
*eVnimixixaggaranuMdi/eVnimixixaggaranuMci/eVnimixixaggiranuMdi/eVnimixixaggiranuMci	n number eka parsarg xaggaranuMdi 
*eVnimixivaxxanuMdi/eVnimixivaxxanuMci/eVnimixivaxxaniMci	n number eka parsarg vaxxanuMdi 
*eVnimixipakkanuMdi/eVnimixipakkanuMci/eVnimixipakkaniMci/eVnimixipakkalonuMdi/eVnimixipakkalonuMci/eVnimixipakkaloniMci	n number eka parsarg pakkanuMdi 
*eVnimixilopalanuMdi/eVnimixilopalanuMci/eVnimixilopalaniMci	n number eka parsarg lopalanuMdi 
*eVnimixibEtanuMdi/eVnimixibEtanuMci/eVnimixibEtaniMci	n number eka parsarg bEtanuMdi 
*eVnimixipEnuMdi/eVnimixipEnuMci/eVnimixipEniMci	n number eka parsarg pEnuMdi 
eVnimixikiMxanuMdi/eVnimixikiMxanuMci/eVnimixikiMxaniMci/*eVnimixikriMxanuMdi/eVnimixikriMxanuMci/eVnimixikriMxaniMci	n number eka parsarg kriMxanuMdi 
eVnimixadugunuMdi/eVnimixadugunuMci/*eVnimixikadugunuMdi/eVnimixikadugunuMci/eVnimixikaduguniMci	n number eka parsarg adugunuMdi 
*eVnimiximuMxunuMdi/eVnimiximuMxunuMci/eVnimiximuMxuniMci	n number eka parsarg muMxunuMdi 
eVnimixiveVnukanuMdi/*eVnimixiveVnakAlanuMdi/eVnimixiveVnakAwalanuMdi/eVnimixiveVnakanuMdi/eVnimixiveVnukanuMci/eVnimixiveVnakAlanuMci/eVnimixiveVnakAwalanuMci/eVnimixiveVnakanuMci	n number eka parsarg veVnukanuMdi 
eVnimixeVxutinuMdi/eVnimixikeVxutinuMdi/eVnimixikeVxutinuMci/eVnimixeVxutinuMci/eVnimixeVxutanuMdi/*eVnimixikeVxutanuMdi/eVnimixikeVxutanuMci	n number eka parsarg eVxutinuMdi 
*eVnimiximaXyanuMdi/eVnimiximaXyanuMci/eVnimiximaXyalonuMdi/eVnimiximaXyalonuMci	n number eka parsarg maXyanuMdi 
*eVnimixinadumanuMdi/eVnimixinadumanuMci	n number eka parsarg nadumanuMdi 
*eVnimixiwaravAwanuMdi/eVnimixiwarvAwanuMdi/eVnimixiwaravAwanuMci/eVnimixiwarvAwanuMci	n number eka parsarg waravAwanuMdi 
*eVnimixicotlonuMdi/eVnimixicotunuMdi/eVnimixicotlonuMci/eVnimixicotunuMci	n number eka parsarg cotlonuMdi 
eVnimixisWAnaMnuMdi/*eVnimixisWAnamunuMdi/eVnimixisWAnaMnuMci/eVnimixisWAnamunuMci/eVnimixisWAnaMlonuMdi/eVnimixisWAnamulonuMdi/eVnimixisWAnaMlonuMci/eVnimixiswAnamulonuMci	n number eka parsarg sWAnaMnuMdi 
eVnimixaMxu/eVnimixinaMxu/*eVnimixiyaMxu	n number eka parsarg aMxu 
*eVnimixaMte/eVnimixaMteV/eVnimixiyaMte/eVnimixiyaMteV	n number eka parsarg aMte 
*eVnimixikaMteV/eVnimixikaMte/eVnimixikanna/eVnimixikannA	n number eka parsarg kaMteV 
*eVnimixEna	n number eka parsarg Ena 
*eVnimixipAti	n number eka parsarg pAti 
*eVnimixilAMti/eVnimixilAti	n number eka parsarg lAMti 
*eVnimixigAnI/eVnimixikAnI	n number eka parsarg gAni 
*eVnimixigA	n number eka parsarg gA 
eVnumuxulu/*eVnimixulu	n number bahu parsarg 0 
eVnumuxulU/*eVnimixulU/eVnumuxulArA/eVnimixulArA	n number bahu parsarg I 
-	n number bahu parsarg gA 
eVnumuxulugAdu/*eVnimixulagAdu	n number bahu parsarg gAdu 
eVnumuxulugawweV/*eVnimixulagawweV	n number bahu parsarg gawweV 
eVnumuxulavAdu/*eVnimixulavAdu	n number bahu parsarg vAdu 
eVnumuxulAyana/*eVnimixulAyana	n number bahu parsarg Ayana 
eVnumuxulavAru/*eVnimixulavAru	n number bahu parsarg vAru 
eVnumuxulaxi/eVnimixulxi/eVnumuxulxi/*eVnimixulaxi	n number bahu parsarg xi 
eVnumuxulavi/eVnimixulay/*eVnimixulavi	n number bahu parsarg vi 
eVnumuxulagAru/*eVnimixulagAru	n number bahu parsarg gAru 
eVnumuxulaM/*eVnimixulaM/eVnumuxulamu/eVnimixulamu	n number bahu parsarg nu 
eVnumuxulu/*eVnimixulu	n number bahu parsarg vu 
eVnumuxulayoVkka/*eVnimixulayoVkka	n number bahu parsarg yoVkka 
eVnumuxula/*eVnimixula	n number bahu parsarg obl 
eVnumuxulani/eVnimixulni/eVnumuxulanu/*eVnimixulani	n number bahu parsarg ni 
eVnumuxulaku/*eVnimixulaki/eVnimixulaku/eVnumuxulaki	n number bahu parsarg ki 
eVnumuxulawo/*eVnimixulawo/eVnumuxulawoda/eVnumuxulawoti/eVnimixulawoti/eVnimixulawoda	n number bahu parsarg wo 
eVnumuxulalo/eVnumuxullo/eVnumuxulalona/*eVnimixullo/eVnimixulalona	n number bahu parsarg lo 
eVnumuxulaloni/eVnumuxulayaMxali/eVnumuxulloni/*eVnimixulloni	n number bahu parsarg loni 
eVnumuxulamIxa/*eVnimixulamIxa/eVnimixulamIxi/eVnumuxulamIxi	n number bahu parsarg mIxa 
eVnumuxulana/*eVnimixulana/eVnimixulana/eVnumuxulana	n number bahu parsarg na 
eVnumuxulaniMci/eVnimixulaniMci/eVnumuxulanuMci/*eVnimixulanuMdi/eVnumuxulanuMdi/eVnimixulnuMci	n number bahu parsarg niMci 
eVnumuxulaxvArA/eVnimixulaxvAra/*eVnimixulaxvArA/eVnumuxulaxvAra	n number bahu parsarg xvArA 
eVnumuxulavalana/*eVnimixulavalana/eVnimixulavalla	n number bahu parsarg valana 
eVnumuxulacewa/*eVnimixulacewa/eVnumuxulace/eVnimixulace	n number bahu parsarg batti 
eVnumuxulawopAtu/*eVnimixulawopAtu/eVnumuxulawobAtu/eVnimixulawobAtu	n number bahu parsarg ce 
eVnumuxulawokUdi/*eVnimixulawokUdi/eVnumuxulawokUdA/eVnimixulawokUdA/eVnimixulwokUdA/eVnumuxulawogUdi/eVnimixulawogUdi/eVnumuxulawogUdA/eVnimixulawogUdA/eVnimixulwogUdA	n number bahu parsarg wopAtu 
eVnumuxulakosaM/eVnimixulakE/*eVnimixulakosaM/eVnumuxulakE/eVnimixulArWaM	n number bahu parsarg wokUdi 
eVnumuxulakoVraku/*eVnimixulakoVraku	n number bahu parsarg kosaM 
eVnumuxulalonuMdi/eVnumuxulalonuMci/*eVnimixullonuMdi/eVnumuxullonuMdi/eVnimixulloniMci/eVnumuxulalonuMdi	n number bahu parsarg koVraku 
eVnumuxulamIxanuMdi/eVnumuxulamIxanuMci/*eVnimixulamIxanuMdi/eVnimixulamIxaniMci	n number bahu parsarg lonuMdi 
eVnumuxulaxAkA/eVnimixulaxAka/*eVnimixulaxAkA/eVnumuxulaxAka	n number bahu parsarg mIxanuMdi 
eVnumuxulavaraku/*eVnimixulavaraku	n number bahu parsarg xAkA 
eVnumuxulamIxaki/eVnumuxulamIxaku/eVnumuxulamIxiki/eVnimixulamIxiki/*eVnimixulamIxaku	n number bahu parsarg varaku 
eVnumuxulaxaggara/*eVnimixulaxaggara/eVnimixulaxaggira	n number bahu parsarg mIxaki 
eVnumuxulavaxxa/*eVnimixulavaxxa/eVnimixuloVxxa	n number bahu parsarg xaggara 
eVnumuxulakAda/*eVnimixulakAda	n number bahu parsarg vaxxa 
eVnumuxuleVxurugA/*eVnimixulakeVxurugA	n number bahu parsarg kAda 
eVnumuxulamuMxu/*eVnimixulamuMxu	n number bahu parsarg keVxurugA 
eVnumuxulaguriMci/eVnumuxulagUrci/*eVnimixulaguriMci/eVnimixulanuguriMci/eVnimixulanigUrci	n number bahu parsarg muMxu 
eVnumuxulapE/eVnumuxulapEni/*eVnimixulapEna	n number bahu parsarg guriMci 
eVnumuxulapEki/*eVnimixulapEki	n number bahu parsarg pE 
eVnumuxulaguMdA/*eVnimixulaguMdA	n number bahu parsarg pEki 
eVnumuxulalA/eVnimixullA/eVnumuxulalAga/*eVnimixullAga/eVnumuxullAgA	n number bahu parsarg guMdA 
eVnumuxulavale/eVnumuxulavaleV/*eVnimixulavaleV/eVnimixulamAxiri/eVnumuxulanupolina/eVnimixulanubolina/eVnumuxulamAxiri/eVnumuxulapolina/eVnimixulabolina	n number bahu parsarg lA 
eVnumuxulakumalle/*eVnimixulakumalle/eVnumuxulakumalleV/eVnimixulakumalleV	n number bahu parsarg vale 
eVnumuxulukUdA/*eVnimixulugUdA/eVnumuxulukUda/eVnimixulugUda	n number bahu parsarg kimalle 
eVnumuxulaxqRtilo/*eVnimixulaxqRtilo/eVnimixulaxruRtilo	n number bahu parsarg kUdA 
eVnumuxululekuMdA/*eVnimixullekuMdA/eVnumuxululeka	n number bahu parsarg xqRtilo 
*eVnimixulukAkuMdA/eVnumuxulukAkuMdA/eVnumuxulukAka/eVnimixulugAka/eVnimixulukAka/eVnimixulukAka/eVnumuxulugAka	n number bahu parsarg lekuMdA 
eVnumuxulumoVxalukoVni/*eVnimixulumoVxalukoVni/eVnimixulanumoVxalukoVni	n number bahu parsarg kAkuMdA 
eVnumuxulavEpu/*eVnimixulavEpu/eVnimixulavepu/eVnumuxulakesi/eVnimixulakesi	n number bahu parsarg moVxalukoVni 
eVnumuxulapakka/eVnumuxulapakkana/*eVnimixulaprakka/eVnumuxulaprakkana	n number bahu parsarg vEpu 
eVnumuxulapakkalo/*eVnimixulaprakkalo	n number bahu parsarg pakka 
eVnumuxulaloki/*eVnimixulaloki/eVnumuxulaloniki/eVnimixulaloniki/eVnumuxulalopalaki/eVnumuxulalopaliki/eVnimixullopaliki/eVnimixullopalaku	n number bahu parsarg pakkalo 
eVnumuxulakiMxa/*eVnimixulakriMxa/eVnumuxulakriMxana/eVnimixulakiMxana	n number bahu parsarg lopalaki 
eVnumuxuladuguna/*eVnimixulakaduguna	n number bahu parsarg kiMxa 
eVnumuxulakeVlla/*eVnimixulakalla	n number bahu parsarg aduguna 
eVnimixulaveVnuka/eVnumuxulaveVnaka/*eVnimixulaveVnakAla/eVnumuxulaveVnukAla/eVnumuxulaveVnakAwala/eVnimixulaveVnukAwala	n number bahu parsarg kalla 
eVnumuxulawaravAwa/*eVnimixulawaruvAwa/eVnimixulawarvAwa/eVnumuxulwaravAwa	n number bahu parsarg veVnuka 
eVnumuxuleVxuruguMdA/*eVnimixulakeVxuruguMdA	n number bahu parsarg waravAwa 
eVnumuxulamaXya/*eVnimixulamaXya/eVnimixulamaXyana/eVnumuxulamaXyalo	n number bahu parsarg eVxuruguMdA 
eVnumuxulanaduma/*eVnimixulakinaduma	n number bahu parsarg maXya 
eVnumuxulabaxulugA/eVnimixulakibaxulugA/eVnumuxulabaxulu/*eVnimixulakibaxulu	n number bahu parsarg naduma 
eVnumuxulacotlo/*eVnimixulacotlo/eVnimixulacotulo	n number bahu parsarg baxulugA 
eVnumuxulasWAnaMlo/eVnimixulaswAnaMlo/*eVnumuxulasWAnamulo	n number bahu parsarg cotlo 
eVnumuxulanerugA/eVnumuxulakunerugA/*eVnimixulakinerugA	n number bahu parsarg sWAnaMlo 
eVnumuxulaprakAraM/*eVnimixulaprakAraM/eVnumuxulanubatti/eVnumuxulabatti/eVnimixulanibatti	n number bahu parsarg nerugA 
eVnumuxulaxaggaranuMdi/*eVnimixulaxaggaranuMdi/eVnimixulaxaggiranuMdi/eVnumuxulaxaggaranuMci/eVnimixulaxaggiranuMci	n number bahu parsarg prakAraM 
eVnumuxulavaxxanuMdi/*eVnimixulavaxxanuMdi/eVnimixulavaxxanuMci	n number bahu parsarg xaggaranuMdi 
eVnumuxulapakkanuMdi/*eVnimixulapakkanuMdi/eVnimixulapakkanuMci/eVnumuxulapakkalonuMdi/eVnimixulapakkalonuMci	n number bahu parsarg vaxxanuMdi 
eVnumuxulalopalanuMdi/*eVnimixullopalanuMdi/eVnumuxulalopalanuMci/eVnimixullopalanuMci/eVnimixullopalinuMdi/eVnimixulalopalinuMci	n number bahu parsarg pakkanuMdi 
eVnumuxulabEtanuMdi/*eVnimixulabEtanuMdi/eVnimixulabEtanuMci/eVnumuxulabEtaniMci	n number bahu parsarg lopalanuMdi 
eVnumuxulapEnuMdi/eVnumuxulapEnuMci/eVnimixulapEniMci/*eVnimixulapEnuMdi	n number bahu parsarg bEtanuMdi 
eVnumuxulakiMxanuMdi/eVnumuxulakiMxanuMci/eVnimixulakiMxaniMci/eVnumuxulakriMxanuMdi/eVnumuxulakriMxanuMci/eVnimixulakriMxaniMci/*eVnimixulakriMxanuMdi	n number bahu parsarg pEnuMdi 
eVnumuxuladugunuMdi/eVnumuxuladugunuMci/eVnimixuladuguniMci/*eVnimixuladugunuMdi	n number bahu parsarg kriMxanuMdi 
eVnumuxulamuMxunuMdi/eVnumuxulamuMxunuMci/eVnimixulamuMxuniMci/*eVnimixulamuMxunuMdi	n number bahu parsarg adugunuMdi 
eVnumuxulaveVnukanuMdi/eVnumuxulaveVnakanuMdi/*eVnimixulaveVnakAlanuMdi/eVnumuxulaveVnakAlanuMci/eVnumuxulaveVnukanuMci/eVnimixulaveVnakanuMci/eVnumuxulaveVnakAwalanuMdi/eVnimixulaveVnakAwalanuMci	n number bahu parsarg muMxunuMdi 
eVnumuxuleVxutinuMdi/eVnimixulakeVxutinuMdi/eVnumuxuleVxutanuMdi/*eVnimixulakeVxutanuMdi/eVnumuxuleVxutinuMci/eVnimixulakeVxutinuMci/eVnumuxuleVxutanuMci/eVnimixulakeVxutanuMci	n number bahu parsarg veVnukanuMdi 
eVnumuxulamaXyanuMdi/*eVnimixulamaXyanuMdi/eVnimixulamaXyanuMci/eVnimixulamaXyaniMci/eVnumuxulamaXyalonuMdi/eVnimixulamaXyalonuMci/eVnumuxulamaXyaloniMci	n number bahu parsarg eVxutinuMdi 
*eVnimixulanadumanuMdi/eVnimixulanadamanuMdi/eVnumuxulanadumanuMci/eVnumuxulanadamanuMci	n number bahu parsarg maXyanuMdi 
eVnumuxulawaravAwanuMdi/*eVnimixulawaravAwanuMdi/eVnimixulawarvAwanuMdi/eVnumuxulawaravAwanuMci/eVnimixulawarvAwanuMci	n number bahu parsarg nadumanuMdi 
eVnumuxulacotunuMci/eVnimixulacotunuMdi/eVnumuxulacotlonuMci/eVnimixulacotloniMci/eVnumuxulacotlonuMdi/*eVnimixulacotulonuMdi	n number bahu parsarg waravAwanuMdi 
eVnumuxulasWAnamunuMdi/*eVnimixulasWAnaMnuMdi/eVnumuxulasWAnamunuMci/eVnimixulasWAnaMnuMci/eVnumuxulasWAnaMlonuMdi/eVnimixulasWAnamulonuMdi/eVnimixulasWAnaMlonuMci/eVnimixulasWAnamulonuMci	n number bahu parsarg cotlonuMdi 
eVnumuxulayaMxu/*eVnimixulaMxu	n number bahu parsarg sWAnaMnuMdi 
eVnumuxulaMte/*eVnimixulaMteV	n number bahu parsarg aMxu 
eVnumuxulakaMteV/*eVnimixulakaMte/eVnumuxulakannA/eVnimixulakanna/eVnumuxulakaMte/eVnimixulakaMteV/eVnumuxulakanna/eVnimixulakannA	n number bahu parsarg aMte 
eVnumuxulEna/*eVnimixlEna	n number bahu parsarg kaMteV 
eVnumuxulapati/*eVnimixulapAti	n number bahu parsarg Ena 
eVnumuxululAMti/eVnumuxululAti/*eVnimixululAMti/eVnimixululAti	n number bahu parsarg pAti 
eVnumuxulugAnI/eVnumuxulukAnI/*eVnimixulugAnI/eVnimixulukAnI	n number bahu parsarg lAMti 
eVnumuxulugA/*eVnimixulugA	n number bahu parsarg gAni 
	n number bahu parsarg gA 
