noun	
gUdu	
*gUdu	n number eka parsarg 0  case d
-	n number eka parsarg I 
-	n number eka parsarg gA 
*gUdugAdu/gUtigAdu	n number eka parsarg gAdu  case d
*gUdugawweV/gUtigawweV	n number eka parsarg gawweV  case d
*gUduvAdu/gUtivAdu	n number eka parsarg vAdu  case d
*gUdAyana/gUtAyana	n number eka parsarg Ayana  case d
gUduvAru/*gUtivAru	n number eka parsarg vAru  case d
gUduxi/*gUtixi	n number eka parsarg xi  case d
*gUduvi/gUdiy/gUtivi	n number eka parsarg vi  case d
*gUdugAru/gUtigAru	n number eka parsarg gAru  case d
*gUdunu/gUduni/gUtinu/gUtini	n number eka parsarg nu 
gUduvu/*gUduvi/gUtivu/gUtivi	n number eka parsarg vu  case d
*gUtiyoVkka/gUduyoVkka	n number eka parsarg yoVkka 
*gUti/gUdu	n number eka parsarg obl 
*gUdunu/gUtini	n number eka parsarg ni 
gUduki/gUduku/*gUtiki/gUtiku	n number eka parsarg ki 
*gUduwo/gUduwoda/gUduwoti/gUtiwo/gUtiwoda/gUtiwoti	n number eka parsarg wo 
*gUdulo/gUdulona/gUdulopala/gUtilo/gUtilona/gUtilopala/gUtlo/gUtlona/gUtlopala	n number eka parsarg lo 
*gUduloni/gUdulopali/gUtiloni/gUtilopali/gUtiyaMxali/gUtloni/gUtlopali	n number eka parsarg loni 
*gUdumIxa/gUtimIxa	n number eka parsarg mIxa 
*gUduna/gUtina	n number eka parsarg na 
gUduniMci/gUdunuMci/*gUdunuMdi/gUtiniMci/gUtinuMci/gUtinuMdi	n number eka parsarg niMci 
gUduxvArA/*gUtixvArA/gUduxvAra/gUtixvAra	n number eka parsarg xvArA 
*gUduvalana/gUduvalla/gUtivalana/gUtivalla	n number eka parsarg valana 
*gUdunubatti/gUdunibatti/gUdnibatti/gUtinubatti/gUtinibatti	n number eka parsarg batti 
gUduce/*gUducewa/gUtice/gUticewa	n number eka parsarg ce 
*gUduwopAtu/gUduwobAtu/gUtiwopAtu/gUtiwobAtu	n number eka parsarg wopAtu 
*gUduwokUdi/gUduwokUda/gUduwokUdA/gUduwogUda/gUduwogUdA/gUtiwokUdi/gUtiwokUda/gUtiwokUdA/gUtiwogUda/gUtiwogUdA	n number eka parsarg wokUdi 
*gUdukosaM/gUdukE/gUtikosaM/gUtikE/gUdArWaM	n number eka parsarg kosaM 
*gUdukoVraku/gUdukoVrYaku/gUtikoVraku/gUtikoVrYaku	n number eka parsarg koVraku 
gUdulonuMdi/gUdulonuMci/gUdlonuMdi/gUdlonuMci/*gUtilonuMdi/gUtilonuMci/gUtlonuMdi/gUtlonuMci	n number eka parsarg lonuMdi 
*gUdumIxanuMdi/gUdumIxanuMci/gUtimIxanuMdi/gUtimIxanuMci	n number eka parsarg mIxanuMdi 
*gUduxAkA/gUduxAka/gUtixAkA/gUtixAka	n number eka parsarg xAkA 
*gUduvaraku/gUtivaraku	n number eka parsarg varaku 
*gUdumIxaki/gUdumIxaku/gUtimIxaki/gUtimIxaku	n number eka parsarg mIxaki 
*gUduxaggara/gUduxaggira/gUtixaggara/gUtixaggira	n number eka parsarg xaggara 
gUduvaxxa/*gUtivaxxa	n number eka parsarg vaxxa 
gUdukAda/*gUtikAda	n number eka parsarg kAda 
*gUdukeVxurugA/gUdeVxurugA/gUtikeVxurugA	n number eka parsarg keVxurugA 
gUdumuMxu/*gUtimuMxu	n number eka parsarg muMxu 
*gUduguriMci/gUduniguriMci/gUdunigUrci/gUtiguriMci/gUtiniguriMci/gUtinigUrci	n number eka parsarg guriMci 
gUdupE/*gUdupEna/gUdupEni/gUtipE/gUtipEna/gUtipEni	n number eka parsarg pE 
gUdupEki/*gUtipEki	n number eka parsarg pEki 
*gUduguMdA/gUtiguMdA	n number eka parsarg guMdA 
gUdulA/gUdulAga/*gUdulAgA/gUtilA/gUtilAga/gUtilAgA	n number eka parsarg lA 
*gUduvale/gUdumAxiri/gUdunipoli/gUduvaleV/gUdunibolina/gUtivale/gUtimAxiri/gUtinipoli/gUtivaleV/gUtinibolina	n number eka parsarg vale 
*gUdukimalle/gUtikimalle	n number eka parsarg kimalle 
*gUdukUdA/gUdunikUdA/gUdugUdA/gUdunigUdA/gUtinikUdA/gUtinigUdA	n number eka parsarg kUdA 
*gUduxqRtilo/gUduxruRtilo/gUtixqRtilo/gUtixruRtilo	n number eka parsarg xqRtilo 
*gUdulekuMdA/gUduleka/gUtilekuMdA/gUtileka	n number eka parsarg lekuMdA 
*gUdukAkuMdA/gUdukAka/gUdugAka	n number eka parsarg kAkuMdA 
*gUdumoVxalukoVni/gUdunimoVxalukoVni/gUtimoVxalukoVni/gUtinimoVxalukoVni	n number eka parsarg moVxalukoVni 
*gUduvEpu/gUduvepu/gUtivEpu/gUtivepu/gUduvepu/gUtikesi	n number eka parsarg vEpu 
gUdupakka/*gUduprakka/gUdupakkana/gUtipakka/gUtiprakka/gUtipakkana	n number eka parsarg pakka 
gUdupakkalo/*gUduprakkalo/gUtipakkalo/gUtiprakkalo	n number eka parsarg pakkalo 
gUduloki/*gUtiloki/gUduloniki/gUtiloniki/gUdulopalaki/gUdulopalaku/gUdulopaliki/gUtilopalaki/gUtilopalaku/gUtilopaliki	n number eka parsarg lopalaki 
gUdukiMxa/*gUdukriMxa/gUtikiMxa/gUtikriMxa/gUdukriMxane/gUdukiMxane/gUtikriMxane/gUtikiMxane	n number eka parsarg kiMxa 
gUdaduguna/gUdukaduguna/*gUtikaduguna	n number eka parsarg aduguna 
gUdukeVlla/*gUdukalla/gUtikeVlla/gUtikalla	n number eka parsarg kalla 
gUduveVnuka/gUduveVnakAla/gUduveVnakAwala/gUtiveVnuka/*gUtiveVnakAla/gUtiveVnakAwala	n number eka parsarg veVnuka 
gUduwaravAwa/gUduwarvAwa/*gUduwaruvAwa/gUtiwaravAwa/gUtiwarvAwa/gUtiwaruvAwa	n number eka parsarg waravAwa 
gUdeVxuruguMdA/*gUdukeVxuruguMdA/gUtikeVxuruguMdA	n number eka parsarg eVxuruguMdA 
*gUdumaXya/gUdumaXyalo/gUdumaXyana/gUtimaXya/gUtimaXyalo/gUtimaXyana	n number eka parsarg maXya 
*gUdunaduma/gUdunadama/gUtinaduma/gUtinadama	n number eka parsarg naduma 
gUdubaxulugA/gUdubaxulu/*gUdukibaxulu/gUdunibaxulu/gUtibaxulugA/gUtibaxulu/gUtikibaxulu/gUtinibaxulu	n number eka parsarg baxulugA 
*gUducotlo/gUducotulo/gUducotuna/gUticotlo/gUticotulo/gUticotuna	n number eka parsarg cotlo 
gUdusWAnaMlo/*gUdusWAnamulo/gUtisWAnaMlo/gUtisWAnamulo	n number eka parsarg sWAnaMlo 
gUdunerugA/gUdukunerugA/*gUdukinerugA/gUtinerugA/gUtikunerugA/gUtikinerugA	n number eka parsarg nerugA 
*gUduprakAraM/gUduprakAramu/gUtiprakAraM/gUtiprakAramu	n number eka parsarg prakAraM 
*gUduxaggaranuMdi/gUduxaggaranuMci/gUduxaggiranuMdi/gUduxaggiranuMci/gUtixaggaranuMdi/gUtixaggaranuMci/gUtixaggiranuMdi/gUtixaggiranuMci	n number eka parsarg xaggaranuMdi 
*gUduvaxxanuMdi/gUduvaxxanuMci/gUtivaxxanuMdi/gUtivaxxanuMci	n number eka parsarg vaxxanuMdi 
gUdupakkanuMdi/gUdupakkanuMci/*gUtipakkanuMdi/gUtipakkanuMci/gUdupakkalonuMdi/gUdupakkalonuMci/gUtipakkalonuMdi/gUtipakkalonuMci	n number eka parsarg pakkanuMdi 
gUdulopalanuMdi/gUdulopalanuMci/gUdulopalinuMci/gUdulopalinuMdi/*gUtilopalanuMdi/gUtilopalanuMci/gUtilopalinuMci/gUtilopalinuMdi	n number eka parsarg lopalanuMdi 
*gUdubEtanuMdi/gUdubEtanuMci/gUtibEtanuMdi/gUtibEtanuMci	n number eka parsarg bEtanuMdi 
*gUdupEnuMdi/gUdupEnuMci/gUtipEnuMdi/gUtipEnuMci	n number eka parsarg pEnuMdi 
gUdukiMxanuMdi/gUdukiMxanuMci/gUtikiMxanuMdi/gUtikiMxanuMci/*gUdukriMxanuMdi/gUdukriMxanuMci/gUtikriMxanuMdi/gUtikriMxanuMci	n number eka parsarg kriMxanuMdi 
gUdadugunuMdi/gUdadugunuMci/gUdukadugunuMdi/gUdukadugunuMci/*gUtikadugunuMdi/gUtikadugunuMci	n number eka parsarg adugunuMdi 
*gUdumuMxunuMdi/gUdumuMxunuMci/gUtimuMxunuMdi/gUtimuMxunuMci	n number eka parsarg muMxunuMdi 
gUduveVnukanuMdi/gUduveVnakAlanuMdi/gUduveVnakAwalanuMdi/gUduveVnakanuMdi/gUtiveVnukanuMdi/*gUtiveVnakAlanuMdi/gUtiveVnakAwalanuMdi/gUtiveVnakanuMdi/gUduveVnukanuMci/gUduveVnakAlanuMci/gUduveVnakAwalanuMci/gUduveVnakanuMci/gUtiveVnukanuMci/gUtiveVnakAlanuMci/gUtiveVnakAwalanuMci/gUtiveVnakanuMci	n number eka parsarg veVnukanuMdi 
gUdeVxutinuMdi/gUdeVxutanuMdi/gUdukeVxutinuMdi/gUdeVxutinuMci/gUdeVxutanuMci/gUdukeVxutinuMci/*gUtikeVxutinuMdi/gUtikeVxutinuMci	n number eka parsarg eVxutinuMdi 
*gUdumaXyanuMdi/gUdumaXyanuMci/gUtimaXyanuMdi/gUtimaXyanuMci/gUdumaXyalonuMdi/gUdumaXyalonuMci/gUtimaXyalonuMdi/gUtimaXyalonuMci	n number eka parsarg maXyanuMdi 
gUdunadumanuMdi/gUdunadumanuMci/*gUtinadumanuMdi/gUtinadumanuMci	n number eka parsarg nadumanuMdi 
*gUduwaravAwanuMdi/gUduwarvAwanuMdi/gUduwaravAwanuMci/gUduwarvAwanuMci/gUtiwaravAwanuMdi/gUtiwarvAwanuMdi/gUtiwaravAwanuMci/gUtiwarvAwanuMci	n number eka parsarg waravAwanuMdi 
*gUducotlonuMdi/gUducotunuMdi/gUducotlonuMci/gUducotunuMci/gUticotlonuMdi/gUticotunuMdi/gUticotlonuMci/gUticotunuMci	n number eka parsarg cotlonuMdi 
gUdusWAnaMnuMdi/gUdusWAnaMnuMdi/gUdusWAnamunuMci/gUdusWAnaMnuMci/*gUtisWAnaMnuMdi/gUtisWAnaMnuMdi/gUtisWAnamunuMci/gUtisWAnaMnuMci/gUdusWAnaMlonuMdi/gUdusWAnamulonuMdi/gUtisWAnaMlonuMdi/gUtisWAnamulonuMdi/gUdusWAnaMlonuMci/gUduswAnamulonuMci/gUtisWAnaMlonuMci/gUtiswAnamulonuMci	n number eka parsarg sWAnaMnuMdi 
gUdaMxu/gUdunaMxu/gUduyaMxu/gUtinaMxu/*gUtiyaMxu	n number eka parsarg aMxu 
*gUdaMte/gUdaMteV	n number eka parsarg aMte 
*gUdukaMteV/gUdukaMte/gUdukanna/gUdukannA/gUtikaMteV/gUtikaMte/gUtikanna/gUtikannA	n number eka parsarg kaMteV 
*gUdEna	n number eka parsarg Ena 
*gUdupAti/gUtipAti	n number eka parsarg pAti 
*gUdulAMti/gUdulAti/gUtilAMti/gUtilAti	n number eka parsarg lAMti 
*gUdugAnI/gUdukAnI	n number eka parsarg gAni 
*gUdugA/gUtigA	n number eka parsarg gA 
*gUlYlYu/gUlYlu	n number bahu parsarg 0  case d
*gUlYlYU/gUlYlU/gUlYlulArA/gUlYlArA/gUdlU/gUdlulArA/gUdlArA	n number bahu parsarg I  case d
-	n number bahu parsarg gA 
*gUlYlYagAdu/gUlYlugAdu/gUdlagAdu/gUlYlagAdu	n number bahu parsarg gAdu  case d
gUdlagawweV/gUlYlugawweV/*gUlYlYagawweV/gUlYlagawweV	n number bahu parsarg gawweV  case d
*gUlYlYavAdu/gUlYlavAdu/gUdlavAdu	n number bahu parsarg vAdu  case d
*gUlYlYAyana/gUlYlAyana/gUdlAyana	n number bahu parsarg Ayana  case d
*gUlYlYavAru/gUlYlavAru/gUdlavAru	n number bahu parsarg vAru  case d
*gUlYlYaxi/gUlYlaxi/gUdlaxi	n number bahu parsarg xi  case d
*gUlYlYavi/gUlYlavi/gUdlavi	n number bahu parsarg vi  case d
gUlYlagAru/gUdlagAru	n number bahu parsarg gAru  case d
*gUlYlYaM/gUlYlaM/gUlYlamu/gUdlaM/gUdlamu	n number bahu parsarg nu  case d
*gUlYlYu/gUlYlu/gUdlu	n number bahu parsarg vu 
*gUlYlYayoVkka/gUlYlayoVkka/gUdlayoVkka	n number bahu parsarg yoVkka 
*gUlYlYa/gUdla	n number bahu parsarg obl 
*gUlYlYani/gUlYlani/gUlYlanu/gUdlanu/gUdlani	n number bahu parsarg ni 
*gUlYlYaki/gUlYlaki/gUdlaki/gUlYlaku/gUdlaku	n number bahu parsarg ki 
*gUlYlYawo/gUlYlawo/gUdlawo/gUlYlawoda/gUdlawoda/gUdlawo/gUdlawoda	n number bahu parsarg wo 
*gUlYlYallo/gUlYlallo/gUdlallo/gUlYlalo/gUdlalo/gUlYlalona/gUdlalona/gUlYlalopala/gUdlalopala	n number bahu parsarg lo 
*gUlYlYaloni/gUlYlaloni/gUdlaloni/gUlYlalopali/gUdlayaMxali/gUdlalopali	n number bahu parsarg loni 
*gUlYlYamIxa/gUlYlamIxa/gUdlamIxa	n number bahu parsarg mIxa 
*gUlYlYana/gUlYlana/gUdlana	n number bahu parsarg na 
gUlYlaniMci/gUdlaniMci/gUlYlanuMci/gUdlanuMci/*gUlYlYanuMdi/gUlYlanuMdi/gUdlanuMdi	n number bahu parsarg niMci 
*gUlYlYaxvArA/gUlYlaxvArA/gUdlaxvArA	n number bahu parsarg xvArA 
*gUlYlYavalana/gUlYlavalana/gUlYlavalla/gUdlavalana/gUdlavalla/	n number bahu parsarg valana 
*gUlYlYanubatti/gUlYlanubatti/gUdlanubatti	n number bahu parsarg batti 
*gUlYlYacewa/gUlYlacewa/gUdlacewa/gUlYlace/gUdlace	n number bahu parsarg ce 
*gUlYlYawopAtu/gUlYlawopAtu/gUdlawopAtu	n number bahu parsarg wopAtu 
*gUlYlYawokUdi/gUlYlawokUdi/gUdlawokUdi/gUlYlawokUda/gUdlawokUda/gUlYlawokUdA/gUdlawokUdA	n number bahu parsarg wokUdi 
*gUlYlYakosaM/gUlYlakosaM/gUdlakosaM/gUlYlakE/gUdlakE/gUlYlArWaM	n number bahu parsarg kosaM 
*gUlYlYakoVraku/gUlYlakoVraku/gUdlakoVraku/gUlYlakoVrYaku/gUdlakoVrYaku	n number bahu parsarg koVraku 
*gUlYlYalonuMdi/gUlYlalonuMdi/gUlYlalonuMci/gUdlalonuMdi/gUdlalonuMci/gUlYlaloniMci/gUdlaloniMci	n number bahu parsarg lonuMdi 
*gUlYlYamIxanuMdi/gUlYlamIxanuMdi/gUdlamIxanuMdi/gUlYlamIxanuMci/gUdlamIxanuMci	n number bahu parsarg mIxanuMdi 
*gUlYlYaxAkA/gUlYlaxAkA/gUdlaxAkA	n number bahu parsarg xAkA 
*gUlYlYavaraku/gUlYlavaraku/gUdlavaraku	n number bahu parsarg varaku 
*gUlYlYamIxaki/gUlYlamIxaki/gUdlamIxaki/gUlYlamIxaku/gUdlamIxaku	n number bahu parsarg mIxaki 
*gUlYlYaxaggara/gUlYlaxaggara/gUdlaxaggara/gUdlaxaggira/gUlYlaxaggira	n number bahu parsarg xaggara 
*gUlYlYavaxxa/gUlYlavaxxa/gUdlavaxxa	n number bahu parsarg vaxxa 
*gUlYlYakAda/gUlYlakAda/gUdlakAda	n number bahu parsarg kAda 
gUlYleVxurugA/gUdleVxurugA/*gUlYlYakeVxurugA/gUlYlakeVxurugA/gUdlakeVxurugA	n number bahu parsarg keVxurugA 
*gUlYlYamuMxu/gUlYlamuMxu/gUdlamuMxu	n number bahu parsarg muMxu 
*gUlYlYaguriMci/gUlYlaguriMci/gUlYlagUrci/gUlYlanuguriMci/gUlYlanigUrci	n number bahu parsarg guriMci 
gUlYlapE/gUlYlapEni/*gUlYlYapEna/gUlYlapEna	n number bahu parsarg pE 
*gUlYlYapEki/gUlYlapEki/gUdlapEki	n number bahu parsarg pEki 
*gUlYlYaguMdA/gUlYlaguMdA/gUdlaguMdA	n number bahu parsarg guMdA 
gUlYlalA/gUdlalA/gUlYlalAga/*gUlYlYulAgA/gUlYlulAgA/gUdlalAga/gUdlulAgA	n number bahu parsarg lA 
*gUlYlYavale/gUlYlavale/gUlYlavaleV/gUlYlamAxiri/gUlYlanupolina/gUlYlanubolina/gUdlavale/gUdlavaleV/gUdlamAxiri/gUdlanupolina/gUdlanubolina	n number bahu parsarg vale 
*gUlYlYakumalle/gUlYlakumalle/gUdlakumalle/gUlYlakumalleV/gUdlakumalleV	n number bahu parsarg kimalle 
gUdlukUdA/*gUlYlYukUdA/gUlYlukUdA/gUdlugUdA/gUlYlugUdA/gUdlanugUdA/gUlYlanugUdA	n number bahu parsarg kUdA 
*gUlYlYaxqRtilo/gUlYlaxqRtilo/gUlYlaxruRtilo/gUdlaxqRtilo/gUdlaxruRtilo	n number bahu parsarg xqRtilo 
gUdlulekuMdA/gUdluleka/gUlYluleka/*gUlYlYulekuMdA/gUlYlulekuMdA/gUlYluleka	n number bahu parsarg lekuMdA 
gUdlukAkuMdA/gUdlukAka/*gUlYlYukAka/gUlYlukAka/gUlYlugAka/gUdlugAka	n number bahu parsarg kAkuMdA 
*gUlYlYumoVxalukoVni/gUlYlumoVxalukoVni/gUlYlanumoVxalukoVni/gUdlumoVxalukoVni/gUdlanumoVxalukoVni	n number bahu parsarg moVxalukoVni 
*gUlYlYavEpu/gUlYlavEpu/gUlYlavepu/gUdlavEpu/gUlYlakesi/gUdlakesi	n number bahu parsarg vEpu 
gUlYlapakka/gUlYlapakkana/*gUlYlYaprakka/gUlYlaprakka/gUlYlaprakkana/gUdlapakka/gUdlapakkana/gUdlaprakka/gUdlaprakkana	n number bahu parsarg pakka 
gUlYlapakkalo/*gUlYlYaprakkalo/gUlYlaprakkalo/gUdlapakkalo/gUdlaprakkalo	n number bahu parsarg pakkalo 
*gUlYlYaloki/gUlYlaloki/gUlYlaloniki/gUdlaloki/gUdlaloniki/gUlYlalopalaki/gUlYlalopaliki/gUdlalopaliki/gUdlalopalaku	n number bahu parsarg lopalaki 
gUlYlakiMxa/*gUlYlYakriMxa/gUlYlakriMxa/gUdlakiMxa/gUdlakriMxa/gUlYlakriMxane/gUlYlakiMxane/gUdlakiMxane/gUdlakriMxane	n number bahu parsarg kiMxa 
gUlYladuguna/*gUlYlYakaduguna/gUlYlakaduguna/gUdladuguna/gUdlakaduguna	n number bahu parsarg aduguna 
gUlYlakeVlla/*gUlYlYakalla/gUlYlakalla/gUdlakalla/gUdlakeVlla	n number bahu parsarg kalla 
gUlYlaveVnuka/gUlYlaveVnaka/*gUlYlYaveVnakAla/gUlYlaveVnakAla/gUlYlaveVnukAla/gUlYlaveVnakAwala/gUlYlaveVnukAwala/gUdlaveVnakAwala/gUdlaveVnukAwala	n number bahu parsarg veVnuka 
*gUlYlYawaravAwa/gUlYlawaravAwa/gUlYlawarvAwa/gUdlawaravAwa	n number bahu parsarg waravAwa 
gUdleVxuruguMdA/*gUlYlYakeVxuruguMdA/gUlYlakeVxuruguMdA/gUdlakeVxuruguMdA/gUlYleVxuruguMdA	n number bahu parsarg eVxuruguMdA 
*gUlYlYamaXya/gUlYlamaXya/gUlYlamaXyana/gUlYlamaXyalo/gUdlamaXya/gUdlamaXyana/gUdlamaXyalo	n number bahu parsarg maXya 
*gUlYlYanaduma/gUlYlanaduma/gUlYlakinaduma/gUdlanaduma/gUdlakinaduma	n number bahu parsarg naduma 
gUlYlabaxulugA/gUlYlakibaxulugA/gUlYlabaxulu/*gUlYlYakibaxulu/gUlYlakibaxulu	n number bahu parsarg baxulugA 
*gUlYlYacotlo/gUlYlacotlo/gUlYlacotulo/gUdlacotlo/gUdlacotulo	n number bahu parsarg cotlo 
gUlYlasWAnaMlo/gUlYlaswAnaMlo/*gUlYlYasWAnamulo/gUlYlasWAnamulo/gUdlasWAnaMlo/gUdlaswAnaMlo/gUdlasWAnamulo	n number bahu parsarg sWAnaMlo 
gUlYlanerugA/gUlYlakunerugA/*gUlYlYakinerugA/gUlYlakinerugA/gUdlanerugA/gUdlakunerugA/gUdlakinerugA	n number bahu parsarg nerugA 
*gUlYlYaprakAraM/gUlYlaprakAraM/gUlYlanubatti/gUlYlabatti/gUlYlanibatti/gUdlaprakAraM/gUdlanubatti/gUdlabatti/gUdlanibatti	n number bahu parsarg prakAraM 
*gUlYlYaxaggaranuMdi/gUlYlaxaggaranuMdi/gUlYlaxaggiranuMdi/gUlYlaxaggaranuMci/gUlYlaxaggiranuMci/gUdlaxaggaranuMdi/gUdlaxaggiranuMdi/gUdlaxaggaranuMci/gUdlaxaggiranuMci	n number bahu parsarg xaggaranuMdi 
*gUlYlYavaxxanuMdi/gUlYlavaxxanuMdi/gUlYlavaxxanuMci/gUdlavaxxanuMdi/gUdlavaxxanuMci	n number bahu parsarg vaxxanuMdi 
*gUlYlYapakkanuMdi/gUlYlapakkanuMdi/gUlYlapakkanuMci/gUdlapakkanuMdi/gUdlapakkanuMci/gUlYlapakkalonuMdi/gUlYlapakkalonuMci/gUdlapakkalonuMdi/gUdlapakkalonuMci	n number bahu parsarg pakkanuMdi 
*gUlYlYalopalanuMdi/gUlYlalopalanuMdi/gUdlalopalanuMdi/gUlYlalopalanuMci/gUdlalopalanuMci/gUdlalopalinuMdi/gUlYlalopalinuMci	n number bahu parsarg lopalanuMdi 
*gUlYlYabEtanuMdi/gUlYlabEtanuMdi/gUlYlabEtanuMci/gUlYlabEtaniMci/gUdlabEtanuMdi/gUdlabEtanuMci/gUdlabEtaniMci	n number bahu parsarg bEtanuMdi 
*gUlYlYapEnuMdi/gUlYlapEnuMdi/gUlYlapEnuMci/gUlYlapEniMci/gUdlapEnuMdi/gUdlapEnuMci/gUdlapEniMci	n number bahu parsarg pEnuMdi 
gUlYlakiMxanuMdi/gUlYlakiMxanuMci/gUlYlakiMxaniMci/gUdlakiMxanuMdi/gUdlakiMxanuMci/gUdlakiMxaniMci/*gUlYlYakriMxanuMdi/gUlYlakriMxanuMdi/gUlYlakriMxanuMci/gUlYlakriMxaniMci/gUdlakriMxanuMdi/gUdlakriMxanuMci/gUdlakriMxaniMci	n number bahu parsarg kriMxanuMdi 
*gUlYlYadugunuMdi/gUlYladugunuMdi/gUlYladugunuMci/gUlYladuguniMci/gUdladugunuMdi/gUdladugunuMci/gUdladuguniMci	n number bahu parsarg adugunuMdi 
*gUlYlYamuMxunuMdi/gUlYlamuMxunuMdi/gUlYlamuMxunuMci/gUlYlamuMxuniMci/gUdlamuMxunuMdi/gUdlamuMxunuMci/gUdlamuMxuniMci	n number bahu parsarg muMxunuMdi 
gUlYlaveVnukanuMdi/gUlYlaveVnakanuMdi/*gUlYlYaveVnakAlanuMdi/gUlYlaveVnakAlanuMdi/gUdlaveVnukanuMdi/gUlaveVnakanuMdi/gUlaveVnakAlanuMdi/gUlYlaveVnakAlanuMci/gUlYlaveVnukanuMci/gUlYlaveVnakanuMci/gUlaveVnakAlanuMci/gUlaveVnukanuMci/gUlaveVnakanuMci/gUlYlaveVnakAwalanuMdi/gUlYlaveVnakAwalanuMci/gUdlaveVnakAwalanuMdi/gUdlaveVnakAwalanuMci	n number bahu parsarg veVnukanuMdi 
gUdleVxutinuMdi/gUlYlakeVxutinuMdi/gUdleVxutanuMdi/*gUlYlYakeVxutanuMdi/gUlYlakeVxutanuMdi/gUdleVxutinuMci/gUlYlakeVxutinuMci/gUdleVxutanuMci/gUlYlakeVxutanuMci	n number bahu parsarg eVxutinuMdi 
*gUlYlYamaXyanuMdi/gUlYlamaXyanuMdi/gUlYlamaXyanuMci/gUlYlamaXyaniMci/gUdlamaXyanuMdi/gUdlamaXyanuMci/gUdlamaXyaniMci/gUlYlamaXyalonuMdi/gUlYlamaXyalonuMci/gUlYlamaXyaloniMci/gUdlamaXyalonuMdi/gUdlamaXyalonuMci/gUdlamaXyaloniMci	n number bahu parsarg maXyanuMdi 
*gUlYlYanadumanuMdi/gUlYlanadumanuMdi/gUlYlanadamanuMdi/gUlYlanadumanuMci/gUlYlanadamanuMci/gUdlanadumanuMdi/gUdlanadamanuMdi/gUdlanadumanuMci/gUdlanadamanuMci	n number bahu parsarg nadumanuMdi 
*gUlYlYawaravAwanuMdi/gUlYlawaravAwanuMdi/gUlYlawarvAwanuMdi/gUdlawaravAwanuMdi/gUdlawarvAwanuMdi/gUlYlawaravAwanuMci/gUlYlawarvAwanuMci/gUdlawaravAwanuMci/gUdlawarvAwanuMci	n number bahu parsarg waravAwanuMdi 
gUlYlacotunuMdi/gUlYlacotunuMci/gUlYlacotuniMci/gUdlacotunuMdi/gUdlacotunuMci/*gUlYlYacotlonuMdi/gUlYlacotlonuMdi/gUlYlacotlonuMci/gUlYlacotloniMci/gUdlacotlonuMdi/gUdlacotlonuMci	n number bahu parsarg cotlonuMdi 
*gUlYlYasWAnamunuMdi/gUlYlasWAnamunuMdi/gUlYlasWAnaMnuMdi/gUdlasWAnamunuMdi/gUdlasWAnaMnuMdi/gUlYlasWAnamunuMci/gUlYlasWAnaMnuMci/gUdlasWAnamunuMci/gUdlasWAnaMnuMci/gUlYlasWAnaMlonuMdi/gUlYlasWAnamulonuMdi/gUdlasWAnaMlonuMdi/gUdlasWAnamulonuMdi/gUlYlasWAnaMlonuMci/gUlYlasWAnamulonuMci/gUdlasWAnaMlonuMci/gUdlasWAnamulonuMci	n number bahu parsarg sWAnaMnuMdi 
*gUlYlYayaMxu/gUlYlayaMxu/gUlYlaMxu/gUdlayaMxu/gUdlaMxu	n number bahu parsarg aMxu 
*gUlYlYaMte/gUlYlaMte/gUlYlaMteV/gUdlaMte/gUdlaMteV	n number bahu parsarg aMte 
*gUlYlYakaMteV/gUlYlakaMteV/gUlYlakaMte/gUdlakaMteV/gUdlakaMte/gUlYlakanna/gUlYlakannA/gUdlakanna/gUdlakannA	n number bahu parsarg kaMteV 
*gUlYlYEna/gUlYlEna/gUdlEna	n number bahu parsarg Ena 
*gUlYlYapAti/gUlYlapAti/gUdlapAti	n number bahu parsarg pAti 
*gUlYlYalAMti/gUlYalAMti/gUdlalAti/gUlYulAMti/gUdlulAti	n number bahu parsarg lAMti 
*gUlYlYugAnI/gUlYlugAnI/gUdlukAnI/gUdlugAnI/gUdlukAnI	n number bahu parsarg gAni 
*gUlYlYugA/gUlYlugA/gUdlugA	n number bahu parsarg gA 
