noun	
goyi	
*goyi	n number eka parsarg 0 
-	n number eka parsarg I 
-	n number eka parsarg gA 
*goyigAdu/gowigAdu	n number eka parsarg gAdu 
*goyigawweV/gowigawweV	n number eka parsarg gawweV 
*goyivAdu/gowivAdu	n number eka parsarg vAdu 
*goyAyana/gowAyana	n number eka parsarg Ayana 
*goyivAru/gowivAru	n number eka parsarg vAru 
*goyixi/gowixi	n number eka parsarg xi 
*goyivi/gowivi/gowiy/gowiyyi	n number eka parsarg vi 
*goyigAru/gowigAru	n number eka parsarg gAru 
goyinu/gowinu/*goyini/gowini	n number eka parsarg nu 
*goyivi/gowivu/gowivi	n number eka parsarg vu 
*gowiyoVkka/goyiyoVkka	n number eka parsarg yoVkka 
*gowi	n number eka parsarg obl 
*goyini/goyinu/gowini	n number eka parsarg ni 
*goyiki/goyiku/gowiki/gowiku	n number eka parsarg ki 
*goyiwo/goyiwoda/gowiwo/gowiwoda/gowwo	n number eka parsarg wo 
*goyilo/goyilona/gowilo/gowilona/goyilopala/gowilopala	n number eka parsarg lo 
*goyiloni/gowiloni/goyilopali/gowiyaMxali/gowilopali	n number eka parsarg loni 
*goyimIxa/gowimIxa	n number eka parsarg mIxa 
goyina/*gowina	n number eka parsarg na 
goyiniMci/goyinuMci/*goyinuMdi/gowiniMci/gowinuMci/gowinuMdi	n number eka parsarg niMci 
*goyixvArA/gowixvArA/goyixvAra/gowixvAra	n number eka parsarg xvArA 
*goyivalana/goyivalla/gowivalana/gowivalla	n number eka parsarg valana 
gowinibatti/*goyinibatti	n number eka parsarg batti 
goyice/goyicewa/gowice/*gowicewa	n number eka parsarg ce 
*goyiwopAtu/gowiwopAtu/goyiwobAtu/gowiwobAtu/gowwopAtu	n number eka parsarg wopAtu 
*goyiwokUdi/goyiwokUdA/goyiwogUdA/gowiwokUdi/goyiwogUdi/gowiwogUdi/gowwokUdA/gowwogUdA	n number eka parsarg wokUdi 
*goyikosaM/goyikE/gowikosaM/gowikE/goyArWaM	n number eka parsarg kosaM 
*goyikoVraku/goyikoVrYaku/gowikoVraku/gowikoVrYaku	n number eka parsarg koVraku 
goyilonuMdi/goyilonuMci/*gowilonuMdi/gowilonuMci	n number eka parsarg lonuMdi 
*goyimIxanuMdi/goyimIxanuMci/gowimIxanuMdi/gowimIxanuMci	n number eka parsarg mIxanuMdi 
*goyixAkA/goyixAka/gowixAkA/gowixAka	n number eka parsarg xAkA 
*goyivaraku/gowivaraku	n number eka parsarg varaku 
*goyimIxaki/goyimIxaku/gowimIxaki/gowimIxaku	n number eka parsarg mIxaki 
*goyixaggara/gowixaggara	n number eka parsarg xaggara 
*goyivaxxa/gowivaxxa	n number eka parsarg vaxxa 
goyikAda/*gowikAda	n number eka parsarg kAda 
*goyikeVxurugA/goyeVxurugA/gowikeVxurugA	n number eka parsarg keVxurugA 
*goyimuMxu/gowimuMxu	n number eka parsarg muMxu 
*goyiguriMci/goyiniguriMci/gowiguriMci/gowiniguriMci	n number eka parsarg guriMci 
goyipE/*goyipEna/gowipE/gowipEna	n number eka parsarg pE 
*goyipEki/gowipEki	n number eka parsarg pEki 
*goyiguMdA/gowiguMdA	n number eka parsarg guMdA 
goyilA/goyilAga/*goyilAgA/gowilA/gowilAga/gowilAgA	n number eka parsarg lA 
*goyivale/goyimAxiri/goyinipoli/gowivale/gowimAxiri/gowinipoli	n number eka parsarg vale 
*goyikimalle/gowikimalle/goyikimalleV/gowikimalleV	n number eka parsarg kimalle 
*goyikUdA/goyinikUdA/gowinikUdA/goyigUdA/goyinigUdA/gowinigUdA	n number eka parsarg kUdA 
*goyixqRtilo/goyixruRtilo/gowixqRtilo/gowixruRtilo	n number eka parsarg xqRtilo 
*goyilekuMdA/goyinilekuMdA/goyileka/gowinilekuMdA	n number eka parsarg lekuMdA 
*goyikAkuMdA/goyinikAkuMdA/goyikAka/gowinikAkuMdA	n number eka parsarg kAkuMdA 
*goyimoVxalukoVni/goyinimoVxalukoVni/gowinimoVxalukoVni	n number eka parsarg moVxalukoVni 
*goyivEpu/gowivEpu/goyikesi/gowikesi	n number eka parsarg vEpu 
goyipakka/*goyiprakka/goyipakkana/gowipakka/gowiprakka/gowipakkana	n number eka parsarg pakka 
goyipakkalo/*goyiprakkalo/gowipakkalo/gowiprakkalo	n number eka parsarg pakkalo 
*goyiloki/gowiloki/goyiloniki/gowiloniki/goyilopaliki/goyilopalaki/goyilopalaku/gowilopalaki/gowilopalaku/gowilopaliki	n number eka parsarg lopalaki 
goyikiMxa/*goyikriMxa/gowikiMxa/gowikriMxa/goyikriMxana/goyikiMxana/gowikriMxana/gowikiMxana	n number eka parsarg kiMxa 
goyaduguna/*goyikaduguna/gowikaduguna/gowaduguna	n number eka parsarg aduguna 
goyikeVlla/*goyikalla/gowikeVlla/gowikalla	n number eka parsarg kalla 
goyiveVnuka/*goyiveVnakAla/goyiveVnakAwala/gowiveVnuka/gowiveVnakAla/gowiveVnakAwala	n number eka parsarg veVnuka 
goyiwaravAwa/goyiwarvAwa/*goyiwaruvAwa/gowiwaravAwa/gowiwarvAwa/gowiwaruvAwa	n number eka parsarg waravAwa 
goyeVxuruguMdA/*goyikeVxuruguMdA/goweVxuruguMdA/gowikeVxuruguMdA	n number eka parsarg eVxuruguMdA 
*goyimaXya/goyimaXyalo/goyimaXyana/gowimaXya/gowimaXyalo/gowimaXyana	n number eka parsarg maXya 
*goyinaduma/gowinaduma	n number eka parsarg naduma 
goyibaxulugA/goyibaxulu/*goyikibaxulu/gowibaxulu/gowikibaxulu	n number eka parsarg baxulugA 
*goyicotlo/goyicotulo/goyicotuna/gowicotulo/gowicotlo/gowicotuna	n number eka parsarg cotlo 
*goyisWAnaMlo/goyiswAnaMlo/gowisWAnaMlo/gowiswAnaMlo	n number eka parsarg sWAnaMlo 
goyinerugA/*goyikunerugA/goyikinerugA/gowikinerugA	n number eka parsarg nerugA 
*goyiprakAraM/gowiprakAramu	n number eka parsarg prakAraM 
*goyixaggaranuMdi/goyixaggaranuMci/gowixaggaranuMdi/gowixaggaranuMci	n number eka parsarg xaggaranuMdi 
*goyivaxxanuMdi/goyivaxxanuMci/gowivaxxanuMdi/gowivaxxanuMci	n number eka parsarg vaxxanuMdi 
*goyipakkanuMdi/goyipakkanuMci/gowipakkanuMdi/gowipakkanuMci/goyipakkalonuMdi/goyipakkalonuMci/gowipakkalonuMdi/gowipakkalonuMci	n number eka parsarg pakkanuMdi 
*goyilopalanuMdi/goyilopalanuMci/gowilopalanuMdi/gowilopalanuMci	n number eka parsarg lopalanuMdi 
*goyibEtanuMdi/goyibEtanuMci/gowibEtanuMdi/gowibEtanuMci	n number eka parsarg bEtanuMdi 
*goyipEnuMdi/goyipEnuMci/gowipEnuMdi/gowipEnuMci	n number eka parsarg pEnuMdi 
goyikiMxanuMdi/goyikiMxanuMci/gowikiMxanuMdi/gowikiMxanuMci/*goyikriMxanuMdi/goyikriMxanuMci/gowikriMxanuMdi/gowikriMxanuMci	n number eka parsarg kriMxanuMdi 
goyadugunuMdi/goyadugunuMci/*goyikadugunuMdi/goyikadugunuMci/gowikadugunuMdi/gowikadugunuMci	n number eka parsarg adugunuMdi 
*goyimuMxunuMdi/goyimuMxunuMci/gowimuMxunuMdi/gowimuMxunuMci	n number eka parsarg muMxunuMdi 
goyiveVnukanuMdi/*goyiveVnakAlanuMdi/goyiveVnakAwalanuMdi/gowiveVnakanuMdi/gowiveVnakanuMci/goyiveVnukanuMci/goyiveVnakAlanuMci/goyiveVnakAwalanuMci/gowiveVnakAlanuMdi/gowiveVnakAlanuMci	n number eka parsarg veVnukanuMdi 
goyeVxutinuMdi/goyeVxutanuMdi/*goyikeVxutinuMdi/gowikeVxutinuMci/gowikeVxutinuMdi	n number eka parsarg eVxutinuMdi 
*goyimaXyanuMdi/goyimaXyanuMci/gowimaXyanuMdi/gowimaXyanuMci/goyimaXyalonuMdi/goyimaXyalonuMci/gowimaXyalonuMdi/gowimaXyalonuMci	n number eka parsarg maXyanuMdi 
*goyinadumanuMdi/goyinadumanuMci/gowinadumanuMdi/gowinadumanuMci	n number eka parsarg nadumanuMdi 
*goyiwaravAwanuMdi/goyiwarvAwanuMdi/gowiwaravAwanuMdi/gowiwarvAwanuMdi/goyiwaravAwanuMci/goyiwarvAwanuMci/gowiwaravAwanuMci/gowiwarvAwanuMci	n number eka parsarg waravAwanuMdi 
goyicotunuMdi/goyicotunuMci/gowicotunuMci/gowicotunuMdi/*goyicotlonuMdi/goyicotlonuMci/gowicotlonuMdi/gowicotlonuMci	n number eka parsarg cotlonuMdi 
goyisWAnaMnuMdi/*goyisWAnamunuMdi/gowisWAnaMnuMdi/goyisWAnamunuMci/goyisWAnaMnuMci/gowisWAnaMnuMci/gowisWAnamunuMci/goyisWAnaMlonuMdi/gowisWAnamulonuMdi/goyiswAnaMlonuMdi/gowisWAnaMlonuMdi/goyisWAnaMlonuMci/goyisWAnamulonuMci/gowisWAnaMlonuMci/gowisWAnamulonuMci	n number eka parsarg sWAnaMnuMdi 
goyaMxu/goyinaMxu/gowinaMxu/*gowiyaMxu	n number eka parsarg aMxu 
*goyaMte/gowaMte/goyaMteV/gowaMteV	n number eka parsarg aMte 
*goyikaMteV/gowikaMte/gowikaMteV/goyikannA/gowikannA/gowikanna	n number eka parsarg kaMteV 
*goyEna/gowEna	n number eka parsarg Ena 
*goyipAti/gowipAti	n number eka parsarg pAti 
*goyilAMti/goyilAti/gowilAMti/gowilAti	n number eka parsarg lAMti 
*goyigAnI/goyikAnI/gowigAnI/gowikAnI	n number eka parsarg gAni 
*goyigA/gowigA	n number eka parsarg gA 
goyilu/*gowulu	n number bahu parsarg 0 
goyilU/*gowulU/goyilArA/gowulArA	n number bahu parsarg I 
-	n number bahu parsarg gA 
goyilagAdu/*gowulagAdu	n number bahu parsarg gAdu 
goyilagawweV/*gowulagawweV	n number bahu parsarg gawweV 
goyilavAdu/*gowulavAdu	n number bahu parsarg vAdu 
goyilAyana/*gowulAyana	n number bahu parsarg Ayana 
goyilavAru/*gowulavAru	n number bahu parsarg vAru 
goyilaxi/*gowulaxi	n number bahu parsarg xi 
goyilavi/goyilay/*gowulavi	n number bahu parsarg vi 
goyilugAru/*gowulagAru	n number bahu parsarg gAru 
goyilaM/goyilamu/gowulamu/*gowulaM	n number bahu parsarg nu 
goyilu/*gowulu	n number bahu parsarg vu 
goyilayoVkka/*gowulayoVkka	n number bahu parsarg yoVkka 
goyyila/*gowula	n number bahu parsarg obl 
goyilani/goyilni/gowulni/goyilanu/gowulanu/*gowulani	n number bahu parsarg ni 
goyilaki/*gowulaki/goyilaku/gowulaku	n number bahu parsarg ki 
goyilawo/*gowulawo/goyilawoda/gowulawoda/goyyilwo/goyyilwoda	n number bahu parsarg wo 
goyyilallo/goyilalo/*gowulalo/goyillo/gowullo/goyilalona/gowulalona/goyillona/gowullona	n number bahu parsarg lo 
goyilloni/*gowulloni	n number bahu parsarg loni 
goyilamIxa/*gowulamIxa	n number bahu parsarg mIxa 
goyilana/*gowulana	n number bahu parsarg na 
goyilaniMci/gowulaniMci/goyilanuMci/gowulanuMci/goyilanuMdi/*gowulanuMdi	n number bahu parsarg niMci 
goyilaxvArA/*gowulaxvArA	n number bahu parsarg xvArA 
goyilavalana/*gowulavalana/goyilavalla/gowulavalla/goyyilavalana	n number bahu parsarg valana 
goyilacewa/*gowulacewa/goyilace/gowulace	n number bahu parsarg batti 
goyilawopAtu/*gowulawopAtu/goyilawobAtu/gowulawobAtu	n number bahu parsarg ce 
goyilawokUdi/*gowulawokUdi/goyilawogUdi/gowulawogUdA/goyilawogUdA/gowulawokUdA	n number bahu parsarg wopAtu 
goyilakosaM/*gowulakosaM/goyilakE/gowulakE/gowulArWaM	n number bahu parsarg wokUdi 
goyilakoVraku/*gowulakoVraku/goyilakoVrYaku/gowulakoVrYaku	n number bahu parsarg kosaM 
goyilanuMdi/goyilalonuMdi/gowulanuMdi/goyilalonuMci/*gowulalonuMdi/goyillonuMdi/gowullonuMdi/goyilalonuMci/gowulalonuMci/goyillonuMci/gowullonuMci	n number bahu parsarg koVraku 
goyilamIxanuMdi/*gowulamIxanuMdi/goyilamIxanuMci/gowulamIxanuMci	n number bahu parsarg lonuMdi 
goyilaxAkA/*gowulaxAkA/goyilaxAka/gowulaxAka	n number bahu parsarg mIxanuMdi 
goyilavaraku/*gowulavaraku	n number bahu parsarg xAkA 
goyilamIxaki/*gowulamIxaki/goyilamIxaku/gowulamIxaku	n number bahu parsarg varaku 
goyilaxaggara/*gowulaxaggara/gowulaxaggira/goyilaxaggira	n number bahu parsarg mIxaki 
goyilavaxxa/*gowulavaxxa	n number bahu parsarg xaggara 
goyilakAda/*gowulakAda	n number bahu parsarg vaxxa 
goyileVxurugA/*gowulakeVxurugA	n number bahu parsarg kAda 
goyilamuMxu/*gowulamuMxu	n number bahu parsarg keVxurugA 
goyilaguriMci/*gowulaguriMci/goyilanuguriMci/gowulanugUrci/gowulniguriMci	n number bahu parsarg muMxu 
goyilapE/gowulapE/goyilapEna/*gowulapEna/goyilapEni/gowulapEni	n number bahu parsarg guriMci 
goyilapEki/*gowulapEki	n number bahu parsarg pE 
goyilaguMdA/*gowulaguMdA	n number bahu parsarg pEki 
goyilalA/goyyilalA/gowulalA/goyillA/gowullA/goyilalAga/gowulalAga/goyillAgA/*gowullAgA	n number bahu parsarg guMdA 
goyilavale/*gowulavale/goyilamAxiri/gowulamAxiri/goyilanupolina/gowulanupolina	n number bahu parsarg lA 
goyilakumalle/*gowulakumalle/goyilakumalleV/gowulakumalleV	n number bahu parsarg vale 
goyilukUdA/*gowulukUdA/goyilugUdA/gowulugUdA	n number bahu parsarg kimalle 
goyilaxqRtilo/*gowulaxqRtilo/goyilaxruRtilo/gowulaxruRtilo	n number bahu parsarg kUdA 
goyilulekuMdA/*gowululekuMdA/goyiluleka/gowululeka	n number bahu parsarg xqRtilo 
goyilukAkuMdA/*gowulukAkuMdA/goyilukAka/gowulukAka/goyilugAkuMdA/gowulugAkuMdA/goyilugAka/gowulugAka	n number bahu parsarg lekuMdA 
goyilumoVxalukoVni/*gowulumoVxalukoVni	n number bahu parsarg kAkuMdA 
goyilavEpu/*gowulavEpu/goyilavepu/gowulavepu/goyilakesi/gowulakesi	n number bahu parsarg moVxalukoVni 
goyilapakka/gowulapakka/goyilaprakka/goyilapakkana/*gowulaprakka/gowulapakkana	n number bahu parsarg vEpu 
goyilapakkalo/gowulapakkalo/goyilaprakkalo/*gowulaprakkalo	n number bahu parsarg pakka 
goyilloki/*gowulloki/goyilloniki/gowulloniki/goyilalopalaki/gowulalopalaki/goyillopaliki/gowullopaliki/goyilalopalaku/gowulalopalaku/goyillopalaku/gowullopalaku	n number bahu parsarg pakkalo 
goyilakiMxa/gowulakiMxa/*goyilakriMxa/gowulakriMxa/goyilakriMxana/gowulakriMxana/goyilakiMxana/gowulakiMxana	n number bahu parsarg lopalaki 
goyiladuguna/gowuladuguna/goyilakaduguna/*gowulakaduguna	n number bahu parsarg kiMxa 
goyilakeVlla/gowulakeVlla/goyilakalla/*gowulakalla	n number bahu parsarg aduguna 
goyilaveVnuka/gowulaveVnuka/goyilaveVnakAla/*gowulaveVnakAla/goyilaveVnakAwala/gowulaveVnakAwala	n number bahu parsarg kalla 
goyilawaravAwa/*gowulawaravAwa/goyilawarvAwa/gowulawarvAwa	n number bahu parsarg veVnuka 
goyileVxuruguMdA/*gowulakeVxuruguMdA	n number bahu parsarg waravAwa 
goyilamaXya/*gowulamaXya/goyilamaXyalo/gowulamaXyalo	n number bahu parsarg eVxuruguMdA 
goyilanaduma/*gowulanaduma	n number bahu parsarg maXya 
goyilabaxulugA/gowulabaxulugA/goyilabaxulu/*gowulabaxulu	n number bahu parsarg naduma 
goyilacotlo/*gowulacotlo/goyilacotulo/gowulacotulo	n number bahu parsarg baxulugA 
goyilasWAnaMlo/*gowulasWAnaMlo/goyilaswAnaMlo/gowulaswAnaMlo/goyilanerugA/gowulanerugA/goyilakunerugA/gowulakunerugA/goyilakinerugA/gowulakinerugA	n number bahu parsarg cotlo 
goyilaprakAraM/*gowulaprakAraM/goyilabatti/gowulabatti	n number bahu parsarg sWAnaMlo 
goyilaxaggaranuMdi/*gowulaxaggaranuMdi/goyilaxaggaranuMci/gowulaxaggaranuMci	n number bahu parsarg nerugA 
goyilavaxxanuMdi/*gowulavaxxanuMdi/goyilavaxxanuMci/gowulavaxxanuMci	n number bahu parsarg prakAraM 
goyilapakkanuMdi/*gowulapakkanuMdi/goyilapakkanuMci/gowulapakkanuMci/goyilapakkalonuMdi/gowulapakkalonuMdi/goyilapakkalonuMci/gowulapakkalonuMci	n number bahu parsarg xaggaranuMdi 
goyilalopalanuMdi/goyillopalanuMdi/*gowulalopalanuMdi/goyillopalanuMdi/gowullopalanuMdi/goyilalopalanuMci/gowulalopalanuMci/goyillopalanuMci/gowullopalanuMci	n number bahu parsarg vaxxanuMdi 
goyilabEtanuMdi/*gowulabEtanuMdi/goyilabEtanuMci/gowulabEtanuMci	n number bahu parsarg pakkanuMdi 
goyilapEnuMdi/*gowulapEnuMdi/goyilapEnuMci/gowulapEnuMci	n number bahu parsarg lopalanuMdi 
goyilakiMxanuMdi/gowulakiMxanuMdi/goyilakiMxanuMci/gowulakiMxanuMci/goyilakriMxanuMdi/*gowulakriMxanuMdi/goyilakriMxanuMci/gowulakriMxanuMci	n number bahu parsarg bEtanuMdi 
goyiladugunuMdi/*gowuladugunuMdi/goyiladugunuMci/gowuladugunuMci	n number bahu parsarg pEnuMdi 
goyilamuMxunuMdi/*gowulamuMxunuMdi/goyilamuMxunuMci/gowulamuMxunuMci	n number bahu parsarg kriMxanuMdi 
goyilaveVnukanuMdi/gowulaveVnukanuMdi/goyilaveVnakAlanuMdi/*gowulaveVnakAlanuMdi/goyilaveVnukanuMci/gowulaveVnukanuMci/goyilaveVnakAlanuMci/gowulaveVnakAlanuMci/goyilaveVnakAwalanuMdi/gowulaveVnakAwalanuMdi/goyilaveVnakAwalanuMci/gowulaveVnakAwalanuMci	n number bahu parsarg adugunuMdi 
goyileVxutinuMdi/gowuleVxutinuMdi/gowulakeVxutinuMdi/goyileVxutanuMdi/gowuleVxutanuMdi/*gowulakeVxutanuMdi/goyileVxutinuMci/gowuleVxutinuMci/gowulakeVxutinuMci	n number bahu parsarg muMxunuMdi 
goyilamaXyanuMdi/*gowulamaXyanuMdi/goyilamaXyanuMci/gowulamaXyanuMci/goyilamaXyalonuMdi/gowulamaXyalonuMdi/goyilamaXyalonuMci/gowulamaXyalonuMci	n number bahu parsarg veVnukanuMdi 
goyilanadumanuMdi/*gowulanadumanuMdi/goyilanadumanuMci/gowulanadumanuMci	n number bahu parsarg eVxutinuMdi 
goyilawaravAwanuMdi/*gowulawaravAwanuMdi/goyilawarvAwanuMdi/gowulawarvAwanuMdi/goyilawaravAwanuMci/gowulawaravAwanuMci/goyilawarvAwanuMci/gowulawarvAwanuMci	n number bahu parsarg maXyanuMdi 
goyilacotunuMdi/gowulacotunuMdi/goyilacotunuMci/gowulacotunuMci/goyilacotlonuMdi/*gowulacotlonuMdi/goyilacotlonuMci/gowulacotlonuMci	n number bahu parsarg nadumanuMdi 
goyilasWAnamunuMdi/*gowulasWAnamunuMdi/goyilaswAnaMnuMdi/gowulaswAnaMnuMdi/goyilasWAnamunuMci/gowulasWAnamunuMci/goyilaswAnaMnuMci/gowulaswAnaMnuMci/goyilasWAnaMlonuMdi/gowulasWAnaMlonuMdi/goyilaswAnamulonuMdi/gowulaswAnamulonuMdi/goyilasWAnaMlonuMci/gowulasWAnaMlonuMci/goyilaswAnamulonuMci/gowulaswAnamulonuMci	n number bahu parsarg waravAwanuMdi 
goyilayaMxu/*gowulayaMxu/goyilaMxu/gowulaMxu	n number bahu parsarg cotlonuMdi 
goyilaMte/*gowulaMte/goyilaMteV/gowulaMteV	n number bahu parsarg sWAnaMnuMdi 
goyilakaMteV/goyilakaMte/*gowulakaMteV/gowulakaMte/goyilakanna/goyilakannA/gowulakanna/gowulakannA	n number bahu parsarg aMxu 
*gowulEna	n number bahu parsarg aMte 
*gowulupAti	n number bahu parsarg kaMteV 
*gowululAMti/gowululAti	n number bahu parsarg Ena 
*gowulugAnI/gowulukAnI	n number bahu parsarg pAti 
*gowulugA	n number bahu parsarg lAMti 
	n number bahu parsarg gAni 
	n number bahu parsarg gA 
