noun	
goru	
*goru	n number eka parsarg 0  case d
-	n number eka parsarg I 
-	n number eka parsarg gA 
*gorugAdu/gotigAdu	n number eka parsarg gAdu  case d
*gorugawweV/gotigawweV	n number eka parsarg gawweV  case d
*goruvAdu/gotivAdu	n number eka parsarg vAdu  case d
*gorAyana/gotAyana	n number eka parsarg Ayana  case d
*goruvAru/gotivAru	n number eka parsarg vAru  case d
*goruxi/gotixi	n number eka parsarg xi  case d
*goruvi/goriy/gotivi	n number eka parsarg vi  case d
*gorugAru/gotigAru	n number eka parsarg gAru  case d
gorunu/*goruni	n number eka parsarg nu 
goruvu/*goruvi	n number eka parsarg vu  case d
gotiyoVkka/*goruyoVkka	n number eka parsarg yoVkka 
goti/*goru	n number eka parsarg obl 
*goruni/gotini	n number eka parsarg ni 
*goruki/goruku/gotiki	n number eka parsarg ki 
*goruwo/goruwoda/goruwoti/gotiwo/gotiwoda/gotiwoti	n number eka parsarg wo 
gorulo/gorulona/*gorulopala/gotilo/gotilona/gotilopala/gotlo/gotlona/gotlopala	n number eka parsarg lo 
*goruloni/gorulopali/gotiloni/gotilopali/gotiyaMxali/gotloni/gotlopali	n number eka parsarg loni 
*gorumIxa/gotimIxa	n number eka parsarg mIxa 
*goruna/gotina	n number eka parsarg na 
goruniMci/gorunuMci/*gorunuMdi/gotiniMci/gotinuMci/gotinuMdi	n number eka parsarg niMci 
*goruxvArA/gotixvArA/goruxvAra/gotixvAra	n number eka parsarg xvArA 
*goruvalana/goruvalla/gotivalana/gotivalla	n number eka parsarg valana 
*gorunubatti/gorunibatti/gornibatti/gotinubatti/gotinibatti	n number eka parsarg batti 
goruce/*gorucewa/gotice/goticewa	n number eka parsarg ce 
*goruwopAtu/goruwobAtu/gotiwopAtu/gotiwobAtu	n number eka parsarg wopAtu 
*goruwokUdi/goruwokUda/goruwokUdA/goruwogUda/goruwogUdA/gotiwokUdi/gotiwokUda/gotiwokUdA/gotiwogUda/gotiwogUdA	n number eka parsarg wokUdi 
*gorukosaM/gorukE/gotikosaM/gotikE/gorArWaM	n number eka parsarg kosaM 
*gorukoVraku/gorukoVrYaku/gotikoVraku/gotikoVrYaku	n number eka parsarg koVraku 
*gorulonuMdi/gorulonuMci/gorlonuMdi/gorlonuMci/gotilonuMdi/gotilonuMci/gotlonuMdi/gotlonuMci	n number eka parsarg lonuMdi 
*gorumIxanuMdi/gorumIxanuMci/gotimIxanuMdi/gotimIxanuMci	n number eka parsarg mIxanuMdi 
*goruxAkA/goruxAka/gotixAkA/gotixAka	n number eka parsarg xAkA 
goruvaraku/*gotivaraku	n number eka parsarg varaku 
*gorumIxaki/gorumIxaku/gotimIxaki/gotimIxaku	n number eka parsarg mIxaki 
*goruxaggara/goruxaggira/gotixaggara/gotixaggira	n number eka parsarg xaggara 
*goruvaxxa/gotivaxxa	n number eka parsarg vaxxa 
*gorukAda/gotikAda	n number eka parsarg kAda 
*gorukeVxurugA/goreVxurugA/gotikeVxurugA	n number eka parsarg keVxurugA 
*gorumuMxu/gotimuMxu	n number eka parsarg muMxu 
*goruguriMci/goruniguriMci/gorunigUrci/gotiguriMci/gotiniguriMci/gotinigUrci	n number eka parsarg guriMci 
gorupE/*gorupEna/gorupEni/gotipE/gotipEna/gotipEni	n number eka parsarg pE 
*gorupEki/gotipEki	n number eka parsarg pEki 
*goruguMdA/gotiguMdA	n number eka parsarg guMdA 
gorulA/gorulAga/*gorulAgA/gotilA/gotilAga/gotilAgA	n number eka parsarg lA 
*goruvale/gorumAxiri/gorunipoli/goruvaleV/gorunibolina/gotivale/gotimAxiri/gotinipoli/gotivaleV/gotinibolina	n number eka parsarg vale 
*gorukimalle/gotikimalle	n number eka parsarg kimalle 
*gorukUdA/gorunikUdA/gorugUdA/gornigUdA/gotinikUdA/gotinigUdA	n number eka parsarg kUdA 
*goruxqRtilo/goruxruRtilo/gotixqRtilo/gotixruRtilo	n number eka parsarg xqRtilo 
*gorulekuMdA/goruleka/gotilekuMdA/gotileka	n number eka parsarg lekuMdA 
*gorukAkuMdA/gorukAka/gorugAka	n number eka parsarg kAkuMdA 
*gorumoVxalukoVni/gorunimoVxalukoVni/gotimoVxalukoVni/gotinimoVxalukoVni	n number eka parsarg moVxalukoVni 
*goruvEpu/goruvepu/gotivEpu/gotivepu/gorukesi/gotikesi	n number eka parsarg vEpu 
gorupakka/goruprakka/*gorupakkana/gotipakka/gotiprakka/gotipakkana	n number eka parsarg pakka 
gorupakkalo/*goruprakkalo/gotipakkalo/gotiprakkalo	n number eka parsarg pakkalo 
goruloki/gotiloki/goruloniki/gotiloniki/*gorulopalaki/gorulopalaku/gorulopaliki/gotilopalaki/gotilopalaku/gotilopaliki	n number eka parsarg lopalaki 
gorukiMxa/*gorukriMxa/gotikiMxa/gotikriMxa/gorukriMxane/gorukiMxane/gotikriMxane/gotikiMxane	n number eka parsarg kiMxa 
goraduguna/*gorukaduguna/gotikaduguna	n number eka parsarg aduguna 
gorukeVlla/*gorukalla/gotikeVlla/gotikalla	n number eka parsarg kalla 
goruveVnuka/*goruveVnakAla/goruveVnakAwala/gotiveVnuka/gotiveVnakAla/gotiveVnakAwala	n number eka parsarg veVnuka 
goruwaravAwa/goruwarvAwa/*goruwaruvAwa/gotiwaravAwa/gotiwarvAwa/gotiwaruvAwa	n number eka parsarg waravAwa 
goreVxuruguMdA/*gorukeVxuruguMdA/gotikeVxuruguMdA	n number eka parsarg eVxuruguMdA 
gorumaXya/*gorumaXyalo/gorumaXyana/gotimaXya/gotimaXyalo/gotimaXyana	n number eka parsarg maXya 
gorunadama/*gorunaduma/gotinaduma/gotinadama	n number eka parsarg naduma 
gorubaxulugA/gorubaxulu/*gorukibaxulu/gorunibaxulu/gotibaxulugA/gotibaxulu/gotikibaxulu/gotinibaxulu	n number eka parsarg baxulugA 
*gorucotlo/gorucotulo/gorucotuna/goticotlo/goticotulo/goticotuna	n number eka parsarg cotlo 
gorusWAnaMlo/*gorusWAnamulo/gotisWAnaMlo/gotisWAnamulo	n number eka parsarg sWAnaMlo 
gorunerugA/gorukunerugA/*gorukinerugA/gotinerugA/gotikunerugA/gotikinerugA	n number eka parsarg nerugA 
*goruprakAraM/goruprakAramu/gotiprakAraM/gotiprakAramu	n number eka parsarg prakAraM 
*goruxaggaranuMdi/goruxaggaranuMci/goruxaggiranuMdi/goruxaggiranuMci/gotixaggaranuMdi/gotixaggaranuMci/gotixaggiranuMdi/gotixaggiranuMci	n number eka parsarg xaggaranuMdi 
*goruvaxxanuMdi/goruvaxxanuMci/gotivaxxanuMdi/gotivaxxanuMci	n number eka parsarg vaxxanuMdi 
*gorupakkanuMdi/gorupakkanuMci/gotipakkanuMdi/gotipakkanuMci/gorupakkalonuMdi/gorupakkalonuMci/gotipakkalonuMdi/gotipakkalonuMci	n number eka parsarg pakkanuMdi 
*gorulopalanuMdi/gorulopalanuMci/gorulopalinuMci/gorulopalinuMdi/gotilopalanuMdi/gotilopalanuMci/gotilopalinuMci/gotilopalinuMdi	n number eka parsarg lopalanuMdi 
*gorubEtanuMdi/gorubEtanuMci/gotibEtanuMdi/gotibEtanuMci	n number eka parsarg bEtanuMdi 
*gorupEnuMdi/gorupEnuMci/gotipEnuMdi/gotipEnuMci	n number eka parsarg pEnuMdi 
gorukiMxanuMdi/gorukiMxanuMci/gotikiMxanuMdi/gotikiMxanuMci/*gorukriMxanuMdi/gorukriMxanuMci/gotikriMxanuMdi/gotikriMxanuMci	n number eka parsarg kriMxanuMdi 
goradugunuMdi/goradugunuMci/*gorukadugunuMdi/gorukadugunuMci/gotikadugunuMdi/gotikadugunuMci	n number eka parsarg adugunuMdi 
*gorumuMxunuMdi/gorumuMxunuMci/gotimuMxunuMdi/gotimuMxunuMci	n number eka parsarg muMxunuMdi 
goruveVnukanuMdi/*goruveVnakAlanuMdi/goruveVnakAwalanuMdi/goruveVnakanuMdi/gotiveVnukanuMdi/gotiveVnakAlanuMdi/gotiveVnakAwalanuMdi/gotiveVnakanuMdi/goruveVnukanuMci/goruveVnakAlanuMci/goruveVnakAwalanuMci/goruveVnakanuMci/gotiveVnukanuMci/gotiveVnakAlanuMci/gotiveVnakAwalanuMci/gotiveVnakanuMci	n number eka parsarg veVnukanuMdi 
goreVxutinuMdi/goreVxutanuMdi/*gorukeVxutinuMdi/goreVxutinuMci/goreVxutanuMci/gorukeVxutinuMci/gotikeVxutinuMdi/gotikeVxutinuMci	n number eka parsarg eVxutinuMdi 
*gorumaXyanuMdi/gorumaXyanuMci/gotimaXyanuMdi/gotimaXyanuMci/gorumaXyalonuMdi/gorumaXyalonuMci/gotimaXyalonuMdi/gotimaXyalonuMci	n number eka parsarg maXyanuMdi 
*gorunadumanuMdi/gorunadumanuMci/gotinadumanuMdi/gotinadumanuMci	n number eka parsarg nadumanuMdi 
*goruwaravAwanuMdi/goruwarvAwanuMdi/goruwaravAwanuMci/goruwarvAwanuMci/gotiwaravAwanuMdi/gotiwarvAwanuMdi/gotiwaravAwanuMci/gotiwarvAwanuMci	n number eka parsarg waravAwanuMdi 
*gorucotlonuMdi/gorucotunuMdi/gorucotlonuMci/gorucotunuMci/goticotlonuMdi/goticotunuMdi/goticotlonuMci/goticotunuMci	n number eka parsarg cotlonuMdi 
gorusWAnaMnuMdi/*gorusWAnamunuMdi/gorusWAnamunuMci/gorusWAnaMnuMci/gotisWAnaMnuMdi/gotisWAnaMnuMdi/gotisWAnamunuMci/gotisWAnaMnuMci/gorusWAnaMlonuMdi/gorusWAnamulonuMdi/gotisWAnaMlonuMdi/gotisWAnamulonuMdi/gorusWAnaMlonuMci/goruswAnamulonuMci/gotisWAnaMlonuMci/gotiswAnamulonuMci	n number eka parsarg sWAnaMnuMdi 
goraMxu/gorunaMxu/*goruyaMxu/gotinaMxu/gotiyaMxu	n number eka parsarg aMxu 
*goraMte/goraMteV	n number eka parsarg aMte 
*gorukaMteV/gorukaMte/gorukanna/gorukannA/gotikaMteV/gotikaMte/gotikanna/gotikannA	n number eka parsarg kaMteV 
*gorEna	n number eka parsarg Ena 
*gorupAti/gotipAti	n number eka parsarg pAti 
*gorulAMti/gorulAti/gotilAMti/gotilAti	n number eka parsarg lAMti 
*gorugAnI/gorukAnI	n number eka parsarg gAni 
*gorugA/gotigA	n number eka parsarg gA 
*golYlYu/golYlu/gorlu/gorulu	n number bahu parsarg 0  case d
*golYlYU/golYlU/golYlulArA/golYlArA/gorlU/gorlulArA/gorlArA	n number bahu parsarg I  case d
-	n number bahu parsarg gA 
golYlugAdu/gorlagAdu/golYlagAdu/*golYlYagAdu	n number bahu parsarg gAdu  case d
gorlagawweV/golYlugawweV/golYlagawweV/*golYlYagawweV	n number bahu parsarg gawweV  case d
*golYlYavAdu/golYlavAdu/gorlavAdu	n number bahu parsarg vAdu  case d
*golYlYAyana/golYlAyana/gorlAyana	n number bahu parsarg Ayana  case d
*golYlYavAru/golYlavAru/gorlavAru	n number bahu parsarg vAru  case d
*golYlYaxi/golYlaxi/gorlaxi	n number bahu parsarg xi  case d
*golYlYavi/golYlavi/gorlavi	n number bahu parsarg vi  case d
*golYlYagAru/golYlagAru/gorlagAru	n number bahu parsarg gAru  case d
*golYlYaM/golYlaM/golYlamu/gorlaM/gorlamu	n number bahu parsarg nu  case d
*golYlYu/golYlu/gorlu	n number bahu parsarg vu 
*golYlYayoVkka/golYlayoVkka/gorlayoVkka	n number bahu parsarg yoVkka 
*golYlYa/golYla/gorla	n number bahu parsarg obl 
*golYlYani/golYlani/gorlani/golYlanu/gorlanu/gorulni	n number bahu parsarg ni 
*golYlYaki/golYlaki/gorlaki/golYlaku/gorlaku	n number bahu parsarg ki 
*golYlYawo/golYlawo/gorlawo/golYlawoda/gorlawoda	n number bahu parsarg wo 
golYlallo/golYlalo/gorlallo/gorlalo/golYlalona/gorlalona/*golYlYalopala/golYlalopala/gorlalopala	n number bahu parsarg lo 
*golYlYaloni/golYlaloni/gorlaloni/golYlalopali/gorlayaMxali/gorlalopali	n number bahu parsarg loni 
*golYlYamIxa/golYlamIxa/gorlamIxa	n number bahu parsarg mIxa 
*golYlYana/golYlana/gorlana	n number bahu parsarg na 
golYlaniMci/gorlaniMci/golYlanuMci/gorlanuMci/*golYlYanuMdi/golYlanuMdi/gorlanuMdi	n number bahu parsarg niMci 
*golYlYaxvArA/golYlaxvArA/gorlaxvArA	n number bahu parsarg xvArA 
*golYlYavalana/golYlavalana/golYlavalla/gorlavalana/gorlavalla	n number bahu parsarg valana 
*golYlYanubatti/golYlanubatti/gorlanubatti	n number bahu parsarg batti 
*golYlYacewa/golYlacewa/gorlacewa/golYlace/gorlace	n number bahu parsarg ce 
*golYlYawopAtu/golYlawopAtu/gorlawopAtu	n number bahu parsarg wopAtu 
*golYlYawokUdi/golYlawokUdi/gorlawokUdi/golYlawokUda/gorlawokUda/golYlawokUdA/gorlawokUdA	n number bahu parsarg wokUdi 
*golYlYakosaM/golYlakosaM/gorlakosaM/golYlakE/gorlakE/golYlArWaM	n number bahu parsarg kosaM 
*golYlYakoVraku/golYlakoVraku/gorlakoVraku/golYlakoVrYaku/gorlakoVrYaku	n number bahu parsarg koVraku 
*golYlYalonuMdi/golYlalonuMdi/golYlalonuMci/gorlalonuMdi/gorlalonuMci/golYlaloniMci/gorlaloniMci	n number bahu parsarg lonuMdi 
*golYlYamIxanuMdi/golYlamIxanuMdi/gorlamIxanuMdi/golYlamIxanuMci/gorlamIxanuMci	n number bahu parsarg mIxanuMdi 
*golYlYaxAkA/golYlaxAkA/gorlaxAkA	n number bahu parsarg xAkA 
*golYlYavaraku/golYlavaraku/gorlavaraku	n number bahu parsarg varaku 
*golYlYamIxaki/golYlamIxaki/gorlamIxaki/golYlamIxaku/gorlamIxaku	n number bahu parsarg mIxaki 
*golYlYaxaggara/golYlaxaggara/gorlaxaggara/gorlaxaggira/golYlaxaggira	n number bahu parsarg xaggara 
*golYlYavaxxa/golYlavaxxa/gorlavaxxa	n number bahu parsarg vaxxa 
*golYlYakAda/golYlakAda/gorlakAda	n number bahu parsarg kAda 
golYleVxurugA/gorleVxurugA/*golYlYakeVxurugA/golYlakeVxurugA/gorlakeVxurugA	n number bahu parsarg keVxurugA 
*golYlYamuMxu/golYlamuMxu/gorlamuMxu	n number bahu parsarg muMxu 
*golYlYaguriMci/golYlaguriMci/golYlagUrci/golYlanuguriMci/golYlanigUrci	n number bahu parsarg guriMci 
golYlapE/golYlapEni/*golYlYapEna/golYlapEna	n number bahu parsarg pE 
*golYlYapEki/golYlapEki/gorlapEki	n number bahu parsarg pEki 
*golYlYaguMdA/golYlaguMdA/gorlaguMdA	n number bahu parsarg guMdA 
golYlalA/gorlalA/golYlalAga/*golYlYulAgA/golYlulAgA/gorlalAga/gorlulAgA	n number bahu parsarg lA 
*golYlYavale/golYlavale/golYlavaleV/golYlamAxiri/golYlanupolina/golYlanubolina/gorlavale/gorlavaleV/gorlamAxiri/gorlanupolina/gorlanubolina	n number bahu parsarg vale 
*golYlYakumalle/golYlakumalle/gorlakumalle/golYlakumalleV/gorlakumalleV	n number bahu parsarg kimalle 
gorlukUdA/*golYlYukUdA/golYlukUdA/gorlugUdA/golYlugUdA/gorlanugUdA/golYlanugUdA	n number bahu parsarg kUdA 
*golYlYaxqRtilo/golYlaxqRtilo/golYlaxruRtilo/gorlaxqRtilo/gorlaxruRtilo	n number bahu parsarg xqRtilo 
*golYlYulekuMdA/gorlulekuMdA/gorluleka/golYluleka/gorlulekuMdA/gorluleka/golYluleka	n number bahu parsarg lekuMdA 
*golYlYukAkuMdA/gorlukAkuMdA/gorlukAka/golYlukAka/golYlugAka/gorlugAka	n number bahu parsarg kAkuMdA 
*golYlYumoVxalukoVni/golYlumoVxalukoVni/golYlanumoVxalukoVni/gorlumoVxalukoVni/gorlanumoVxalukoVni	n number bahu parsarg moVxalukoVni 
*golYlYavEpu/golYlavEpu/golYlavepu/gorlavEpu/gorlavepu/golYlakesi/gorlakesi	n number bahu parsarg vEpu 
golYlapakka/golYlapakkana/golYlaprakka/*golYlYaprakkana/golYlaprakkana/gorlapakka/gorlapakkana/gorlaprakka/gorlaprakkana	n number bahu parsarg pakka 
golYlapakkalo/*golYlYaprakkalo/golYlaprakkalo/gorlapakkalo/gorlaprakkalo	n number bahu parsarg pakkalo 
golYlaloki/gorlaloki/golYlaloniki/gorlaloniki/*golYlYalopalaki/golYlalopalaki/golYlalopaliki/gorlalopaliki/gorlalopalaku	n number bahu parsarg lopalaki 
golYlakiMxa/*golYlYakriMxa/golYlakriMxa/gorlakiMxa/gorlakriMxa/golYlakriMxane/golYlakiMxane/gorlakiMxane/gorlakriMxane	n number bahu parsarg kiMxa 
golYladuguna/*golYlYakaduguna/golYlakaduguna/gorladuguna/gorlakaduguna	n number bahu parsarg aduguna 
golYlakeVlla/*golYlYakalla/golYlakalla/gorlakalla/gorlakeVlla	n number bahu parsarg kalla 
golYlaveVnuka/golYlaveVnaka/*golYlYaveVnakAla/golYlaveVnakAla/golYlaveVnukAla/golYlaveVnakAwala/golYlaveVnukAwala/gorlaveVnakAwala/gorlaveVnukAwala	n number bahu parsarg veVnuka 
*golYlYawaravAwa/golYlawaravAwa/golYlawarvAwa/gorlawaravAwa	n number bahu parsarg waravAwa 
gorleVxuruguMdA/*golYlYakeVxuruguMdA/golYlakeVxuruguMdA/gorlakeVxuruguMdA/golYleVxuruguMdA	n number bahu parsarg eVxuruguMdA 
*golYlYamaXya/golYlamaXya/golYlamaXyana/golYlamaXyalo/gorlamaXya/gorlamaXyana/gorlamaXyalo	n number bahu parsarg maXya 
golYlanaduma/*golYlYakinaduma/golYlakinaduma/gorlanaduma/gorlakinaduma	n number bahu parsarg naduma 
golYlabaxulugA/golYlakibaxulugA/golYlabaxulu/golYlakibaxulu/*golYlYakibaxulu	n number bahu parsarg baxulugA 
*golYlYacotlo/golYlacotlo/golYlacotulo/gorlacotlo/gorlacotulo	n number bahu parsarg cotlo 
golYlasWAnaMlo/golYlaswAnaMlo/*golYlYasWAnamulo/golYlasWAnamulo/gorlasWAnaMlo/gorlaswAnaMlo/gorlasWAnamulo	n number bahu parsarg sWAnaMlo 
golYlanerugA/golYlakunerugA/*golYlYakinerugA/golYlakinerugA/gorlanerugA/gorlakunerugA/gorlakinerugA	n number bahu parsarg nerugA 
*golYlYaprakAraM/golYlaprakAraM/golYlanubatti/golYlabatti/golYlanibatti/gorlaprakAraM/gorlanubatti/gorlabatti/gorlanibatti	n number bahu parsarg prakAraM 
*golYlYaxaggaranuMdi/golYlaxaggaranuMdi/golYlaxaggiranuMdi/golYlaxaggaranuMci/golYlaxaggiranuMci/gorlaxaggaranuMdi/gorlaxaggiranuMdi/gorlaxaggaranuMci/gorlaxaggiranuMci	n number bahu parsarg xaggaranuMdi 
*golYlYavaxxanuMdi/golYlavaxxanuMdi/golYlavaxxanuMci/gorlavaxxanuMdi/gorlavaxxanuMci	n number bahu parsarg vaxxanuMdi 
*golYlYapakkanuMdi/golYlapakkanuMdi/golYlapakkanuMci/gorlapakkanuMdi/gorlapakkanuMci/golYlapakkalonuMdi/golYlapakkalonuMci/gorlapakkalonuMdi/gorlapakkalonuMci	n number bahu parsarg pakkanuMdi 
*golYlYalopalanuMdi/golYlalopalanuMdi/gorlalopalanuMdi/golYlalopalanuMci/gorlalopalanuMci/gorlalopalinuMdi/golYlalopalinuMci	n number bahu parsarg lopalanuMdi 
*golYlYabEtanuMdi/golYlabEtanuMdi/golYlabEtanuMci/golYlabEtaniMci/gorlabEtanuMdi/gorlabEtanuMci/gorlabEtaniMci	n number bahu parsarg bEtanuMdi 
*golYlYapEnuMdi/golYlapEnuMdi/golYlapEnuMci/golYlapEniMci/gorlapEnuMdi/gorlapEnuMci/gorlapEniMci	n number bahu parsarg pEnuMdi 
golYlakiMxanuMdi/golYlakiMxanuMci/golYlakiMxaniMci/gorlakiMxanuMdi/gorlakiMxanuMci/gorlakiMxaniMci/*golYlYakriMxanuMdi/golYlakriMxanuMdi/golYlakriMxanuMci/golYlakriMxaniMci/gorlakriMxanuMdi/gorlakriMxanuMci/gorlakriMxaniMci	n number bahu parsarg kriMxanuMdi 
*golYlYadugunuMdi/golYladugunuMdi/golYladugunuMci/golYladuguniMci/gorladugunuMdi/gorladugunuMci/gorladuguniMci	n number bahu parsarg adugunuMdi 
*golYlYamuMxunuMdi/golYlamuMxunuMdi/golYlamuMxunuMci/golYlamuMxuniMci/gorlamuMxunuMdi/gorlamuMxunuMci/gorlamuMxuniMci	n number bahu parsarg muMxunuMdi 
golYlaveVnukanuMdi/golYlaveVnakanuMdi/*golYlYaveVnakAlanuMdi/golYlaveVnakAlanuMdi/gorlaveVnukanuMdi/golaveVnakanuMdi/golaveVnakAlanuMdi/golYlaveVnakAlanuMci/golYlaveVnukanuMci/golYlaveVnakanuMci/gorlaveVnakAlanuMci/golaveVnukanuMci/golaveVnakanuMci/golYlaveVnakAwalanuMdi/golYlaveVnakAwalanuMci/gorlaveVnakAwalanuMdi/gorlaveVnakAwalanuMci	n number bahu parsarg veVnukanuMdi 
gorleVxutinuMdi/golYlakeVxutinuMdi/gorleVxutanuMdi/*golYlYakeVxutanuMdi/golYlakeVxutanuMdi/gorleVxutinuMci/golYlakeVxutinuMci/gorleVxutanuMci/golYlakeVxutanuMci	n number bahu parsarg eVxutinuMdi 
*golYlYamaXyanuMdi/golYlamaXyanuMdi/golYlamaXyanuMci/golYlamaXyaniMci/gorlamaXyanuMdi/gorlamaXyanuMci/gorlamaXyaniMci/golYlamaXyalonuMdi/golYlamaXyalonuMci/golYlamaXyaloniMci/gorlamaXyalonuMdi/gorlamaXyalonuMci/gorlamaXyaloniMci	n number bahu parsarg maXyanuMdi 
*golYlYanadumanuMdi/golYlanadumanuMdi/golYlanadamanuMdi/golYlanadumanuMci/golYlanadamanuMci/gorlanadumanuMdi/gorlanadamanuMdi/gorlanadumanuMci/gorlanadamanuMci	n number bahu parsarg nadumanuMdi 
*golYlYawaravAwanuMdi/golYlawaravAwanuMdi/golYlawarvAwanuMdi/gorlawaravAwanuMdi/gorlawarvAwanuMdi/golYlawaravAwanuMci/golYlawarvAwanuMci/gorlawaravAwanuMci/gorlawarvAwanuMci	n number bahu parsarg waravAwanuMdi 
golYlacotunuMdi/golYlacotunuMci/golYlacotuniMci/gorlacotunuMdi/gorlacotunuMci/*golYlYacotlonuMdi/golYlacotlonuMdi/golYlacotlonuMci/golYlacotloniMci/gorlacotlonuMdi/gorlacotlonuMci	n number bahu parsarg cotlonuMdi 
*golYlYasWAnamunuMdi/golYlasWAnamunuMdi/golYlasWAnaMnuMdi/gorlasWAnamunuMdi/gorlasWAnaMnuMdi/golYlasWAnamunuMci/golYlasWAnaMnuMci/gorlasWAnamunuMci/gorlasWAnaMnuMci/golYlasWAnaMlonuMdi/golYlasWAnamulonuMdi/gorlasWAnaMlonuMdi/gorlasWAnamulonuMdi/golYlasWAnaMlonuMci/golYlasWAnamulonuMci/gorlasWAnaMlonuMci/gorlasWAnamulonuMci	n number bahu parsarg sWAnaMnuMdi 
*golYlYayaMxu/golYlayaMxu/golYlaMxu/gorlayaMxu/gorlaMxu	n number bahu parsarg aMxu 
*golYlYaMte/golYlaMte/golYlaMteV/gorlaMte/gorlaMteV	n number bahu parsarg aMte 
*golYlYakaMteV/golYlakaMteV/golYlakaMte/gorlakaMteV/gorlakaMte/golYlakanna/golYlakannA/gorlakanna/gorlakannA	n number bahu parsarg kaMteV 
*golYlYEna/golYlEna/gorlEna	n number bahu parsarg Ena 
*golYlYapAti/golYlapAti/gorlapAti	n number bahu parsarg pAti 
*golYlYalAMti/golYalAMti/gorlalAti/golYulAMti/gorlulAti	n number bahu parsarg lAMti 
*golYlYugAnI/golYlugAnI/gorlukAnI/gorlugAnI/gorlukAnI	n number bahu parsarg gAni 
*golYlYugA/golYlugA/gorlugA	n number bahu parsarg gA 
