noun	
guddu	
*guddu	n number eka parsarg 0  case d
-	n number eka parsarg I 
-	n number eka parsarg gA 
*guddugAdu	n number eka parsarg gAdu  case d
*guddugawweV	n number eka parsarg gawweV  case d
*gudduvAdu	n number eka parsarg vAdu  case d
*guddAyana	n number eka parsarg Ayana  case d
*gudduvAru	n number eka parsarg vAru  case d
*gudduxi	n number eka parsarg xi  case d
*gudduvi/gudduy	n number eka parsarg vi  case d
*guddugAru	n number eka parsarg gAru  case d
*guddunu	n number eka parsarg nu 
*gudduvu	n number eka parsarg vu  case d
*gudduyoVkka	n number eka parsarg yoVkka 
*guddu	n number eka parsarg obl 
*gudduni/guddunu	n number eka parsarg ni 
*gudduki/gudduku	n number eka parsarg ki 
*gudduwo/gudduwoda/gudduwoti	n number eka parsarg wo 
guddulo/guddulona/*guddulopala	n number eka parsarg lo 
*gudduloni/guddulopali/guddunaMxali	n number eka parsarg loni 
*guddumIxa	n number eka parsarg mIxa 
*gudduna	n number eka parsarg na 
gudduniMci/guddunuMci/*guddunuMdi	n number eka parsarg niMci 
*gudduxvArA/gudduxvAra	n number eka parsarg xvArA 
*gudduvalana/gudduvalla	n number eka parsarg valana 
*guddunubatti	n number eka parsarg batti 
gudduce/*gudducewa	n number eka parsarg ce 
*gudduwopAtu/gudduwobAtu	n number eka parsarg wopAtu 
*gudduwokUdi/gudduwokUda/gudduwokUdA/gudduwogUdi/gudduwogUdA/gudduwogUda	n number eka parsarg wokUdi 
*guddukosaM/guddukE/guddArWaM	n number eka parsarg kosaM 
*guddukoVraku/guddukoVrYaku	n number eka parsarg koVraku 
*guddulonuMdi/guddulonuMci/gudduloniMci	n number eka parsarg lonuMdi 
*guddumIxanuMdi/guddumIxanuMci/guddumIxaniMci	n number eka parsarg mIxanuMdi 
*gudduxAkA/gudduxAka	n number eka parsarg xAkA 
*gudduvaraku	n number eka parsarg varaku 
*guddumIxaki/guddumIxaku/guddumIxiki	n number eka parsarg mIxaki 
*gudduxaggara/gudduxaggira	n number eka parsarg xaggara 
*gudduvaxxa/guddoVxxa	n number eka parsarg vaxxa 
*guddukAda	n number eka parsarg kAda 
*guddukeVxurugA/guddeVxurugA	n number eka parsarg keVxurugA 
*guddumuMxu	n number eka parsarg muMxu 
*gudduguriMci/gudduniguriMci/guddunugUrci	n number eka parsarg guriMci 
guddupE/*guddupEna/guddupEni	n number eka parsarg pE 
*guddupEki	n number eka parsarg pEki 
*gudduguMdA	n number eka parsarg guMdA 
guddulA/guddulAga/*guddulAgA	n number eka parsarg lA 
*gudduvale/guddumAxiri/guddunipoli/guddunuboli/guddunipolina/guddunupolina/guddunubolina	n number eka parsarg vale 
*guddukumalle/guddukumalleV	n number eka parsarg kimalle 
*guddukUdA/guddunikUdA/guddunukUdA/guddunugUdA/guddugUdA	n number eka parsarg kUdA 
*gudduxqRtilo/gudduxruRtilo	n number eka parsarg xqRtilo 
*guddulekuMdA/guddunulekuMdA/gudduleka/guddunilekuMdA	n number eka parsarg lekuMdA 
*guddukAkuMdA/guddunukAkuMdA/guddukAka/guddunikAkuMdA/guddugAka/guddugAkuMdA	n number eka parsarg kAkuMdA 
*guddumoVxalukoVni/guddunimoVxalukoVni/guddunumoVxalukoVni	n number eka parsarg moVxalukoVni 
*gudduvEpu/gudduvepu/guddukesi	n number eka parsarg vEpu 
guddupakka/gudduprakka/guddupakkana/*gudduprakkana/guddupakkani	n number eka parsarg pakka 
guddupakkalo/*gudduprakkalo/guddupakkalona/guddupakkaloni	n number eka parsarg pakkalo 
gudduloki/gudduloniki/*guddulopalaki/guddulopalaku/guddulopaliki	n number eka parsarg lopalaki 
guddukiMxa/*guddukriMxa/guddukriMxana/guddukiMxana	n number eka parsarg kiMxa 
guddaduguna/*guddukaduguna	n number eka parsarg aduguna 
guddukeVlla/*guddukalla	n number eka parsarg kalla 
gudduveVnuka/*gudduveVnakAla/gudduveVnakAwala/gudduveVnakana	n number eka parsarg veVnuka 
gudduwaravAwa/gudduwarvAwa/*gudduwaruvAwa/gudduwaravAwana/gudduwarvAwana/gudduwaruvAwana	n number eka parsarg waravAwa 
guddeVxuruguMdA/*guddukeVxuruguMdA	n number eka parsarg eVxuruguMdA 
*guddumaXya/guddumaXyalo/guddumaXyana	n number eka parsarg maXya 
*guddunaduma/guddunadumana	n number eka parsarg naduma 
guddubaxulugA/guddubaxulu/*guddukibaxulu/guddukubaxulu	n number eka parsarg baxulugA 
*gudducotlo/gudducotulo/gudducotuna/gudducota	n number eka parsarg cotlo 
*guddusWAnaMlo/gudduswAnaMlo	n number eka parsarg sWAnaMlo 
guddunerugA/guddukunerugA/*guddukinerugA	n number eka parsarg nerugA 
*gudduprakAraM/gudduprakAramu	n number eka parsarg prakAraM 
*gudduxaggaranuMdi/gudduxaggaranuMci/gudduxaggiranuMdi/gudduxaggiranuMci	n number eka parsarg xaggaranuMdi 
*gudduvaxxanuMdi/gudduvaxxanuMci/gudduvaxxaniMci	n number eka parsarg vaxxanuMdi 
*guddupakkanuMdi/guddupakkanuMci/guddupakkaniMci/guddupakkalonuMdi/guddupakkalonuMci/guddupakkaloniMci	n number eka parsarg pakkanuMdi 
*guddulopalanuMdi/guddulopalanuMci/guddulopalaniMci	n number eka parsarg lopalanuMdi 
*guddubEtanuMdi/guddubEtanuMci/guddubEtaniMci	n number eka parsarg bEtanuMdi 
*guddupEnuMdi/guddupEnuMci/guddupEniMci	n number eka parsarg pEnuMdi 
guddukiMxanuMdi/guddukiMxanuMci/guddukiMxaniMci/*guddukriMxanuMdi/guddukriMxanuMci/guddukriMxaniMci	n number eka parsarg kriMxanuMdi 
guddadugunuMdi/guddadugunuMci/*guddukadugunuMdi/guddukadugunuMci/guddukaduguniMci	n number eka parsarg adugunuMdi 
*guddumuMxunuMdi/guddumuMxunuMci/guddumuMxuniMci	n number eka parsarg muMxunuMdi 
gudduveVnukanuMdi/*gudduveVnakAlanuMdi/gudduveVnakAwalanuMdi/gudduveVnakanuMdi/gudduveVnukanuMci/gudduveVnakAlanuMci/gudduveVnakAwalanuMci/gudduveVnakanuMci	n number eka parsarg veVnukanuMdi 
guddeVxutinuMdi/guddukeVxutinuMdi/guddukeVxutinuMci/guddeVxutinuMci/guddeVxutanuMdi/*guddukeVxutanuMdi/guddukeVxutanuMci/guddeVxutanuMci	n number eka parsarg eVxutinuMdi 
*guddumaXyanuMdi/guddumaXyanuMci/guddumaXyalonuMdi/guddumaXyalonuMci	n number eka parsarg maXyanuMdi 
*guddunadumanuMdi/guddunadumanuMci	n number eka parsarg nadumanuMdi 
*gudduwaravAwanuMdi/gudduwarvAwanuMdi/gudduwaravAwanuMci/gudduwarvAwanuMci	n number eka parsarg waravAwanuMdi 
*gudducotlonuMdi/gudducotunuMdi/gudducotlonuMci/gudducotunuMci	n number eka parsarg cotlonuMdi 
guddusWAnaMnuMdi/*guddusWAnamunuMdi/guddusWAnaMnuMci/guddusWAnamunuMci/guddusWAnaMlonuMdi/guddusWAnamulonuMdi/guddusWAnaMlonuMci/gudduswAnamulonuMci	n number eka parsarg sWAnaMnuMdi 
guddaMxu/guddunaMxu/*gudduyaMxu	n number eka parsarg aMxu 
*guddaMte/guddaMteV	n number eka parsarg aMte 
*guddukaMteV/guddukaMte/guddukanna/guddukannA	n number eka parsarg kaMteV 
*guddEna	n number eka parsarg Ena 
*guddupAti	n number eka parsarg pAti 
*guddulAMti/guddulAti	n number eka parsarg lAMti 
*guddugAnI/guddukAnI	n number eka parsarg gAni 
*guddugA	n number eka parsarg gA 
*gudlu/guddulu	n number bahu parsarg 0  case d
*gudlU/gudlulArA/guddullArA	n number bahu parsarg I  case d
-	n number bahu parsarg gA 
*gudlugAdu/guddulagAdu/gudlagAdu	n number bahu parsarg gAdu  case d
*gudlugawweV/guddulagawweV/gudlagawweV	n number bahu parsarg gawweV  case d
*gudlavAdu/gudlodu	n number bahu parsarg vAdu  case d
*gudlAyana/guddulAyana	n number bahu parsarg Ayana  case d
*gudlavAru/gudloru	n number bahu parsarg vAru  case d
*gudlaxi/guddulxi	n number bahu parsarg xi  case d
*gudlavi/gudluy/gudluvi	n number bahu parsarg vi  case d
*gudlugAru/guddulagAru	n number bahu parsarg gAru  case d
*gudlaM/gudlamu	n number bahu parsarg nu  case d
-	n number bahu parsarg vu 
*gudlayoVkka	n number bahu parsarg yoVkka 
gudla/*guddula	n number bahu parsarg obl 
*gudlani/guddulni/gudlanu/guddulanu	n number bahu parsarg ni 
*gudlaki/gudlaku	n number bahu parsarg ki 
*gudlawo/guddulwo/gudlawoda/gudlawoti/guddulwoti/guddulwoda	n number bahu parsarg wo 
*gudlalo/guddullo/gudlalona/guddullona	n number bahu parsarg lo 
*gudlaloni/gudlayaMxali/guddulloni	n number bahu parsarg loni 
*gudlamIxa	n number bahu parsarg mIxa 
*gudlana	n number bahu parsarg na 
gudlaniMci/guddulniMci/gudlanuMci/guddulnuMci/*gudlanuMdi/guddulnuMdi	n number bahu parsarg niMci 
*gudlaxvArA/gudlaxvAra	n number bahu parsarg xvArA 
*gudlavalana/gudlavalla	n number bahu parsarg valana 
*gudlanubatti	n number bahu parsarg batti 
*gudlacewa/guddulacewa/gudlace/guddulace	n number bahu parsarg ce 
*gudlawopAtu/guddulwopAtu/gudlawobAtu	n number bahu parsarg wopAtu 
*gudlawokUdi/guddulwokUdi/gudlawokUda/gudlawokUdA/guddulwokUdA/gudlawogUdA	n number bahu parsarg wokUdi 
*gudlakosaM/gudlakE/gudlArWaM	n number bahu parsarg kosaM 
*gudlakoVraku/gudlakoVrYaku	n number bahu parsarg koVraku 
*gudlalonuMdi/gudlalonuMci/guddullonuMdi/guddullonuMci/guddulloniMci/gudlaloniMci	n number bahu parsarg lonuMdi 
*gudlamIxanuMdi/gudlamIxanuMci/gudlamIxaniMci	n number bahu parsarg mIxanuMdi 
*gudlaxAkA/gudlaxAka	n number bahu parsarg xAkA 
*gudlavaraku	n number bahu parsarg varaku 
*gudlamIxaki/gudlamIxaku/gudlamIxiki	n number bahu parsarg mIxaki 
*gudlaxaggara/gudlaxaggira	n number bahu parsarg xaggara 
*gudlavaxxa/gudduloVxxa	n number bahu parsarg vaxxa 
*gudlakAda/guddulakAda	n number bahu parsarg kAda 
gudleVxurugA/*gudlakeVxurugA	n number bahu parsarg keVxurugA 
*gudlamuMxu	n number bahu parsarg muMxu 
*gudlaguriMci/gudlagUrci/gudlanuguriMci/gudlanigUrci	n number bahu parsarg guriMci 
gudlapE/gudlapEni/*gudlapEna	n number bahu parsarg pE 
*gudlapEki/guddulapEki	n number bahu parsarg pEki 
*gudlaguMdA	n number bahu parsarg guMdA 
gudlalA/guddullA/gudlalAga/guddullAga/*guddullAgA	n number bahu parsarg lA 
*gudlavale/gudlavaleV/gudlamAxiri/gudlanupolina/gudlanubolina	n number bahu parsarg vale 
*gudlakumalle/guddulakumalle/gudlakumalleV/guddulakumalleV	n number bahu parsarg kimalle 
*gudlukUdA/gudlugUdA/gudlukUda/gudlugUda	n number bahu parsarg kUdA 
*gudlaxqRtilo/gudlaxruRtilo	n number bahu parsarg xqRtilo 
*gudlulekuMdA/guddullekuMdA/gudluleka	n number bahu parsarg lekuMdA 
*gudlukAkuMdA/gudlukAkuMda/gudlukAka/gudlugAka/gudlugAkuMdA	n number bahu parsarg kAkuMdA 
*gudlumoVxalukoVni/gudlanumoVxalukoVni	n number bahu parsarg moVxalukoVni 
*gudlavEpu/gudlavepu/gudlakesi	n number bahu parsarg vEpu 
gudlapakka/gudlapakkana/gudlaprakka/*gudlaprakkana	n number bahu parsarg pakka 
gudlapakkalo/*gudlaprakkalo	n number bahu parsarg pakkalo 
gudlaloki/gudlaloniki/guddulloniki/gudlaloniki/*gudlalopalaki/gudlalopaliki/guddullopaliki/guddullopalaku	n number bahu parsarg lopalaki 
gudlakiMxa/*gudlakriMxa/gudlakriMxana/gudlakiMxana	n number bahu parsarg kiMxa 
gudladuguna/*gudlakaduguna	n number bahu parsarg aduguna 
gudlakeVlla/*gudlakalla	n number bahu parsarg kalla 
gudlaveVnuka/gudlaveVnaka/*gudlaveVnakAla/gudlaveVnukAla/gudlaveVnakAwala/gudlaveVnukAwala	n number bahu parsarg veVnuka 
*gudlawaravAwa/gudlawarvAwa/guddulwaravAwa	n number bahu parsarg waravAwa 
gudleVxuruguMdA/*gudlakeVxuruguMdA	n number bahu parsarg eVxuruguMdA 
*gudlamaXya/gudlamaXyana/gudlamaXyalo	n number bahu parsarg maXya 
gudlanaduma/*gudlakinaduma	n number bahu parsarg naduma 
gudlabaxulugA/gudlakibaxulugA/gudlabaxulu/*gudlakibaxulu	n number bahu parsarg baxulugA 
*gudlacotlo/gudlacotulo	n number bahu parsarg cotlo 
gudlasWAnaMlo/gudlaswAnaMlo/*gudlasWAnamulo	n number bahu parsarg sWAnaMlo 
gudlanerugA/gudlakunerugA/*gudlakinerugA	n number bahu parsarg nerugA 
*gudlaprakAraM/gudlanubatti/gudlabatti/gudlanibatti	n number bahu parsarg prakAraM 
*gudlaxaggaranuMdi/gudlaxaggiranuMdi/gudlaxaggaranuMci/gudlaxaggiranuMci	n number bahu parsarg xaggaranuMdi 
*gudlavaxxanuMdi/gudlavaxxanuMci	n number bahu parsarg vaxxanuMdi 
*gudlapakkanuMdi/gudlapakkanuMci/gudlapakkalonuMdi/gudlapakkalonuMci	n number bahu parsarg pakkanuMdi 
*gudlalopalanuMdi/guddullopalanuMdi/gudlalopalanuMci/guddullopalanuMci/guddullopalinuMdi/gudlalopalinuMci	n number bahu parsarg lopalanuMdi 
*gudlabEtanuMdi/gudlabEtanuMci/gudlabEtaniMci	n number bahu parsarg bEtanuMdi 
*gudlapEnuMdi/gudlapEnuMci/gudlapEniMci	n number bahu parsarg pEnuMdi 
gudlakiMxanuMdi/gudlakiMxanuMci/gudlakiMxaniMci/*gudlakriMxanuMdi/gudlakriMxanuMci/gudlakriMxaniMci	n number bahu parsarg kriMxanuMdi 
*gudladugunuMdi/gudladugunuMci/gudladuguniMci	n number bahu parsarg adugunuMdi 
*gudlamuMxunuMdi/gudlamuMxunuMci/gudlamuMxuniMci	n number bahu parsarg muMxunuMdi 
gudlaveVnukanuMdi/gudlaveVnakanuMdi/*gudlaveVnakAlanuMdi/gudlaveVnakAlanuMci/gudlaveVnukanuMci/gudlaveVnakanuMci/gudlaveVnakAwalanuMdi/gudlaveVnakAwalanuMci	n number bahu parsarg veVnukanuMdi 
gudleVxutinuMdi/gudlakeVxutinuMdi/gudleVxutanuMdi/*gudlakeVxutanuMdi/gudleVxutinuMci/gudlakeVxutinuMci/gudleVxutanuMci/gudlakeVxutanuMci	n number bahu parsarg eVxutinuMdi 
*gudlamaXyanuMdi/gudlamaXyanuMci/gudlamaXyaniMci/gudlamaXyalonuMdi/gudlamaXyalonuMci/gudlamaXyaloniMci	n number bahu parsarg maXyanuMdi 
*gudlanadumanuMdi/gudlanadamanuMdi/gudlanadumanuMci/gudlanadamanuMci	n number bahu parsarg nadumanuMdi 
*gudlawaravAwanuMdi/gudlawarvAwanuMdi/gudlawaravAwanuMci/gudlawarvAwanuMci	n number bahu parsarg waravAwanuMdi 
*gudlacotlonuMdi/gudlacotunuMdi/gudlacotlonuMci/gudlacotloniMci/gudlacotunuMci/gudlacotuniMci	n number bahu parsarg cotlonuMdi 
*gudlasWAnamunuMdi/gudlasWAnaMnuMdi/gudlasWAnamunuMci/gudlasWAnaMnuMci/gudlasWAnaMlonuMdi/gudlasWAnamulonuMdi/gudlasWAnaMlonuMci/gudlasWAnamulonuMci	n number bahu parsarg sWAnaMnuMdi 
*gudlayaMxu/gudlaMxu	n number bahu parsarg aMxu 
*gudlaMte/gudlaMteV	n number bahu parsarg aMte 
*gudlakaMteV/gudlakaMte/gudlakanna/gudlakannA	n number bahu parsarg kaMteV 
*gudlEna	n number bahu parsarg Ena 
*gudlupAti	n number bahu parsarg pAti 
*gudlulAMti/gudlulAti	n number bahu parsarg lAMti 
*gudlugAnI/gudlukAnI	n number bahu parsarg gAni 
*gudlugA	n number bahu parsarg gA 
