noun	
guMdu	
*guMdu	n number eka parsarg 0 
-	n number eka parsarg I 
-	n number eka parsarg gA 
*guMdugAdu	n number eka parsarg gAdu 
*guMdugawweV	n number eka parsarg gawweV 
*guMduvAdu/guMdodu/guMdAdu	n number eka parsarg vAdu 
*guMdAyana	n number eka parsarg Ayana 
*guMduvAru/guMdoru/guMdAru	n number eka parsarg vAru 
*guMduxi	n number eka parsarg xi 
*guMduvi/guMduy/guMduyyi	n number eka parsarg vi 
*guMdugAru	n number eka parsarg gAru 
*guMduni	n number eka parsarg nu 
guMduvu/*guMduvi	n number eka parsarg vu 
*guMduyoVkka	n number eka parsarg yoVkka 
*guMdu	n number eka parsarg obl 
*guMduni/guMdunu	n number eka parsarg ni 
*guMduki/guMduku	n number eka parsarg ki 
*guMduwo/guMduwoda/guMduwoti	n number eka parsarg wo 
*guMdulo/guMdulona/guMdulopala	n number eka parsarg lo 
*guMduloni/guMdulopali/guMdunaMxali	n number eka parsarg loni 
*guMdumIxa	n number eka parsarg mIxa 
*guMduna	n number eka parsarg na 
guMduniMci/guMdunuMci/*guMdunuMdi	n number eka parsarg niMci 
*guMduxvArA/guMduxvAra	n number eka parsarg xvArA 
*guMduvalana/guMduvalla	n number eka parsarg valana 
*guMdunubatti	n number eka parsarg batti 
guMduce/*guMducewa	n number eka parsarg ce 
*guMduwopAtu	n number eka parsarg wopAtu 
*guMduwokUdi/guMduwokUda/guMduwokUdA/guMduwogUdi/guMduwogUdA	n number eka parsarg wokUdi 
*guMdukosaM/guMdukE/guMdArWaM	n number eka parsarg kosaM 
*guMdukoVraku/guMdukoVrYaku	n number eka parsarg koVraku 
*guMdulonuMdi/guMdulonuMci	n number eka parsarg lonuMdi 
*guMdumIxanuMdi/guMdumIxanuMci/guMdumIxinuMci	n number eka parsarg mIxanuMdi 
*guMduxAkA/guMduxAka	n number eka parsarg xAkA 
*guMduvaraku	n number eka parsarg varaku 
*guMdumIxaki/guMdumIxaku/guMdumIxiki	n number eka parsarg mIxaki 
*guMduxaggara/guMduxaggira	n number eka parsarg xaggara 
*guMduvaxxa	n number eka parsarg vaxxa 
*guMdukAda	n number eka parsarg kAda 
*guMdukeVxurugA/guMdeVxurugA	n number eka parsarg keVxurugA 
*guMdumuMxu	n number eka parsarg muMxu 
*guMduguriMci/guMduniguriMci/guMdunigUrci	n number eka parsarg guriMci 
guMdupE/*guMdupEna/guMdupEni	n number eka parsarg pE 
*guMdupEki	n number eka parsarg pEki 
*guMduguMdA	n number eka parsarg guMdA 
guMdulA/guMdulAga/*guMdulAgA	n number eka parsarg lA 
*guMduvale/guMdumAxiri/guMdunipolina/guMduvaleV/guMdunibolina	n number eka parsarg vale 
*guMdukimalle/guMdukimalleV	n number eka parsarg kimalle 
*guMdukUdA/guMdunikUdA/guMdugUdA/guMdunigUdA	n number eka parsarg kUdA 
*guMduxqRtilo/guMduxruRtilo	n number eka parsarg xqRtilo 
*guMdulekuMdA/guMdunilekuMdA/guMduleka	n number eka parsarg lekuMdA 
*guMdukAkuMdA/guMdunikAkuMdA/guMdukAka	n number eka parsarg kAkuMdA 
*guMdumoVxalukoVni/guMdunimoVxalukoVni	n number eka parsarg moVxalukoVni 
*guMduvEpu/guMduvepu/guMdukesi	n number eka parsarg vEpu 
guMdupakka/*guMduprakka/guMdupakkana/guMdupakkani	n number eka parsarg pakka 
guMdupakkalo/*guMduprakkalo	n number eka parsarg pakkalo 
*guMduloki/guMduloniki/guMdulopalaki/guMdulopalaku/guMdulopaliki	n number eka parsarg lopalaki 
guMdukiMxa/*guMdukriMxa/guMdukriMxane/guMdukiMxane	n number eka parsarg kiMxa 
guMdaduguna/*guMdukaduguna	n number eka parsarg aduguna 
guMdukeVlla/*guMdukalla	n number eka parsarg kalla 
guMduveVnuka/*guMduveVnakAla/guMduveVnakAwala/guMduvenakana	n number eka parsarg veVnuka 
guMduwaravAwa/guMduwarvAwa/*guMduwaruvAwa	n number eka parsarg waravAwa 
guMdeVxuruguMdA/*guMdukeVxuruguMdA	n number eka parsarg eVxuruguMdA 
*guMdumaXya/guMdumaXyalo/guMdumaXyana	n number eka parsarg maXya 
*guMdunaduma/guMdunadama	n number eka parsarg naduma 
guMdubaxulugA/guMdubaxulu/*guMdukibaxulu/guMdunibaxulu	n number eka parsarg baxulugA 
*guMducotlo/guMducotulo/guMducotuna	n number eka parsarg cotlo 
guMdusWAnaMlo/*guMdusWAnamulo	n number eka parsarg sWAnaMlo 
guMdunerugA/guMdukunerugA/*guMdukinerugA	n number eka parsarg nerugA 
*guMduprakAraM/guMduprakAramu	n number eka parsarg prakAraM 
*guMduxaggaranuMdi/guMduxaggaranuMci/guMduxaggiranuMdi/guMduxaggiranuMci	n number eka parsarg xaggaranuMdi 
*guMduvaxxanuMdi/guMduvaxxanuMci	n number eka parsarg vaxxanuMdi 
*guMdupakkanuMdi/guMdupakkanuMci/guMdupakkalonuMdi/guMdupakkalonuMci	n number eka parsarg pakkanuMdi 
*guMdulopalanuMdi/guMdulopalanuMci/guMdulopalinuMci/guMdulopalinuMdi	n number eka parsarg lopalanuMdi 
*guMdubEtanuMdi/guMdubEtanuMci	n number eka parsarg bEtanuMdi 
*guMdupEnuMdi/guMdupEnuMci	n number eka parsarg pEnuMdi 
guMdukiMxanuMdi/guMdukiMxanuMci/*guMdukriMxanuMdi/guMdukriMxanuMci	n number eka parsarg kriMxanuMdi 
guMdadugunuMdi/guMdadugunuMci/*guMdukadugunuMdi/guMdukadugunuMci	n number eka parsarg adugunuMdi 
*guMdumuMxunuMdi/guMdumuMxunuMci	n number eka parsarg muMxunuMdi 
guMduveVnukanuMdi/*guMduveVnakAlanuMdi/guMduveVnakAwalanuMdi/guMduveVnakanuMdi/guMduveVnukanuMci/guMduveVnakAlanuMci/guMduveVnakAwalanuMci/guMduveVnakanuMci	n number eka parsarg veVnukanuMdi 
guMdeVxutinuMdi/guMdeVxutanuMdi/*guMdukeVxutinuMdi	n number eka parsarg eVxutinuMdi 
*guMdumaXyanuMdi/guMdumaXyanuMci/guMdumaXyalonuMdi/guMdumaXyalonuMci	n number eka parsarg maXyanuMdi 
*guMdunadumanuMdi/guMdunadumanuMci	n number eka parsarg nadumanuMdi 
*guMduwaravAwanuMdi/guMduwarvAwanuMdi/guMduwaravAwanuMci/guMduwarvAwanuMci	n number eka parsarg waravAwanuMdi 
*guMducotlonuMdi/guMducotunuMdi/guMducotlonuMci/guMducotunuMci	n number eka parsarg cotlonuMdi 
*guMdusWAnaMnuMdi/guMduswAnaMnuMdi/guMdusWAnamunuMci/guMdusWAnaMnuMci/guMdusWAnaMlonuMdi/guMdusWAnamulonuMdi/guMdusWAnaMlonuMci/guMduswAnamulonuMci	n number eka parsarg sWAnaMnuMdi 
guMdaMxu/guMdunaMxu/*guMduyaMxu	n number eka parsarg aMxu 
*guMdaMte/guMdaMteV	n number eka parsarg aMte 
*guMdukaMteV/guMdukaMte/guMdukanna/guMdukannA	n number eka parsarg kaMteV 
*guMdEna	n number eka parsarg Ena 
*guMdupAti	n number eka parsarg pAti 
*guMdulAMti/guMdulAti	n number eka parsarg lAMti 
*guMdugAnI/guMdukAnI	n number eka parsarg gAni 
*guMdugA	n number eka parsarg gA 
gulYlu/*guMdlu	n number bahu parsarg 0 
gulYlU/gulYlalArA/*guMdulArA	n number bahu parsarg I 
-	n number bahu parsarg gA 
gulYlagAdu/*guMdlagAdu/gulYlugAdu	n number bahu parsarg gAdu 
gulYlagawweV/*guMdlagawweV/gulYlugawweV	n number bahu parsarg gawweV 
gulYlavAdu/*guMdlavAdu	n number bahu parsarg vAdu 
gulYlAyana/*guMdlAyana	n number bahu parsarg Ayana 
gulYlavAru/*guMdlavAru	n number bahu parsarg vAru 
gulYlaxi/*guMdlaxi	n number bahu parsarg xi 
gulYlavi/*guMdlavi/gulYlay/gulYlayyi	n number bahu parsarg vi 
gulYlagAru/*guMdlagAru	n number bahu parsarg gAru 
gulYlamu/gulYlaM/guMdlamu/*guMdlaM	n number bahu parsarg nu 
gulYlu/*guMdlu	n number bahu parsarg vu 
gulYlayoVkka/*guMdlayoVkka	n number bahu parsarg yoVkka 
gulYla/*guMdla	n number bahu parsarg obl 
gulYlani/*guMdlani/gulYlanu/guMdlanu/guMdulni	n number bahu parsarg ni 
gulYlaki/*guMdlaki/gulYlaku/guMdlaku	n number bahu parsarg ki 
gulYlawo/guMdlawoti/gulYlawoda/gulYlawoti/*guMdlawo/guMdlawoda	n number bahu parsarg wo 
gulYlalo/gulYlallo/*guMdlalo/gulYlalona/guMdlalona	n number bahu parsarg lo 
gulYlaloni/gulYlalloni/*guMdlaloni/guMdlayaMxali	n number bahu parsarg loni 
gulYlamIxa/*guMdlamIxa/gulYlamIxi	n number bahu parsarg mIxa 
gulYlana/*guMdlana/gulYlana	n number bahu parsarg na 
gulYlaniMci/guMdlaniMci/gulYlanuMci/guMdlanuMci/gulYlanuMdi/*guMdlanuMdi	n number bahu parsarg niMci 
gulYlaxvArA/*guMdlaxvArA	n number bahu parsarg xvArA 
gulYlavalana/gulYlavalla/guMdlavalla/*guMdlavalana	n number bahu parsarg valana 
gulYlanubatti/*guMdlanubatti	n number bahu parsarg batti 
gulYlacewa/*guMdlacewa/gulYlace/guMdlace	n number bahu parsarg ce 
gulYlawopAtu/*guMdlawopAtu/gulYlawobAtu/guMdlawobAtu	n number bahu parsarg wopAtu 
gulYlawokUdi/*guMdlawokUdi/gulYlawokUda/guMdlawokUda/gulYlawokUdA/guMdlawokUdA/guMdlawogUdA/guMdlawogUdi/gulYlawogUdA	n number bahu parsarg wokUdi 
gulYlakosaM/*guMdlakosaM/gulYlakE/guMdlakE/guMdlArWaM	n number bahu parsarg kosaM 
gulYlakoVraku/*guMdlakoVraku/gulYlakoVrYaku/guMdlakoVrYaku	n number bahu parsarg koVraku 
gulYlalonuMdi/gulYlalonuMci/*guMdlalonuMdi/guMdlalonuMci/gulYlaloniMci/guMdlaloniMci	n number bahu parsarg lonuMdi 
gulYlamIxanuMdi/*guMdlamIxanuMdi/gulYlamIxanuMci/guMdlamIxanuMci	n number bahu parsarg mIxanuMdi 
gulYlaxAkA/*guMdlaxAkA/gulYlaxAka/guMdlaxAka	n number bahu parsarg xAkA 
gulYlavaraku/*guMdlavaraku	n number bahu parsarg varaku 
gulYlamIxaki/*guMdlamIxaki/gulYlamIxaku/guMdlamIxaku	n number bahu parsarg mIxaki 
gulYlaxaggara/*guMdlaxaggara/guMdlaxaggira/gulYlaxaggira	n number bahu parsarg xaggara 
gulYlavaxxa/*guMdlavaxxa	n number bahu parsarg vaxxa 
gulYlakAda/*guMdlakAda	n number bahu parsarg kAda 
gulYleVxurugA/*guMdlakeVxurugA	n number bahu parsarg keVxurugA 
gulYlamuMxu/*guMdlamuMxu	n number bahu parsarg muMxu 
gulYlaguriMci/gulYlagUrci/gulYlanuguriMci/gulYlanigUrci/*guMdlaguriMci	n number bahu parsarg guriMci 
gulYlapE/gulYlapEni/gulYlapEna/*guMdlapEna	n number bahu parsarg pE 
gulYlapEki/*guMdlapEki	n number bahu parsarg pEki 
gulYlaguMdA/*guMdlaguMdA	n number bahu parsarg guMdA 
gulYlalA/guMdlalA/gulYlallAgA/guMdlallAgA/*guMdlalAgA/gulYlallA/guMdlallA	n number bahu parsarg lA 
gulYlavale/gulYlavaleV/gulYlamAxiri/gulYlanupolina/gulYlanibolina/*guMdlavale	n number bahu parsarg vale 
gulYlakumalle/*guMdlakumalle/gulYlakumalleV/guMdlakumalleV	n number bahu parsarg kimalle 
gulYlukUdA/*guMdlukUdA/guMdlugUdA/gulYlugUdA/gulYlugUda/guMdlukUda	n number bahu parsarg kUdA 
gulYlaxqRtilo/gulYlaxruRtilo/*guMdlaxqRtilo/guMdlaxruRtilo	n number bahu parsarg xqRtilo 
gulYlulekuMdA/*guMdlulekuMdA/gulYluleka/guMdluleka	n number bahu parsarg lekuMdA 
gulYlukAkuMdA/*guMdlukAkuMda/guMdlukAka/gulYlukAka	n number bahu parsarg kAkuMdA 
*guMdlanumoVxalukoVni/gulYlanumoVxalukoVni	n number bahu parsarg moVxalukoVni 
gulYlavEpu/gulYlavepu/guMdlakesi/gulYlakesi/*guMdlavEpu	n number bahu parsarg vEpu 
gulYlapakka/gulYlapakkana/gulYlaprakka/gulYlaprakkana/*guMdlaprakka	n number bahu parsarg pakka 
gulYlapakkalo/gulYlaprakkalo/*guMdlaprakkalo	n number bahu parsarg pakkalo 
gulYlaloki/*guMdlaloki/gulYlaloniki/guMdlaloniki/gulYlalopalaki/gulYlalopaliki/guMdlalopaliki/guMdlalopalaku	n number bahu parsarg lopalaki 
gulYlakiMxa/gulYlakriMxa/guMdlakiMxa/gulYlakriMxana/gulYlakiMxana/*guMdlakriMxa	n number bahu parsarg kiMxa 
gulYladuguna/gulYlakaduguna/guMdladuguna/*guMdlakaduguna	n number bahu parsarg aduguna 
gulYlakeVlla/gulYlakalla/*guMdlakalla	n number bahu parsarg kalla 
gulYlaveVnuka/gulYlaveVnaka/gulYlaveVnakAla/*guMdlaveVnakAla/guMdlaveVnaka/gulYlaveVnakAwala/gulYlaveVnukAwala/guMdlaveVnakAwala	n number bahu parsarg veVnuka 
gulYlawaravAwa/gulYlawarvAwa/*guMdlawaravAwa	n number bahu parsarg waravAwa 
*guMdleVxuruguMdA/gulYlakeVxuruguMdA	n number bahu parsarg eVxuruguMdA 
gulYlamaXya/gulYlamaXyana/gulYlamaXyalo/*guMdlamaXyalo	n number bahu parsarg maXya 
gulYlanaduma/gulYlakinaduma/*guMdlanaduma	n number bahu parsarg naduma 
gulYlabaxulugA/gulYlakibaxulugA/gulYlabaxulu/gulYlakibaxulu/*guMdlakibaxulu	n number bahu parsarg baxulugA 
gulYlacotlo/gulYlacotulo/*guMdlacotulo	n number bahu parsarg cotlo 
gulYlasWAnaMlo/gulYlaswAnaMlo/gulYlasWAnamulo/*guMdlasWAnamulo	n number bahu parsarg sWAnaMlo 
gulYlanerugA/gulYlakunerugA/gulYlakinerugA/*guMdlakinerugA	n number bahu parsarg nerugA 
gulYlaprakAraM/gulYlanubatti/gulYlabatti/gulYlanibatti/guMdlanubatti/*guMdlaprakAraM	n number bahu parsarg prakAraM 
gulYlaxaggaranuMdi/gulYlaxaggiranuMdi/gulYlaxaggaranuMci/gulYlaxaggiranuMci/*guMdlaxaggaranuMdi	n number bahu parsarg xaggaranuMdi 
gulYlavaxxanuMdi/gulYlavaxxanuMci/*guMdlavaxxanuMdi	n number bahu parsarg vaxxanuMdi 
gulYlapakkanuMdi/gulYlapakkanuMci/*guMdlapakkanuMdi/gulYlapakkalonuMdi/gulYlapakkalonuMci	n number bahu parsarg pakkanuMdi 
gulYlalopalanuMdi/*guMdlalopalanuMdi/gulYlalopalanuMci/guMdlalopalanuMci/guMdlalopalinuMdi/gulYlalopalinuMci	n number bahu parsarg lopalanuMdi 
gulYlabEtanuMdi/gulYlabEtanuMci/gulYlabEtaniMci/*guMdlabEtanuMdi	n number bahu parsarg bEtanuMdi 
gulYlapEnuMdi/gulYlapEnuMci/gulYlapEniMci/*guMdlapEnuMdi	n number bahu parsarg pEnuMdi 
gulYlakiMxanuMdi/gulYlakiMxanuMci/gulYlakiMxaniMci/gulYlakriMxanuMdi/gulYlakriMxanuMci/gulYlakriMxaniMci/*guMdlakriMxanuMdi	n number bahu parsarg kriMxanuMdi 
gulYladugunuMdi/gulYladugunuMci/gulYladuguniMci/*guMdladugunuMdi	n number bahu parsarg adugunuMdi 
gulYlamuMxunuMdi/gulYlamuMxunuMci/gulYlamuMxuniMci/*guMdlamuMxunuMdi	n number bahu parsarg muMxunuMdi 
gulYlaveVnukanuMdi/gulYlaveVnakanuMdi/*guMdlaveVnakAlanuMdi/gulYlaveVnakAlanuMci/gulYlaveVnukanuMci/guMdlaveVnakanuMci/gulYlaveVnakAlanuMdi/guMdlaveVnakAwalanuMci	n number bahu parsarg veVnukanuMdi 
guMdleVxutinuMdi/gulYlakeVxutinuMdi/*guMdlakeVxutinuMdi/guMdleVxutinuMci/gulYlakeVxutinuMci/guMdlakeVxutinuMci	n number bahu parsarg eVxutinuMdi 
gulYlamaXyanuMdi/gulYlamaXyanuMci/gulYlamaXyaniMci/*guMdlamaXyanuMdi/gulYlamaXyalonuMdi/gulYlamaXyalonuMci/gulYlamaXyaloniMci	n number bahu parsarg maXyanuMdi 
gulYlanadumanuMdi/gulYlanadamanuMdi/gulYlanadumanuMci/gulYlanadamanuMci/*guMdlanadumanuMdi	n number bahu parsarg nadumanuMdi 
gulYlawaravAwanuMdi/gulYlawarvAwanuMdi/*guMdlawaravAwanuMdi/gulYlawaravAwanuMci/gulYlawarvAwanuMci/guMdlawarvAwanuMci	n number bahu parsarg waravAwanuMdi 
gulYlacotunuMdi/gulYlacotunuMci/gulYlacotuniMci/guMdlacotunuMdi/guMdlacotunuMci/gulYlacotlonuMdi/gulYlacotlonuMci/gulYlacotloniMci/*guMdlacotlonuMdi/guMdlacotlonuMci	n number bahu parsarg cotlonuMdi 
gulYlasWAnamunuMdi/gulYlasWAnaMnuMdi/gulYlasWAnamunuMci/gulYlasWAnaMnuMci/*guMdlasWAnamunuMdi/gulYlasWAnaMlonuMdi/gulYlasWAnamulonuMdi/gulYlasWAnaMlonuMci/gulYlasWAnamulonuMci	n number bahu parsarg sWAnaMnuMdi 
gulYlayaMxu/gulYlaMxu/guMdlaMxu/*guMdlayaMxu	n number bahu parsarg aMxu 
gulYlaMte/gulYlaMteV/*guMdlaMte/guMdlaMteV	n number bahu parsarg aMte 
gulYlakaMteV/gulYlakaMte/*guMdlakaMte/guMdlakaMteV/guMdlakanna/guMdlakannA/gulYlakanna/gulYlakannA	n number bahu parsarg kaMteV 
gulYlEna/*guMdlEna	n number bahu parsarg Ena 
gulYlupAti/gulYlapAti/guMdlupAti/*guMdlapAti	n number bahu parsarg pAti 
gulYlulAMti/gulYlulAti/*guMdlulAMti/guMdlulAti	n number bahu parsarg lAMti 
gulYlugAnI/gulYlukAnI/*guMdlugAnI/guMdlukAnI	n number bahu parsarg gAni 
gulYlugA/*guMdlugA	n number bahu parsarg gA 
