noun	
gudi	
*gudi	n number eka parsarg 0  case d
-	n number eka parsarg I 
-	n number eka parsarg gA 
*gudigAdu	n number eka parsarg gAdu  case d
*gudigawweV	n number eka parsarg gawweV  case d
*gudivAdu/gudodu	n number eka parsarg vAdu  case d
*gudAyana/gudiAyana	n number eka parsarg Ayana  case d
*gudivAru/gudoru	n number eka parsarg vAru  case d
*gudixi	n number eka parsarg xi  case d
*gudivi/gudiy/gudiyyi	n number eka parsarg vi  case d
*gudigAru	n number eka parsarg gAru  case d
*gudini	n number eka parsarg nu 
*gudivi	n number eka parsarg vu  case d
*gudiyoVkka	n number eka parsarg yoVkka 
*gudi	n number eka parsarg obl 
*gudini/guNNi	n number eka parsarg ni 
*gudiki/gudiku	n number eka parsarg ki 
*gudiwo/gudiwoda/gudiwoti	n number eka parsarg wo 
*gudilo/gudilona/gulYlo/gulYlona/gudilopala/gulYlopala	n number eka parsarg lo 
*gudiloni/gulYloni/gudilopali/gulYlopali	n number eka parsarg loni 
*gudimIxa	n number eka parsarg mIxa 
*gudina	n number eka parsarg na 
gudiniMci/gudinuMci/*gudinuMdi	n number eka parsarg niMci 
*gudixvArA/gudixvAra	n number eka parsarg xvArA 
*gudivalana/gudivalla	n number eka parsarg valana 
*gudinibatti	n number eka parsarg batti 
gudice/*gudicewa	n number eka parsarg ce 
*gudiwopAtu	n number eka parsarg wopAtu 
*gudiwokUdi/gudiwokUda/gudiwokUdA/gudiwogUdA/gudiwogUdi	n number eka parsarg wokUdi 
*gudikosaM/gudikE/gudArWaM	n number eka parsarg kosaM 
*gudikoVraku/gudikoVrYaku	n number eka parsarg koVraku 
*gudilonuMdi/gudilonuMci/gudiloniMci/gulYlonuMdi/gulYlonuMci/gulYloniMci	n number eka parsarg lonuMdi 
*gudimIxanuMdi/gudimIxanuMci/gudimIxaniMci	n number eka parsarg mIxanuMdi 
*gudixAkA/gudixAka	n number eka parsarg xAkA 
*gudivaraku	n number eka parsarg varaku 
*gudimIxaki/gudimIxaku/gudimIxiki	n number eka parsarg mIxaki 
*gudixaggara/gudixaggira	n number eka parsarg xaggara 
*gudivaxxa/gudoVxxa/gudiyoVxxa	n number eka parsarg vaxxa 
*gudikAda	n number eka parsarg kAda 
*gudikeVxurugA/gudeVxurugA	n number eka parsarg keVxurugA 
*gudimuMxu	n number eka parsarg muMxu 
*gudiguriMci/gudiniguriMci/gudinigUrci	n number eka parsarg guriMci 
gudipE/*gudipEna/gudipEni	n number eka parsarg pE 
*gudipEki	n number eka parsarg pEki 
*gudiguMdA	n number eka parsarg guMdA 
gudilA/gudilAga/*gudilAgA	n number eka parsarg lA 
*gudivale/gudimAxiri/gudinipolina/gudinibolina	n number eka parsarg vale 
*gudikimalle/gudikimalleV	n number eka parsarg kimalle 
*gudikUdA/gudinikUdA/gudinigUdA/gudigUdA	n number eka parsarg kUdA 
*gudixqRtilo/gudixruRtilo	n number eka parsarg xqRtilo 
*gudilekuMdA/gudinilekuMdA/gudilekuMda/guNNilekuMdA/gudileka	n number eka parsarg lekuMdA 
*gudikAkuMdA/gudinikAkuMdA/gudikAkuMda/guNNikAkuMdA/gudikAka	n number eka parsarg kAkuMdA 
*gudimoVxalukoVni/gudinimoVxalukoVni/guNNimoVxalukoVni	n number eka parsarg moVxalukoVni 
*gudivEpu/gudivepu/gudikesi	n number eka parsarg vEpu 
gudipakka/*gudiprakka/gudipakkana/gudiprakkana/gudipakkani	n number eka parsarg pakka 
gudipakkalo/*gudiprakkalo/gudipakkalona/gudipakkaloni	n number eka parsarg pakkalo 
*gulYlYoki/gulYloki/gudiloki/gulYloniki/gudiloniki/gulYlopalaku/gudilopalaku/gudilopaliki/gulYlopaliki	n number eka parsarg lopalaki 
gudikiMxa/*gudikriMxa/gudikriMxana/gudikiMxana	n number eka parsarg kiMxa 
gudaduguna/*gudikaduguna	n number eka parsarg aduguna 
gudikeVlla/*gudikalla	n number eka parsarg kalla 
gudiveVnuka/*gudiveVnakAla/gudiveVnakAwala/gudiveVnakana	n number eka parsarg veVnuka 
gudiwaravAwa/gudiwarvAwa/*gudiwaruvAwa/gudiwaravAwana/gudiwarvAwana/gudiwaruvAwana	n number eka parsarg waravAwa 
gudeVxuruguMdA/*gudikeVxuruguMdA	n number eka parsarg eVxuruguMdA 
*gudimaXya/gudimaXyalo/gudimaXyana	n number eka parsarg maXya 
*gudinaduma/gudinadumana	n number eka parsarg naduma 
gudibaxulugA/gudibaxulu/*gudikibaxulu/gudikubaxulu	n number eka parsarg baxulugA 
*gudicotlo/gudicotulo/gudicotuna/gudicota	n number eka parsarg cotlo 
*gudisWAnaMlo/gudiswAnaMlo	n number eka parsarg sWAnaMlo 
gudinerugA/gudikunerugA/*gudikinerugA	n number eka parsarg nerugA 
*gudiprakAraM/gudiprakAramu	n number eka parsarg prakAraM 
*gudixaggaranuMdi/gudixaggaranuMci/gudixaggiranuMdi/gudixaggiranuMci	n number eka parsarg xaggaranuMdi 
*gudivaxxanuMdi/gudivaxxanuMci/gudivaxxaniMci	n number eka parsarg vaxxanuMdi 
*gudipakkanuMdi/gudipakkanuMci/gudipakkaniMci/gudipakkalonuMdi/gudipakkalonuMci/gudipakkaloniMci	n number eka parsarg pakkanuMdi 
*gudilopalanuMdi/gulYlopalanuMdi/gudilopalanuMci/gulYlopalanuMci/gulYlopalaniMci	n number eka parsarg lopalanuMdi 
*gudibEtanuMdi/gudibEtanuMci/gudibEtaniMci	n number eka parsarg bEtanuMdi 
*gudipEnuMdi/gudipEnuMci/gudipEniMci	n number eka parsarg pEnuMdi 
gudikiMxanuMdi/gudikiMxanuMci/gudikiMxaniMci/*gudikriMxanuMdi/gudikriMxanuMci/gudikriMxaniMci	n number eka parsarg kriMxanuMdi 
gudadugunuMdi/gudadugunuMci/*gudikadugunuMdi/gudikadugunuMci/gudikaduguniMci	n number eka parsarg adugunuMdi 
*gudimuMxunuMdi/gudimuMxunuMci/gudimuMxuniMci	n number eka parsarg muMxunuMdi 
gudiveVnukanuMdi/*gudiveVnakAlanuMdi/gudiveVnakAwalanuMdi/gudiveVnakanuMdi/gudiveVnukanuMci/gudiveVnakAlanuMci/gudiveVnakAwalanuMci/gudiveVnakanuMci	n number eka parsarg veVnukanuMdi 
gudeVxutinuMdi/gudikeVxutinuMdi/gudikeVxutinuMci/gudeVxutinuMci/gudeVxutanuMdi/*gudikeVxutanuMdi/gudikeVxutanuMci/gudeVxutanuMci	n number eka parsarg eVxutinuMdi 
*gudimaXyanuMdi/gudimaXyanuMci/gudimaXyalonuMdi/gudimaXyalonuMci	n number eka parsarg maXyanuMdi 
*gudinadumanuMdi/gudinadumanuMci	n number eka parsarg nadumanuMdi 
*gudiwaravAwanuMdi/gudiwarvAwanuMdi/gudiwaravAwanuMci/gudiwarvAwanuMci	n number eka parsarg waravAwanuMdi 
*gudicotlonuMdi/gudicotunuMdi/gudicotlonuMci/gudicotunuMci	n number eka parsarg cotlonuMdi 
gudisWAnaMnuMdi/*gudisWAnamunuMdi/gudisWAnaMnuMci/gudisWAnamunuMci/gudisWAnaMlonuMdi/gudisWAnamulonuMdi/gudisWAnaMlonuMci/gudiswAnamulonuMci	n number eka parsarg sWAnaMnuMdi 
gudaMxu/gudinaMxu/*gudiyaMxu	n number eka parsarg aMxu 
*gudaMte/gudaMteV	n number eka parsarg aMte 
*gudikaMteV/gudikaMte/gudikanna/gudikannA	n number eka parsarg kaMteV 
*gudEna	n number eka parsarg Ena 
*gudipAti	n number eka parsarg pAti 
*gudilAMti/gudilAti	n number eka parsarg lAMti 
*gudigAnI/gudikAnI	n number eka parsarg gAni 
*gudigA	n number eka parsarg gA 
*gulYlYu/gulYlu/gudulu	n number bahu parsarg 0  case d
*gulYlYU/gulYlU/gulYlulArA/gudulArA	n number bahu parsarg I  case d
-	n number bahu parsarg gA 
*gulYlYagAdu/gulYlagAdu/gudulagAdu	n number bahu parsarg gAdu  case d
*gulYlYagawweV/gulYlagawweV/gudulagawweV	n number bahu parsarg gawweV  case d
*gulYlYavAdu/gulYlavAdu/gulYlodu/gudulodu	n number bahu parsarg vAdu  case d
*gulYlYAyana/gulYlAyana/gudulAyana	n number bahu parsarg Ayana  case d
*gulYlYavAru/gulYlavAru/gulYloru/guduloru	n number bahu parsarg vAru  case d
*gulYlYaxi/gulYlaxi/gudulxi/gudulaxi	n number bahu parsarg xi  case d
*gulYlYavi/gulYlavi/gudulavi/gulYlay/gulYlayyi	n number bahu parsarg vi  case d
*gulYlYagAru/gulYlagAru/gudulagAru	n number bahu parsarg gAru  case d
gulYlamu/*gulYlYaM/gulYlaM/gudulaM	n number bahu parsarg nu  case d
*gulYlYu/gulYlu/gudulu	n number bahu parsarg vu 
gudulayoVkka/*gulYlYayoVkka/gulYlayoVkka	n number bahu parsarg yoVkka 
*gulYlYa/gulYla/gudula	n number bahu parsarg obl 
*gulYlYani/gulYlani/gudulni/gulYlanu/gudulanu	n number bahu parsarg ni 
*gulYlYaki/gulYlaki/gulYlaku/gudulaku	n number bahu parsarg ki 
*gulYlYawo/gulYlawo/gudulawo/gulYlawoda/gulYlawoti/gudulawoti/gudulawoda	n number bahu parsarg wo 
*gulYlYalo/gulYlalo/gudulalo/gulYlalona/gudulalona/gulYlalopala/gudulalopala	n number bahu parsarg lo 
*gulYlYaloni/gulYlaloni/gudulaloni/gudulalopali/gudulayaMxali/gulYlalopali	n number bahu parsarg loni 
*gulYlYamIxa/gulYlamIxa/gudulamIxa	n number bahu parsarg mIxa 
*gulYlYana/gulYlana/gudulana	n number bahu parsarg na 
gulYlaniMci/gudulaniMci/gulYlanuMci/gudulanuMci/*gulYlYanuMdi/gulYlanuMdi/gudulanuMdi	n number bahu parsarg niMci 
*gulYlYaxvArA/gulYlaxvArA/gulYlaxvAra/gudulaxvAra	n number bahu parsarg xvArA 
*gulYlYavalana/gulYlavalana/gulYlavalla/gudulavalla	n number bahu parsarg valana 
*gulYlYanubatti/gulYlanubatti/gudulanubatti	n number bahu parsarg batti 
*gulYlYacewa/gulYlacewa/gudulacewa/gulYlace/gudulace	n number bahu parsarg ce 
*gulYlYawopAtu/gulYlawopAtu/gudulawopAtu/gulYlawobAtu/gudulawobAtu	n number bahu parsarg wopAtu 
*gulYlYawokUdi/gulYlawokUdi/gudulwokUdi/gulYlawokUda/gulYlawokUdA/gudulawokUdA/gulYlawogUdi/gudulawogUdi/gulYlawogUda/gulYlawogUdA/gudulawogUdA	n number bahu parsarg wokUdi 
*gulYlYakosaM/gulYlakosaM/gulYlakE/gudulakE/gulYlArWaM	n number bahu parsarg kosaM 
*gulYlYakoVraku/gulYlakoVraku/gulYlakoVrYaku/gudulakoVrYaku	n number bahu parsarg koVraku 
*gulYlYalonuMdi/gulYlalonuMdi/gulYlalonuMci/gudulalonuMdi/gudulalonuMci/gudulaloniMci/gulYlaloniMci	n number bahu parsarg lonuMdi 
*gulYlYamIxanuMdi/gulYlamIxanuMdi/gulYlamIxanuMci/gulYlamIxaniMci/gudulamIxanuMdi/gudulamIxanuMci	n number bahu parsarg mIxanuMdi 
*gulYlYaxAkA/gulYlaxAkA/gulYlaxAka/gudulaxAka/gudulaxAkA	n number bahu parsarg xAkA 
*gulYlYavaraku/gulYlavaraku/gudulavaraku	n number bahu parsarg varaku 
*gulYlYamIxaki/gulYlamIxaki/gulYlamIxaku/gulYlamIxiki/gudulamIxaki/gudulamIxaku/gudulamIxiki	n number bahu parsarg mIxaki 
*gulYlYaxaggara/gulYlaxaggara/gulYlaxaggira/gudulaxaggira/gudulaxaggara	n number bahu parsarg xaggara 
*gulYlYavaxxa/gulYlavaxxa/gulYloVxxa/gudulavaxxa	n number bahu parsarg vaxxa 
*gulYlYakAda/gulYlakAda/gudulakAda	n number bahu parsarg kAda 
gulYleVxurugA/*gulYlYakeVxurugA/gulYlakeVxurugA/guduleVxurugA/gudulakeVxurugA	n number bahu parsarg keVxurugA 
*gulYlYamuMxu/gulYlamuMxu/gudulamuMxu	n number bahu parsarg muMxu 
*gulYlYaguriMci/gulYlaguriMci/gulYlagUrci/gulYlanuguriMci/gulYlanigUrci/gudulaguriMci/gudulanugUrci	n number bahu parsarg guriMci 
gulYlapE/gulYlapEni/*gulYlYapEna/gulYlapEna/gudulapEna/gudulapEni/gudulapE	n number bahu parsarg pE 
*gulYlYapEki/gulYlapEki/gudulapEki	n number bahu parsarg pEki 
*gulYlYaguMdA/gulYlaguMdA/gudulaguMdA	n number bahu parsarg guMdA 
gulYlalA/gudulalA/*gulYlYalAga/gulYlalAga/gudulalAga/gudulalAgA	n number bahu parsarg lA 
*gulYlYavale/gulYlavale/gulYlavaleV/gulYlamAxiri/gulYlanipoli/gulYlanubolina/gudulanupolina/gudulamAxiri/gudulavale	n number bahu parsarg vale 
*gulYlYakumalle/gulYlakumalle/gudulakumalle/gulYlakimalleV/gulYlakimalle	n number bahu parsarg kimalle 
*gulYlYukUdA/gulYlukUdA/gulYlanukUdA/gulYlugUdA/gulYlanugUdA/gudulanugUdA/gudulanukUdA	n number bahu parsarg kUdA 
*gulYlYaxqRtilo/gulYlaxqRtilo/gulYlaxruRtilo/gudulaxqRtilo/gudulaxruRtilo	n number bahu parsarg xqRtilo 
*gulYlYulekuMdA/gulYlulekuMdA/gudullekuMdA/gudululekuMdA/gudululeka/gulYluleka	n number bahu parsarg lekuMdA 
*gulYlYukAkuMdA/gulYlukAkuMdA/gulYlukAkuMda/gudulukAkuMdA/gudulukAka/gulYlukAka/gulYlugAkuMdA/gulYlugAkuMda/gudulugAkuMdA/gudulugAka/gulYlugAka	n number bahu parsarg kAkuMdA 
*gulYlYumoVxalukoVni/gulYlumoVxalukoVni/gulYlanumoVxalukoVni/gudulanumoVxalukoVni	n number bahu parsarg moVxalukoVni 
*gulYlYavEpu/gulYlavEpu/gulYlavepu/gudulavEpu/gudulavepu/gulYlakesi/gudulakesi	n number bahu parsarg vEpu 
gulYlapakka/gulYlapakkana/*gulYlYaprakka/gulYlaprakka/gulYlaprakkana/gudulapakkana	n number bahu parsarg pakka 
gulYlapakkalo/*gulYlYaprakkalo/gulYlaprakkalo/gudulapakkalo	n number bahu parsarg pakkalo 
*gulYlYaloki/gulYlaloki/gudulloki/gulYlaloniki/gudulaloniki/gulYlalopalaki/gulYlalopaliki/gudulalopaliki/gudulalopalaku	n number bahu parsarg lopalaki 
gulYlakiMxa/*gulYlYakriMxa/gulYlakriMxa/gudulakiMxa/gulYlakriMxane/gulYlakiMxane/gudulakiMxane	n number bahu parsarg kiMxa 
gulYladuguna/*gulYlYakaduguna/gulYlakaduguna/guduladuguna/gudulakaduguna	n number bahu parsarg aduguna 
gulYlakeVlla/*gulYlYakalla/gulYlakalla/gudulakalla	n number bahu parsarg kalla 
gulYlaveVnuka/gulYlaveVnaka/*gulYlYaveVnakAla/gulYlaveVnakAla/gulYlaveVnukAla/gudulaveVnakAla/gudulaveVnaka/gulYlaveVnakAwala/gulYlaveVnukAwala/gudulaveVnakAwala	n number bahu parsarg veVnuka 
*gulYlYawaravAwa/gulYlawaravAwa/gulYlawarvAwa/gudulwaravAwa	n number bahu parsarg waravAwa 
gulYleVxuruguMdA/*gulYlYakeVxuruguMdA/gulYlakeVxuruguMdA/guduleVxurugMdA	n number bahu parsarg eVxuruguMdA 
*gulYlYamaXya/gulYlamaXya/gulYlamaXyana/gulYlamaXyalo/gudulamaXyalo/gudulamaXyana	n number bahu parsarg maXya 
*gulYlYanaduma/gulYlanaduma/gulYlakinaduma/gudulanadumana	n number bahu parsarg naduma 
gulYlabaxulugA/gulYlakibaxulugA/gulYlabaxulu/*gulYlYakibaxulu/gulYlakibaxulu/gudulakubaxulu	n number bahu parsarg baxulugA 
*gulYlYacotlo/gulYlacotlo/gulYlacotulo/gudulacotlo/gudulacotulo	n number bahu parsarg cotlo 
gulYlasWAnaMlo/gulYlaswAnaMlo/*gulYlYasWAnamulo/gulYlasWAnamulo/gudulasWAnaMlo	n number bahu parsarg sWAnaMlo 
gulYlanerugA/gulYlakunerugA/*gulYlYakinerugA/gulYlakinerugA/gudulakuneruga	n number bahu parsarg nerugA 
*gulYlYaprakAraM/gulYlaprakAraM/gulYlanubatti/gulYlabatti/gulYlanibatti/gudulnibatti	n number bahu parsarg prakAraM 
*gulYlYaxaggaranuMdi/gulYlaxaggaranuMdi/gulYlaxaggiranuMdi/gulYlaxaggaranuMci/gulYlaxaggiranuMci	n number bahu parsarg xaggaranuMdi 
*gulYlYavaxxanuMdi/gulYlavaxxanuMdi/gulYlavaxxanuMci/gudulavaxxanuMdi	n number bahu parsarg vaxxanuMdi 
*gulYlYapakkanuMdi/gulYlapakkanuMdi/gulYlapakkanuMci/gudulapakkanuMdi/gulYlYapakkalonuMdi/gulYlapakkalonuMdi/gulYlapakkalonuMci/gudulapakkalonuMdi	n number bahu parsarg pakkanuMdi 
*gulYlYalopalanuMdi/gulYlalopalanuMdi/gudulalopalanuMdi/gulYlalopalanuMci/gudulalopalanuMci/gudulalopalinuMdi/gulYlalopalinuMci	n number bahu parsarg lopalanuMdi 
*gulYlYabEtanuMdi/gulYlabEtanuMdi/gulYlabEtanuMci/gulYlabEtaniMci/gudulabEtanuMdi	n number bahu parsarg bEtanuMdi 
*gulYlYapEnuMdi/gulYlapEnuMdi/gulYlapEnuMci/gulYlapEniMci	n number bahu parsarg pEnuMdi 
gulYlakiMxanuMdi/gulYlakiMxanuMci/gulYlakiMxaniMci/gudulakiMxanuMdi/*gulYlYakriMxanuMdi/gulYlakriMxanuMdi/gulYlakriMxanuMci/gulYlakriMxaniMci/gudulakriMxanuMdi	n number bahu parsarg kriMxanuMdi 
*gulYlYadugunuMdi/gulYladugunuMdi/gulYladugunuMci/gulYladuguniMci/guduladugunuMdi	n number bahu parsarg adugunuMdi 
*gulYlYamuMxunuMdi/gulYlamuMxunuMdi/gulYlamuMxunuMci/gulYlamuMxuniMci/gudulamuMxunuMdi	n number bahu parsarg muMxunuMdi 
gulYlaveVnukanuMdi/gulYlaveVnakanuMdi/*gulYlYaveVnakAlanuMdi/gulYlaveVnakAlanuMdi/gudulaveVnakanuMdi/gulYlaveVnakAlanuMci/gulYlaveVnukanuMci/gulYlaveVnakanuMci/gudulaveVnakanuMci/gulYlaveVnakAwalanuMdi/gulYlaveVnakAwalanuMci	n number bahu parsarg veVnukanuMdi 
gulYleVxutinuMdi/gulYlakeVxutinuMdi/guduleVxutinuMdi/gulYleVxutanuMdi/*gulYlYakeVxutanuMdi/gulYlakeVxutanuMdi/guduleVxutanuMdi/gulYleVxutinuMci/gulYlakeVxutinuMci/gudulakeVxutinuMdi/gulYleVxutanuMci/gulYlakeVxutanuMci/gudulakeVxutanuMdi	n number bahu parsarg eVxutinuMdi 
*gulYlYamaXyanuMdi/gulYlamaXyanuMdi/gulYlamaXyanuMci/gulYlamaXyaniMci/gudulamaXyanuMdi/gulYlamaXyalonuMdi/gulYlamaXyalonuMci/gulYlamaXyaloniMci/gudulamaXyalonuMdi	n number bahu parsarg maXyanuMdi 
*gulYlYanadumanuMdi/gulYlanadumanuMdi/gulYlanadamanuMdi/gulYlanadumanuMci/gulYlanadamanuMci/gudulanadamanuMdi	n number bahu parsarg nadumanuMdi 
*gulYlYawaravAwanuMdi/gulYlawaravAwanuMdi/gulYlawarvAwanuMdi/gudulawaravAwanuMdi/gulYlawaravAwanuMci/gulYlawarvAwanuMci/gudulawaravAwanuMci	n number bahu parsarg waravAwanuMdi 
gulYlacotunuMdi/gulYlacotunuMci/gudulacotunuMdi/gudulacotunuMci/gulYlacotlonuMci/gulYlacotloniMci/*gulYlYacotlonuMdi/gulYlacotlonuMdi/gulYlacotuniMci	n number bahu parsarg cotlonuMdi 
*gulYlYasWAnamunuMdi/gulYlasWAnamunuMdi/gulYlasWAnaMnuMdi/gudulasWAnaMnuMdi/gulYlasWAnamunuMci/gulYlasWAnaMnuMci/gudulasWAnaMnuMci/gulYlasWAnaMlonuMdi/gulYlasWAnamulonuMdi/gudulasWAnaMlonuMdi/gulYlasWAnaMlonuMci/gulYlasWAnamulonuMci/gudulasWAnaMlonuMci	n number bahu parsarg sWAnaMnuMdi 
*gulYlYayaMxu/gulYlayaMxu/gulYlaMxu/gudulaMxu/gudulayaMxu	n number bahu parsarg aMxu 
*gulYlYaMte/gulYlaMte/gulYlaMteV/gudulaMte	n number bahu parsarg aMte 
*gulYlYakaMteV/gulYlakaMteV/gulYlakaMte/gudulakaMte/gulYlakanna/gulYlakannA/gudulakannA	n number bahu parsarg kaMteV 
*gulYlYEna/gulYlEna/gudulEna	n number bahu parsarg Ena 
*gulYlYapAti/gulYlapAti/gudulapAti	n number bahu parsarg pAti 
*gulYlYulAMti/gulYlulAMti/gulYlalAti/gudulalAMti/gudulalAti	n number bahu parsarg lAMti 
*gulYlYugAnI/gulYlugAnI/gulYlukAnI/gudulugAnI/gudulukAnI	n number bahu parsarg gAni 
*gulYlYugA/gulYlugA/gudulugA	n number bahu parsarg gA 
