noun	
gaxi	
*gaxi	n number eka parsarg 0 
-	n number eka parsarg I 
-	n number eka parsarg gA 
*gaxigAdu	n number eka parsarg gAdu 
*gaxigawweV	n number eka parsarg gawweV 
*gaxivAdu	n number eka parsarg vAdu 
*gaxAyana	n number eka parsarg Ayana 
*gaxivAru	n number eka parsarg vAru 
*gaxixi	n number eka parsarg xi 
*gaxivi/gaxiy	n number eka parsarg vi 
*gaxigAru	n number eka parsarg gAru 
*gaxini	n number eka parsarg nu 
*gaxivi	n number eka parsarg vu 
*gaxiyoVkka	n number eka parsarg yoVkka 
*gaxi	n number eka parsarg obl 
*gaxini/gaxinu	n number eka parsarg ni 
*gaxiki/gaxiku	n number eka parsarg ki 
*gaxiwo/gaxiwoda/gaxiwoti	n number eka parsarg wo 
gaxilo/gaxilona/*gaxilopala	n number eka parsarg lo 
*gaxiloni/gaxilopali/gaxiyaMxali	n number eka parsarg loni 
*gaximIxa	n number eka parsarg mIxa 
*gaxina	n number eka parsarg na 
gaxiniMci/gaxinuMci/*gaxinuMdi	n number eka parsarg niMci 
*gaxixvArA/gaxixvAra	n number eka parsarg xvArA 
*gaxivalana/gaxivalla	n number eka parsarg valana 
*gaxinibatti	n number eka parsarg batti 
gaxice/*gaxicewa	n number eka parsarg ce 
*gaxiwopAtu	n number eka parsarg wopAtu 
*gaxiwokUdi/gaxiwokUda/gaxiwokUdA/gaxiwogUdi/gaxiwogUda/gaxiwogUdA	n number eka parsarg wokUdi 
*gaxikosaM/gaxikE/gaxArWaM	n number eka parsarg kosaM 
*gaxikoVraku/gaxikoVrYaku	n number eka parsarg koVraku 
*gaxilonuMdi/gaxilonuMci/gaxiloniMci	n number eka parsarg lonuMdi 
*gaximIxanuMdi/gaximIxanuMci/gaximIxaniMci	n number eka parsarg mIxanuMdi 
*gaxixAkA/gaxixAka	n number eka parsarg xAkA 
*gaxivaraku	n number eka parsarg varaku 
*gaximIxaki/gaximIxaku/gaximIxiki	n number eka parsarg mIxaki 
*gaxixaggara/gaxixaggira	n number eka parsarg xaggara 
*gaxivaxxa/gaxoVxxa	n number eka parsarg vaxxa 
*gaxikAda	n number eka parsarg kAda 
*gaxikeVxurugA/gaxeVxurugA	n number eka parsarg keVxurugA 
*gaximuMxu	n number eka parsarg muMxu 
*gaxiguriMci/gaxiniguriMci/gaxinigUrci	n number eka parsarg guriMci 
gaxipE/*gaxipEna/gaxipEni	n number eka parsarg pE 
*gaxipEki	n number eka parsarg pEki 
*gaxiguMdA	n number eka parsarg guMdA 
gaxilA/gaxilAga/*gaxilAgA	n number eka parsarg lA 
*gaxivale/gaximAxiri/gaxinipolina/gaxinibolina	n number eka parsarg vale 
*gaxikimalle/gaxikimalleV	n number eka parsarg kimalle 
*gaxikUdA/gaxinikUdA/gaxigUdA/gaxinigUdA	n number eka parsarg kUdA 
*gaxixqRtilo/gaxixruRtilo	n number eka parsarg xqRtilo 
*gaxilekuMdA/gaxinilekuMdA/gaxileka/gaxilekuMda	n number eka parsarg lekuMdA 
*gaxikAkuMdA/gaxinikAkuMdA/gaxikAka/gaxigAka/gaxinigAkuMdA/gaxigAkuMdA	n number eka parsarg kAkuMdA 
*gaximoVxalukoVni/gaxinimoVxalukoVni/gaxinumoVxalukoVni	n number eka parsarg moVxalukoVni 
*gaxivEpu/gaxivepu/gaxikesi	n number eka parsarg vEpu 
gaxipakka/gaxiprakka/gaxipakkana/*gaxiprakkana/gaxipakkani	n number eka parsarg pakka 
gaxipakkalo/*gaxiprakkalo/gaxipakkalona/gaxipakkaloni	n number eka parsarg pakkalo 
gaxiloki/gaxiloniki/*gaxilopalaki/gaxilopalaku/gaxilopaliki	n number eka parsarg lopalaki 
gaxikiMxa/*gaxikriMxa/gaxikriMxana/gaxikiMxana	n number eka parsarg kiMxa 
gaxaduguna/*gaxikaduguna	n number eka parsarg aduguna 
gaxikeVlla/*gaxikalla	n number eka parsarg kalla 
gaxiveVnuka/*gaxiveVnakAla/gaxiveVnakAwala/gaxiveVnakana	n number eka parsarg veVnuka 
gaxiwaravAwa/gaxiwarvAwa/*gaxiwaruvAwa/gaxiwaravAwana/gaxiwarvAwana/gaxiwaruvAwana	n number eka parsarg waravAwa 
gaxeVxuruguMdA/*gaxikeVxuruguMdA	n number eka parsarg eVxuruguMdA 
*gaximaXya/gaximaXyalo/gaximaXyana	n number eka parsarg maXya 
*gaxinaduma/gaxinadumana	n number eka parsarg naduma 
gaxibaxulugA/gaxibaxulu/*gaxikibaxulu/gaxikubaxulu	n number eka parsarg baxulugA 
*gaxicotlo/gaxicotulo/gaxicotuna/gaxicota	n number eka parsarg cotlo 
*gaxisWAnaMlo/gaxiswAnaMlo	n number eka parsarg sWAnaMlo 
gaxinerugA/gaxikunerugA/*gaxikinerugA	n number eka parsarg nerugA 
*gaxiprakAraM/gaxiprakAramu	n number eka parsarg prakAraM 
*gaxixaggaranuMdi/gaxixaggaranuMci/gaxixaggiranuMdi/gaxixaggiranuMci	n number eka parsarg xaggaranuMdi 
*gaxivaxxanuMdi/gaxivaxxanuMci/gaxivaxxaniMci	n number eka parsarg vaxxanuMdi 
*gaxipakkanuMdi/gaxipakkanuMci/gaxipakkaniMci/gaxipakkalonuMdi/gaxipakkalonuMci/gaxipakkaloniMci	n number eka parsarg pakkanuMdi 
*gaxilopalanuMdi/gaxilopalanuMci/gaxilopalaniMci	n number eka parsarg lopalanuMdi 
*gaxibEtanuMdi/gaxibEtanuMci/gaxibEtaniMci	n number eka parsarg bEtanuMdi 
*gaxipEnuMdi/gaxipEnuMci/gaxipEniMci	n number eka parsarg pEnuMdi 
gaxikiMxanuMdi/gaxikiMxanuMci/gaxikiMxaniMci/*gaxikriMxanuMdi/gaxikriMxanuMci/gaxikriMxaniMci	n number eka parsarg kriMxanuMdi 
gaxadugunuMdi/gaxadugunuMci/*gaxikadugunuMdi/gaxikadugunuMci/gaxikaduguniMci	n number eka parsarg adugunuMdi 
*gaximuMxunuMdi/gaximuMxunuMci/gaximuMxuniMci	n number eka parsarg muMxunuMdi 
gaxiveVnukanuMdi/*gaxiveVnakAlanuMdi/gaxiveVnakAwalanuMdi/gaxiveVnakanuMdi/gaxiveVnukanuMci/gaxiveVnakAlanuMci/gaxiveVnakAwalanuMci/gaxiveVnakanuMci	n number eka parsarg veVnukanuMdi 
gaxeVxutinuMdi/gaxikeVxutinuMdi/gaxikeVxutinuMci/gaxeVxutinuMci/gaxeVxutanuMdi/*gaxikeVxutanuMdi/gaxikeVxutanuMci/gaxeVxutanuMci	n number eka parsarg eVxutinuMdi 
*gaximaXyanuMdi/gaximaXyanuMci/gaximaXyalonuMdi/gaximaXyalonuMci	n number eka parsarg maXyanuMdi 
*gaxinadumanuMdi/gaxinadumanuMci	n number eka parsarg nadumanuMdi 
*gaxiwaravAwanuMdi/gaxiwarvAwanuMdi/gaxiwaravAwanuMci/gaxiwarvAwanuMci	n number eka parsarg waravAwanuMdi 
*gaxicotlonuMdi/gaxicotunuMdi/gaxicotlonuMci/gaxicotunuMci	n number eka parsarg cotlonuMdi 
gaxisWAnaMnuMdi/*gaxisWAnamunuMdi/gaxisWAnaMnuMci/gaxisWAnamunuMci/gaxisWAnaMlonuMdi/gaxisWAnamulonuMdi/gaxisWAnaMlonuMci/gaxiswAnamulonuMci	n number eka parsarg sWAnaMnuMdi 
gaxaMxu/gaxinaMxu/*gaxiyaMxu	n number eka parsarg aMxu 
*gaxaMte/gaxaMteV	n number eka parsarg aMte 
*gaxikaMteV/gaxikaMte/gaxikannA/gaxikanna	n number eka parsarg kaMteV 
*gaxEna	n number eka parsarg Ena 
*gaxipAti	n number eka parsarg pAti 
*gaxilAMti/gaxilAti	n number eka parsarg lAMti 
*gaxigAnI/gaxikAnI	n number eka parsarg gAni 
*gaxigA	n number eka parsarg gA 
*gaxulu	n number bahu parsarg 0 
gaxulU/gaxululArA/*gaxullArA	n number bahu parsarg I 
-	n number bahu parsarg gA 
*gaxulagAdu	n number bahu parsarg gAdu 
*gaxulagawweV	n number bahu parsarg gawweV 
*gaxulavAdu/gaxulodu	n number bahu parsarg vAdu 
*gaxulAyana	n number bahu parsarg Ayana 
*gaxulavAru/gaxuloru	n number bahu parsarg vAru 
*gaxulaxi/gaxulxi	n number bahu parsarg xi 
*gaxulavi/gaxulay/gaxuliy	n number bahu parsarg vi 
*gaxulagAru	n number bahu parsarg gAru 
*gaxulaM/gaxulamu	n number bahu parsarg nu 
-	n number bahu parsarg vu 
*gaxulayoVkka	n number bahu parsarg yoVkka 
*gaxula	n number bahu parsarg obl 
*gaxulani/gaxulni/gaxulanu/gaxulnu	n number bahu parsarg ni 
*gaxulaki/gaxulaku	n number bahu parsarg ki 
*gaxulawo/gaxulwo/gaxulawoda/gaxulawoti/gaxulwoti/gaxulwoda	n number bahu parsarg wo 
*gaxulalo/gaxullo/gaxulalona/gaxullona	n number bahu parsarg lo 
*gaxulaloni/gaxulayaMxali/gaxulloni	n number bahu parsarg loni 
*gaxulamIxa	n number bahu parsarg mIxa 
*gaxulana	n number bahu parsarg na 
gaxulaniMci/gaxulniMci/gaxulanuMci/gaxulnuMci/*gaxulanuMdi/gaxulnuMdi	n number bahu parsarg niMci 
*gaxulaxvArA/gaxulaxvAra	n number bahu parsarg xvArA 
*gaxulavalana/gaxulavalla	n number bahu parsarg valana 
*gaxulanubatti/gaxulnibatti/gaxulanibatti	n number bahu parsarg batti 
*gaxulacewa/gaxulcewa/gaxulace/gaxulce	n number bahu parsarg ce 
*gaxulawopAtu/gaxulwopAtu/gaxulawobAtu/gaxulwobAtu	n number bahu parsarg wopAtu 
*gaxulawokUdi/gaxulwokUdi/gaxulawogUdi/gaxulawokUdA/gaxulawogUdA/gaxulwogUdA	n number bahu parsarg wokUdi 
*gaxulakosaM/gaxulakE/gaxulArWaM	n number bahu parsarg kosaM 
*gaxulakoVraku/gaxulakoVrYaku	n number bahu parsarg koVraku 
*gaxulalonuMdi/gaxulalonuMci/gaxullonuMdi/gaxullonuMci/gaxulloniMci/gaxulaloniMci	n number bahu parsarg lonuMdi 
*gaxulamIxanuMdi/gaxulamIxanuMci/gaxulamIxaniMci	n number bahu parsarg mIxanuMdi 
*gaxulaxAkA/gaxulaxAka	n number bahu parsarg xAkA 
*gaxulavaraku	n number bahu parsarg varaku 
*gaxulamIxaki/gaxulamIxaku/gaxulamIxiki	n number bahu parsarg mIxaki 
*gaxulaxaggara/gaxulaxaggira	n number bahu parsarg xaggara 
*gaxulavaxxa/gaxuloVxxa/gaxulayoVxxa	n number bahu parsarg vaxxa 
*gaxulakAda	n number bahu parsarg kAda 
gaxuleVxurugA/*gaxulakeVxurugA	n number bahu parsarg keVxurugA 
*gaxulamuMxu	n number bahu parsarg muMxu 
*gaxulaguriMci/gaxulagUrci/gaxulanuguriMci/gaxulanigUrci	n number bahu parsarg guriMci 
gaxulapE/gaxulapEni/*gaxulapEna	n number bahu parsarg pE 
*gaxulapEki	n number bahu parsarg pEki 
*gaxulaguMdA	n number bahu parsarg guMdA 
gaxulalA/gaxullA/gaxulalAga/gaxullAga/*gaxullAgA	n number bahu parsarg lA 
*gaxulavale/gaxulavaleV/gaxulamAxiri/gaxulapoli/gaxulabolina/gaxulanupolina/gaxulanuboli	n number bahu parsarg vale 
*gaxulakumalle/gaxulakumalleV	n number bahu parsarg kimalle 
*gaxulukUdA/gaxulakUdA/gaxulugUdA/gaxulugUda	n number bahu parsarg kUdA 
*gaxulaxqRtilo/gaxulaxruRtilo	n number bahu parsarg xqRtilo 
*gaxululekuMdA/gaxullekuMdA/gaxululeka/gaxulleka	n number bahu parsarg lekuMdA 
*gaxulukAkuMdA/gaxulukAkuMda/gaxulukAka/gaxulugAka	n number bahu parsarg kAkuMdA 
*gaxulumoVxalukoVni/gaxulanumoVxalukoVni	n number bahu parsarg moVxalukoVni 
*gaxulavEpu/gaxulavepu/gaxulakesi	n number bahu parsarg vEpu 
gaxulapakka/gaxulapakkana/gaxulaprakka/*gaxulaprakkana	n number bahu parsarg pakka 
gaxulapakkalo/*gaxulaprakkalo	n number bahu parsarg pakkalo 
gaxulaloki/gaxulaloniki/gaxulloki/gaxulloniki/*gaxulalopalaki/gaxulalopaliki/gaxullopaliki/gaxullopalaku	n number bahu parsarg lopalaki 
gaxulakiMxa/*gaxulakriMxa/gaxulakriMxana/gaxulakiMxana	n number bahu parsarg kiMxa 
gaxuladuguna/*gaxulakaduguna	n number bahu parsarg aduguna 
gaxulakeVlla/*gaxulakalla	n number bahu parsarg kalla 
gaxulaveVnuka/gaxulaveVnaka/*gaxulaveVnakAla/gaxulaveVnukAla/gaxulaveVnakAwala/gaxulaveVnukAwala	n number bahu parsarg veVnuka 
*gaxulawaravAwa/gaxulawarvAwa/gaxulwaravAwa	n number bahu parsarg waravAwa 
gaxuleVxuruguMdA/*gaxulakeVxuruguMdA	n number bahu parsarg eVxuruguMdA 
*gaxulamaXya/gaxulamaXyana/gaxulamaXyalo	n number bahu parsarg maXya 
*gaxulanaduma/gaxulakinaduma	n number bahu parsarg naduma 
gaxulabaxulugA/gaxulakibaxulugA/gaxulabaxulu/*gaxulakibaxulu	n number bahu parsarg baxulugA 
*gaxulacotlo/gaxulacotulo	n number bahu parsarg cotlo 
gaxulasWAnaMlo/gaxulaswAnaMlo/*gaxulasWAnamulo	n number bahu parsarg sWAnaMlo 
gaxulanerugA/gaxulakunerugA/*gaxulakinerugA	n number bahu parsarg nerugA 
*gaxulaprakAraM/gaxulanubatti/gaxulabatti/gaxulanibatti	n number bahu parsarg prakAraM 
*gaxulaxaggaranuMdi/gaxulaxaggiranuMdi/gaxulaxaggaranuMci/gaxulaxaggiranuMci	n number bahu parsarg xaggaranuMdi 
*gaxulavaxxanuMdi/gaxulavaxxanuMci	n number bahu parsarg vaxxanuMdi 
*gaxulapakkanuMdi/gaxulapakkanuMci/gaxulapakkalonuMdi/gaxulapakkalonuMci	n number bahu parsarg pakkanuMdi 
*gaxulalopalanuMdi/gaxullopalanuMdi/gaxulalopalanuMci/gaxullopalanuMci/gaxullopalinuMdi/gaxulalopalinuMci	n number bahu parsarg lopalanuMdi 
*gaxulabEtanuMdi/gaxulabEtanuMci/gaxulabEtaniMci	n number bahu parsarg bEtanuMdi 
*gaxulapEnuMdi/gaxulapEnuMci/gaxulapEniMci	n number bahu parsarg pEnuMdi 
gaxulakiMxanuMdi/gaxulakiMxanuMci/gaxulakiMxaniMci/*gaxulakriMxanuMdi/gaxulakriMxanuMci/gaxulakriMxaniMci	n number bahu parsarg kriMxanuMdi 
*gaxuladugunuMdi/gaxuladugunuMci/gaxuladuguniMci	n number bahu parsarg adugunuMdi 
*gaxulamuMxunuMdi/gaxulamuMxunuMci/gaxulamuMxuniMci	n number bahu parsarg muMxunuMdi 
gaxulaveVnukanuMdi/gaxulaveVnakanuMdi/*gaxulaveVnakAlanuMdi/gaxulaveVnakAlanuMci/gaxulaveVnukanuMci/gaxulaveVnakanuMci/gaxulaveVnakAwalanuMci/gaxulaveVnakAwalanuMci	n number bahu parsarg veVnukanuMdi 
gaxuleVxutinuMdi/gaxulakeVxutinuMdi/gaxuleVxutanuMdi/*gaxulakeVxutanuMdi/gaxuleVxutinuMci/gaxulakeVxutinuMci/gaxuleVxutanuMci/gaxulakeVxutanuMci	n number bahu parsarg eVxutinuMdi 
*gaxulamaXyanuMdi/gaxulamaXyanuMci/gaxulamaXyaniMci/gaxulamaXyalonuMdi/gaxulamaXyalonuMci/gaxulamaXyaloniMci	n number bahu parsarg maXyanuMdi 
*gaxulanadumanuMdi/gaxulanadamanuMdi/gaxulanadumanuMci/gaxulanadamanuMci	n number bahu parsarg nadumanuMdi 
*gaxulawaravAwanuMdi/gaxulawarvAwanuMdi/gaxulawaravAwanuMci/gaxulawarvAwanuMci	n number bahu parsarg waravAwanuMdi 
gaxulacotunuMci/gaxulacotunuMdi/*gaxulacotlonuMci/gaxulacotloniMci/gaxulacotulonuMci/gaxulacotulonuMdi	n number bahu parsarg cotlonuMdi 
*gaxulasWAnamunuMdi/gaxulasWAnaMnuMdi/gaxulasWAnamunuMci/gaxulasWAnaMnuMci/gaxulasWAnaMlonuMdi/gaxulasWAnamulonuMdi/gaxulasWAnaMlonuMci/gaxulasWAnamulonuMci	n number bahu parsarg sWAnaMnuMdi 
*gaxulayaMxu/gaxulaMxu	n number bahu parsarg aMxu 
*gaxulaMte/gaxulaMteV	n number bahu parsarg aMte 
*gaxulakaMteV/gaxulakaMte/gaxulakanna/gaxulakannA	n number bahu parsarg kaMteV 
*gaxulEna	n number bahu parsarg Ena 
*gaxulupAti/gaxulapAti	n number bahu parsarg pAti 
*gaxululAMti/gaxululAti	n number bahu parsarg lAMti 
*gaxulugAnI/gaxulukAnI	n number bahu parsarg gAni 
*gaxulugA	n number bahu parsarg gA 
