noun	
kuMxelu	
*kuMxelu	n number eka parsarg 0 
-	n number eka parsarg I 
-	n number eka parsarg gA 
*kuMxelugAdu/kuMxetigAdu	n number eka parsarg gAdu 
*kuMxelugawweV/kuMxetigawweV	n number eka parsarg gawweV 
*kuMxeluvAdu/kuMxetivAdu	n number eka parsarg vAdu 
*kuMxelAyana/kuMxetAyana	n number eka parsarg Ayana 
*kuMxeluvAru/kuMxetivAru	n number eka parsarg vAru 
*kuMxeluxi/kuMxetixi	n number eka parsarg xi 
*kuMxeluvi/kuMxetivi/kuMxeluy	n number eka parsarg vi 
*kuMxelugAru	n number eka parsarg gAru 
*kuMxelunu	n number eka parsarg nu 
*kuMxeluvu	n number eka parsarg vu 
*kuMxeluyoVkka/kuMxetiyoVkka	n number eka parsarg yoVkka 
kuMxeti/*kuMxelu	n number eka parsarg obl 
*kuMxeluni/kuMxetini	n number eka parsarg ni 
*kuMxeluki/kuMxetiki	n number eka parsarg ki 
*kuMxeluwo/kuMxeluwoda/kuMxeluwoti/kuMxetiwoti/kuMxetiwo	n number eka parsarg wo 
kuMxelulo/kuMxelulona/kuMxetilo/kuMxetlo/kuMxetilona/*kuMxelulopala/kuMxetilopala	n number eka parsarg lo 
*kuMxeluloni/kuMxetiloni/kuMxelulopali/kuMxetilopali	n number eka parsarg loni 
*kuMxelumIxa/kuMxetimIxa	n number eka parsarg mIxa 
*kuMxeluna/kuMxetina	n number eka parsarg na 
*kuMxelunuMdi/kuMxeluniMci/kuMxelunuMci/kuMxetinuMdi	n number eka parsarg niMci 
*kuMxeluxvArA/kuMxeluxvAra	n number eka parsarg xvArA 
*kuMxeluvalana/kuMxeluvalla	n number eka parsarg valana 
*kuMxelunibatti/kuMxetinibatti	n number eka parsarg batti 
kuMxeluce/*kuMxelucewa/kuMxeticewa	n number eka parsarg ce 
*kuMxeluwopAtu/kuMxetiwopAtu	n number eka parsarg wopAtu 
*kuMxeluwokUdi/kuMxeluwokUda/kuMxeluwokUdA/kuMxeluwokUdA/kuMxeluwogUdi/kuMxeluwogUda/kuMxeluwogUdA/kuMxeluwogUdA	n number eka parsarg wokUdi 
*kuMxelukosaM/kuMxelukE/kuMxelukosaM/kuMxelukosamu/kuMxelArWaM	n number eka parsarg kosaM 
*kuMxelukoVraku/kuMxelukoVrYaku/kuMxetikoVrYaku	n number eka parsarg koVraku 
*kuMxelulonuMdi/kuMxelulonuMci/kuMxeluloniMci/kuMxellonuMdi/kuMxellonuMci/kuMxelloniMci/kuMxetilonuMdi	n number eka parsarg lonuMdi 
*kuMxelumIxanuMdi/kuMxelumIxanuMci/kuMxelumIxaniMci	n number eka parsarg mIxanuMdi 
*kuMxeluxAkA/kuMxetixAka	n number eka parsarg xAkA 
*kuMxeluvaraku/kuMxetivaraku	n number eka parsarg varaku 
*kuMxelumIxaki/kuMxelumIxaku/kuMxelumIxiki	n number eka parsarg mIxaki 
*kuMxeluxaggara/kuMxeluxaggira	n number eka parsarg xaggara 
*kuMxeluvaxxa/kuMxeloVxxa	n number eka parsarg vaxxa 
*kuMxelukAda/kuMxetikAda	n number eka parsarg kAda 
*kuMxelukeVxurugA/kuMxeleVxurugA/kuMxetikeVxurugA	n number eka parsarg keVxurugA 
*kuMxelumuMxu/kuMxetimuMxu	n number eka parsarg muMxu 
*kuMxeluguriMci/kuMxeluniguriMci/kuMxelunigUrci/kuMxelunuguriMci/kuMxelunugUrci	n number eka parsarg guriMci 
kuMxelupE/kuMxetipE/*kuMxelupEna/kuMxetipEna/kuMxelupEni	n number eka parsarg pE 
*kuMxelupEki/kuMxetipEki	n number eka parsarg pEki 
*kuMxeluguMdA/kuMxetiguMdA	n number eka parsarg guMdA 
kuMxelulA/kuMxelulAga/*kuMxelulAgA	n number eka parsarg lA 
*kuMxeluvale/kuMxeluvaleV/kuMxelumAxiri/kuMxelunipoli/kuMxelunibolina	n number eka parsarg vale 
*kuMxelukumalle/kuMxelukumalleV/kuMxetikimalle	n number eka parsarg kimalle 
*kuMxelukUdA/kuMxelunikUdA/kuMxelunukUdA/kuMxelugUdA/kuMxelunigUdA/kuMxelunugUdA	n number eka parsarg kUdA 
*kuMxeluxqRtilo/kuMxeluxruRtilo	n number eka parsarg xqRtilo 
*kuMxelulekuMdA/kuMxelunilekuMdA/kuMxelulekuMda/kuMxeluleka	n number eka parsarg lekuMdA 
*kuMxelukAkuMdA/kuMxelunikAkuMdA/kuMxelugAkuMda/kuMxelugAka	n number eka parsarg kAkuMdA 
*kuMxelumoVxalukoVni/kuMxelunimoVxalukoVni/kuMxelunumoVxalukoVni	n number eka parsarg moVxalukoVni 
*kuMxeluvEpu/kuMxeluvepu/kuMxelukesi/kuMxetikesi/kuMxetivEpu	n number eka parsarg vEpu 
kuMxelupakka/kuMxeluprakka/kuMxelupakkana/*kuMxeluprakkana/kuMxelupakkani	n number eka parsarg pakka 
kuMxelupakkalo/*kuMxeluprakkalo/kuMxelupakkalona/kuMxelupakkaloni	n number eka parsarg pakkalo 
kuMxeluloki/kuMxeluloniki/kuMxelloki/kuMxelloniki/kuMxelulopalaku/kuMxellopalaku/*kuMxelulopalaki/kuMxellopaliki/kuMxelulopaliki	n number eka parsarg lopalaki 
kuMxelukiMxa/*kuMxelukriMxa/kuMxetikriMxa/kuMxelukriMxana/kuMxelukiMxana/kuMxetikiMxana	n number eka parsarg kiMxa 
kuMxeladuguna/*kuMxelukaduguna/kuMxetikaduguna	n number eka parsarg aduguna 
kuMxelukeVlla/*kuMxelukalla/kuMxetikalla	n number eka parsarg kalla 
kuMxeluveVnuka/*kuMxeluveVnakAla/kuMxeluveVnakAwala/kuMxeluveVnakana	n number eka parsarg veVnuka 
kuMxeluwaravAwa/kuMxeluwarvAwa/*kuMxeluwaruvAwa/kuMxeluwaravAwana/kuMxeluwarvAwana/kuMxeluwaruvAwana	n number eka parsarg waravAwa 
kuMxeleVxuruguMdA/*kuMxelukeVxuruguMdA	n number eka parsarg eVxuruguMdA 
*kuMxelumaXya/kuMxelumaXyalo/kuMxelumaXyana	n number eka parsarg maXya 
*kuMxelunaduma/kuMxelunadumana	n number eka parsarg naduma 
kuMxelubaxulugA/kuMxelubaxulu/*kuMxelukibaxulu/kuMxelukubaxulu	n number eka parsarg baxulugA 
*kuMxelucotlo/kuMxelucotulo/kuMxelucotuna/kuMxelucota	n number eka parsarg cotlo 
*kuMxelusWAnaMlo/kuMxeluswAnaMlo	n number eka parsarg sWAnaMlo 
kuMxelunerugA/kuMxelukunerugA/*kuMxelukinerugA	n number eka parsarg nerugA 
*kuMxeluprakAraM/kuMxeluprakAramu	n number eka parsarg prakAraM 
*kuMxeluxaggaranuMdi/kuMxeluxaggaranuMci/kuMxeluxaggiranuMdi/kuMxeluxaggiranuMci	n number eka parsarg xaggaranuMdi 
*kuMxeluvaxxanuMdi/kuMxeluvaxxanuMci/kuMxeluvaxxaniMci	n number eka parsarg vaxxanuMdi 
*kuMxelupakkanuMdi/kuMxelupakkanuMci/kuMxelupakkaniMci/kuMxelupakkalonuMdi/kuMxelupakkalonuMci/kuMxelupakkaloniMci	n number eka parsarg pakkanuMdi 
*kuMxelulopalanuMdi/kuMxellopalanuMdi/kuMxelulopalanuMci/kuMxellopalanuMci/kuMxelulopalaniMci	n number eka parsarg lopalanuMdi 
*kuMxelubEtanuMdi/kuMxelubEtanuMci/kuMxelubEtaniMci	n number eka parsarg bEtanuMdi 
*kuMxelupEnuMdi/kuMxelupEnuMci/kuMxelupEniMci	n number eka parsarg pEnuMdi 
kuMxelukiMxanuMdi/kuMxelukiMxanuMci/kuMxelukiMxaniMci/*kuMxelukriMxanuMdi/kuMxelukriMxanuMci/kuMxelukriMxaniMci	n number eka parsarg kriMxanuMdi 
kuMxeladugunuMdi/kuMxeladugunuMci/*kuMxelukadugunuMdi/kuMxelukadugunuMci/kuMxelukaduguniMci	n number eka parsarg adugunuMdi 
*kuMxelumuMxunuMdi/kuMxelumuMxunuMci/kuMxelumuMxuniMci	n number eka parsarg muMxunuMdi 
kuMxeluveVnukanuMdi/*kuMxeluveVnakAlanuMdi/kuMxeluveVnakAwalanuMdi/kuMxeluveVnakanuMdi/kuMxeluveVnukanuMci/kuMxeluveVnakAlanuMci/kuMxeluveVnakAwalanuMci/kuMxeluveVnakanuMci	n number eka parsarg veVnukanuMdi 
kuMxeleVxutinuMdi/kuMxelukeVxutinuMdi/kuMxelukeVxutinuMci/kuMxeleVxutinuMci/kuMxeleVxutanuMdi/*kuMxelukeVxutanuMdi/kuMxelukeVxutanuMci/kuMxeleVxutanuMci	n number eka parsarg eVxutinuMdi 
*kuMxelumaXyanuMdi/kuMxelumaXyanuMci/kuMxelumaXyalonuMdi/kuMxelumaXyalonuMci	n number eka parsarg maXyanuMdi 
*kuMxelunadumanuMdi/kuMxelunadumanuMci	n number eka parsarg nadumanuMdi 
*kuMxeluwaravAwanuMdi/kuMxeluwarvAwanuMdi/kuMxeluwaravAwanuMci/kuMxeluwarvAwanuMci	n number eka parsarg waravAwanuMdi 
*kuMxelucotlonuMdi/kuMxelucotunuMdi/kuMxelucotlonuMci/kuMxelucotunuMci	n number eka parsarg cotlonuMdi 
kuMxelusWAnaMnuMdi/*kuMxelusWAnamunuMdi/kuMxelusWAnaMnuMci/kuMxelusWAnamunuMci/kuMxelusWAnaMlonuMdi/kuMxelusWAnamulonuMdi/kuMxelusWAnaMlonuMci/kuMxelusWAnamulonuMci	n number eka parsarg sWAnaMnuMdi 
kuMxelaMxu/kuMxelunaMxu/*kuMxeluyaMxu	n number eka parsarg aMxu 
*kuMxelaMte/kuMxelaMteV	n number eka parsarg aMte 
*kuMxelukaMteV/kuMxelukaMte/kuMxelukannA/kuMxelukanna/kuMxelukannA/kuMxelukanna	n number eka parsarg kaMteV 
*kuMxelEna	n number eka parsarg Ena 
*kuMxelupAti	n number eka parsarg pAti 
*kuMxelulAMti/kuMxelulAti	n number eka parsarg lAMti 
*kuMxelugAnI/kuMxelugAni	n number eka parsarg gAni 
*kuMxelugA	n number eka parsarg gA 
*kuMxelYlYu/kuMxelYlu	n number bahu parsarg 0 
*kuMxelYlYulArA/kuMxelYlulArA/kuMxelYlU	n number bahu parsarg I 
-	n number bahu parsarg gA 
*kuMxelYlYagAdu/kuMxelYlagAdu	n number bahu parsarg gAdu 
*kuMxelYlYagawweV/kuMxelYlagawweV	n number bahu parsarg gawweV 
*kuMxelYlYavAdu/kuMxelYlavAdu/kuMxelYlodu	n number bahu parsarg vAdu 
*kuMxelYlYAyana/kuMxelYlAyana	n number bahu parsarg Ayana 
*kuMxelYlYavAru/kuMxelYlavAru/kuMxelYloru	n number bahu parsarg vAru 
*kuMxelYlYaxi/kuMxelYlaxi	n number bahu parsarg xi 
*kuMxelYlYavi/kuMxelYlavi/kuMxelYlay	n number bahu parsarg vi 
*kuMxelYlYagAru/kuMxelYlagAru	n number bahu parsarg gAru 
*kuMxelYlYaM/kuMxelYlaM/kuMxelYlamu	n number bahu parsarg nu 
*kuMxelYlYu/kuMxelYlu	n number bahu parsarg vu 
*kuMxelYlYayoVkka/kuMxelYlayoVkka	n number bahu parsarg yoVkka 
*kuMxelYlYa/kuMxelYla	n number bahu parsarg obl 
*kuMxelYlYani/kuMxelYlani/kuMxelYlanu	n number bahu parsarg ni 
*kuMxelYlYaki/kuMxelYlaki/kuMxelYlaku	n number bahu parsarg ki 
*kuMxelYlYawo/kuMxelYlawo/kuMxelYlawoda/kuMxelYlawoti	n number bahu parsarg wo 
kuMxelYlalo/kuMxelYlallo/kuMxelYlallona/kuMxelYlalona/kuMxelYlalopala/*kuMxelYlYalopala	n number bahu parsarg lo 
kuMxelYlalloni/kuMxelYlaloni/*kuMxelYlYaloni/kuMxelYlalopali/kuMxelYlayaMxali	n number bahu parsarg loni 
*kuMxelYlYamIxa/kuMxelYlamIxa	n number bahu parsarg mIxa 
*kuMxelYlYana/kuMxelYlana	n number bahu parsarg na 
kuMxelYlaniMci/kuMxelYlanuMci/kuMxelYlanuMdi/*kuMxelYlYanuMdi	n number bahu parsarg niMci 
*kuMxelYlYaxvArA/kuMxelYlaxvArA/kuMxelYlaxvAra	n number bahu parsarg xvArA 
*kuMxelYlYavalana/kuMxelYlavalana/kuMxelYlavalla/	n number bahu parsarg valana 
*kuMxelYlYanubatti/kuMxelYlanubatti	n number bahu parsarg batti 
*kuMxelYlYacewa/kuMxelYlacewa/kuMxelYlace	n number bahu parsarg ce 
*kuMxelYlYawopAtu/kuMxelYlawopAtu/kuMxelYlawobAtu	n number bahu parsarg wopAtu 
*kuMxelYlYawokUdi/kuMxelYlawokUdi/kuMxelYlawogUdi/kuMxelYlawokUda/kuMxelYlawogUdA/kuMxelYlawokUdA	n number bahu parsarg wokUdi 
*kuMxelYlYakosaM/kuMxelYlakosaM/kuMxelYlakE/kuMxelYlArWaM	n number bahu parsarg kosaM 
*kuMxelYlYakoVraku/kuMxelYlakoVraku/kuMxelYlakoVrYaku	n number bahu parsarg koVraku 
*kuMxelYlYalonuMdi/kuMxelYlalonuMdi/kuMxelYlalonuMci/kuMxelYlaloniMci	n number bahu parsarg lonuMdi 
*kuMxelYlYamIxanuMdi/kuMxelYlamIxanuMdi/kuMxelYlamIxanuMci/kuMxelYlamIxaniMci	n number bahu parsarg mIxanuMdi 
*kuMxelYlYaxAkA/kuMxelYlaxAkA/kuMxelYlaxAka	n number bahu parsarg xAkA 
*kuMxelYlYavaraku/kuMxelYlavaraku	n number bahu parsarg varaku 
*kuMxelYlYamIxaki/kuMxelYlamIxaki/kuMxelYlamIxaku/kuMxelYlamIxiki	n number bahu parsarg mIxaki 
*kuMxelYlYaxaggara/kuMxelYlaxaggara/kuMxelYlaxaggira	n number bahu parsarg xaggara 
*kuMxelYlYavaxxa/kuMxelYlavaxxa/kuMxelYloVxxa	n number bahu parsarg vaxxa 
*kuMxelYlYakAda/kuMxelYlakAda	n number bahu parsarg kAda 
kuMxelYleVxurugA/kuMxelYlakeVxurugA/*kuMxelYlYakeVxurugA	n number bahu parsarg keVxurugA 
*kuMxelYlYamuMxu/kuMxelYlamuMxu	n number bahu parsarg muMxu 
*kuMxelYlYaguriMci/kuMxelYlaguriMci/kuMxelYlagUrci/kuMxelYlanuguriMci/kuMxelYlanigUrci	n number bahu parsarg guriMci 
kuMxelYlapE/kuMxelYlapEni/kuMxelYlapEna/*kuMxelYlYapEna	n number bahu parsarg pE 
*kuMxelYlYapEki/kuMxelYlapEki	n number bahu parsarg pEki 
*kuMxelYlYaguMdA/kuMxelYlaguMdA	n number bahu parsarg guMdA 
kuMxelYlalA/kuMxelYlalAga/kuMxelYlalAgA/*kuMxelYlYalAgA	n number bahu parsarg lA 
*kuMxelYlYavale/kuMxelYlavale/kuMxelYlavaleV/kuMxelYlamAxiri/kuMxelYlanupoli/kuMxelYlanubolina	n number bahu parsarg vale 
*kuMxelYlYakumalle/kuMxelYlakumalle/kuMxelYlakumalleV	n number bahu parsarg kimalle 
kuMxelYlanukUdA/*kuMxelYlYukUdA/kuMxelYlukUdA/kuMxelYlugUdA/kuMxelYlanugUdA	n number bahu parsarg kUdA 
*kuMxelYlYaxqRtilo/kuMxelYlaxqRtilo/kuMxelYlaxruRtilo	n number bahu parsarg xqRtilo 
*kuMxelYlYulekuMdA/kuMxelYlulekuMdA/kuMxelYlanulekuMdA/kuMxelYluleka	n number bahu parsarg lekuMdA 
*kuMxelYlYukAkuMdA/kuMxelYlukAkuMdA/kuMxelYlukAkuMda/kuMxelYlukAka/kuMxelYlugAkuMdA/kuMxelYlugAkuMda/kuMxelYlugAka	n number bahu parsarg kAkuMdA 
*kuMxelYlYumoVxalukoVni/kuMxelYlumoVxalukoVni/kuMxelYlanumoVxalukoVni	n number bahu parsarg moVxalukoVni 
*kuMxelYlYavepu/kuMxelYlavepu/kuMxelYlakesi    --  it should be vEpu 	n number bahu parsarg vEpu 
kuMxelYlapakka/kuMxelYlapakkana/kuMxelYlaprakka/kuMxelYlaprakkana/*kuMxelYlYaprakkana	n number bahu parsarg pakka 
kuMxelYlapakkalo/kuMxelYlaprakkalo/*kuMxelYlYaprakkalo	n number bahu parsarg pakkalo 
kuMxelYlaloki/kuMxelYlaloniki/*kuMxelYlYalopalaki/kuMxelYlalopalaki/kuMxelYlalopaliki/kuMxelYlalopaliki/kuMxelYlalopalaku	n number bahu parsarg lopalaki 
kuMxelYlakiMxa/*kuMxelYlYakriMxa/kuMxelYlakriMxa/kuMxelYlakriMxane/kuMxelYlakiMxane	n number bahu parsarg kiMxa 
kuMxelYladuguna/kuMxelYlakaduguna/*kuMxelYlYakaduguna	n number bahu parsarg aduguna 
kuMxelYlakeVlla/kuMxelYlakalla/*kuMxelYlYakalla	n number bahu parsarg kalla 
kuMxelYlaveVnuka/kuMxelYlaveVnaka/*kuMxelYlYaveVnakAla/kuMxelYlaveVnakAla/kuMxelYlaveVnukAla/kuMxelYlaveVnakAwala/kuMxelYlaveVnukAwala	n number bahu parsarg veVnuka 
kuMxelYlawaravAwa/kuMxelYlawarvAwa/kuMxelYlawaruvAwa/*kuMxelYlYawaruvAwa	n number bahu parsarg waravAwa 
kuMxelYleVxuruguMdA/kuMxelYlakeVxuruguMdA/*kuMxelYlYakeVxuruguMdA	n number bahu parsarg eVxuruguMdA 
*kuMxelYlYamaXya/kuMxelYlamaXya/kuMxelYlamaXyana/kuMxelYlamaXyalo	n number bahu parsarg maXya 
*kuMxelYlYanaduma/kuMxelYlanaduma/kuMxelYlakinaduma	n number bahu parsarg naduma 
kuMxelYlabaxulugA/kuMxelYlakibaxulugA/kuMxelYlabaxulu/*kuMxelYlYakibaxulu/kuMxelYlakibaxulu/kuMxelYlanubaxulu	n number bahu parsarg baxulugA 
*kuMxelYlYacotlo/kuMxelYlacotlo/kuMxelYlacotulo	n number bahu parsarg cotlo 
kuMxelYlasWAnaMlo/kuMxelYlaswAnaMlo/kuMxelYlasWAnamulo/*kuMxelYlYasWAnamulo	n number bahu parsarg sWAnaMlo 
kuMxelYlanerugA/kuMxelYlakunerugA/kuMxelYlakinerugA/*kuMxelYlYakinerugA	n number bahu parsarg nerugA 
*kuMxelYlYaprakAraM/kuMxelYlaprakAraM/kuMxelYlanubatti/kuMxelYlabatti/kuMxelYlanibatti	n number bahu parsarg prakAraM 
*kuMxelYlYaxaggaranuMdi/kuMxelYlaxaggaranuMdi/kuMxelYlaxaggiranuMdi/kuMxelYlaxaggaranuMci/kuMxelYlaxaggiranuMci	n number bahu parsarg xaggaranuMdi 
*kuMxelYlYavaxxanuMdi/kuMxelYlavaxxanuMdi/kuMxelYlavaxxanuMci	n number bahu parsarg vaxxanuMdi 
*kuMxelYlYapakkanuMdi/kuMxelYlapakkanuMdi/kuMxelYlapakkanuMci/kuMxelYlapakkalonuMdi/kuMxelYlapakkalonuMci	n number bahu parsarg pakkanuMdi 
*kuMxelYlYalopalanuMdi/kuMxelYlalopalanuMdi/kuMxelYlalopalanuMci/kuMxelYlalopalinuMdi/kuMxelYlalopalinuMci	n number bahu parsarg lopalanuMdi 
*kuMxelYlYabEtanuMdi/kuMxelYlabEtanuMdi/kuMxelYlabEtanuMci/kuMxelYlabEtaniMci	n number bahu parsarg bEtanuMdi 
*kuMxelYlYapEnuMdi/kuMxelYlapEnuMdi/kuMxelYlapEnuMci/kuMxelYlapEniMci	n number bahu parsarg pEnuMdi 
kuMxelYlakiMxanuMdi/kuMxelYlakiMxanuMci/kuMxelYlakiMxaniMci/*kuMxelYlYakriMxanuMdi/kuMxelYlakriMxanuMdi/kuMxelYlakriMxanuMci/kuMxelYlakriMxaniMci	n number bahu parsarg kriMxanuMdi 
*kuMxelYlYadugunuMdi/kuMxelYladugunuMdi/kuMxelYladugunuMci/kuMxelYladuguniMci	n number bahu parsarg adugunuMdi 
*kuMxelYlYamuMxunuMdi/kuMxelYlamuMxunuMdi/kuMxelYlamuMxunuMci/kuMxelYlamuMxuniMci	n number bahu parsarg muMxunuMdi 
kuMxelYlaveVnukanuMdi/kuMxelYlaveVnakanuMdi/kuMxelYlaveVnakAlanuMdi/*kuMxelYlYaveVnakAlanuMdi/kuMxelYlaveVnakAlanuMci/kuMxelYlaveVnukanuMci/kuMxelYlaveVnakanuMci/kuMxelYlaveVnakAwalanuMdi/kuMxelYlaveVnakAwalanuMci	n number bahu parsarg veVnukanuMdi 
kuMxelYleVxutinuMdi/kuMxelYlakeVxutinuMdi/kuMxelYleVxutanuMdi/*kuMxelYlYakeVxutanuMdi/kuMxelYlakeVxutanuMdi/kuMxelYleVxutinuMci/kuMxelYlakeVxutinuMci/kuMxelYleVxutanuMci/kuMxelYlakeVxutanuMci	n number bahu parsarg eVxutinuMdi 
*kuMxelYlYamaXyanuMdi/kuMxelYlamaXyanuMdi/kuMxelYlamaXyanuMci/kuMxelYlamaXyaniMci/kuMxelYlamaXyalonuMdi/kuMxelYlamaXyalonuMci/kuMxelYlamaXyaloniMci	n number bahu parsarg maXyanuMdi 
*kuMxelYlYanadumanuMdi/kuMxelYlanadumanuMdi/kuMxelYlanadamanuMdi/kuMxelYlanadumanuMci/kuMxelYlanadumaniMci/kuMxelYlanadamanuMci	n number bahu parsarg nadumanuMdi 
*kuMxelYlYawarvAwanuMdi/kuMxelYlawarvAwanuMdi/kuMxelYlawaravAwanuMci/kuMxelYlawarvAwanuMci	n number bahu parsarg waravAwanuMdi 
kuMxelYlacotunuMdi/kuMxelYlacotunuMci/kuMxelYlacotlonuMci/kuMxelYlacotloniMci/kuMxelYlacotlonuMdi/*kuMxelYlYacotlonuMdi	n number bahu parsarg cotlonuMdi 
*kuMxelYlYasWAnamunuMdi/kuMxelYlasWAnamunuMdi/kuMxelYlasWAnaMnuMdi/kuMxelYlasWAnamunuMci/kuMxelYlasWAnaMnuMci/kuMxelYlasWAnaMlonuMdi/kuMxelYlasWAnamulonuMdi/kuMxelYlasWAnaMlonuMci/kuMxelYlasWAnamulonuMci	n number bahu parsarg sWAnaMnuMdi 
*kuMxelYlYayaMxu/kuMxelYlayaMxu/kuMxelYlaMxu	n number bahu parsarg aMxu 
*kuMxelYlYaMte/kuMxelYlaMte/kuMxelYlaMteV	n number bahu parsarg aMte 
*kuMxelYlYakaMteV/kuMxelYlakaMteV/kuMxelYlakaMte/kuMxelYlakanna/kuMxelYlakannA	n number bahu parsarg kaMteV 
*kuMxelYlYEna/kuMxelYlEna	n number bahu parsarg Ena 
*kuMxelYlYapAti/kuMxelYlapAti	n number bahu parsarg pAti 
*kuMxelYlYalAMti/kuMxelYlalAMti/kuMxelYlalAti	n number bahu parsarg lAMti 
*kuMxelYlYugAnI/kuMxelYlugAnI/kuMxelYlugAni	n number bahu parsarg gAni 
*kuMxelYlYugA/kuMxelYlugA	n number bahu parsarg gA 
