noun	
kotu	
*kotu	n number eka parsarg 0 
-	n number eka parsarg I 
-	n number eka parsarg gA 
*kotugAdu	n number eka parsarg gAdu 
*kotugawweV	n number eka parsarg gawweV 
*kotuvAdu	n number eka parsarg vAdu 
*kotAyana	n number eka parsarg Ayana 
*kotuvAru	n number eka parsarg vAru 
*kotuxi	n number eka parsarg xi 
*kotuvi/kotuy	n number eka parsarg vi 
*kotugAru	n number eka parsarg gAru 
*kotunu/kotuni	n number eka parsarg nu 
*kotuvu/kotuvi	n number eka parsarg vu 
*kotuyoVkka	n number eka parsarg yoVkka 
*kotu	n number eka parsarg obl 
*kotuni/kotunu	n number eka parsarg ni 
*kotuki/kotuku	n number eka parsarg ki 
*kotuwo/kotuwoda/kotuwoti/kotuwoni	n number eka parsarg wo 
kotulo/kotulona/*kotulopala	n number eka parsarg lo 
*kotuloni/kotulopali/kotunaMxali	n number eka parsarg loni 
*kotumIxa	n number eka parsarg mIxa 
*kotuna	n number eka parsarg na 
kotuniMci/kotunuMci/*kotunuMdi	n number eka parsarg niMci 
*kotuxvArA/kotuxvAra	n number eka parsarg xvArA 
*kotuvalana/kotuvalla	n number eka parsarg valana 
*kotunubatti/kotunibatti	n number eka parsarg batti 
kotuce/*kotucewa	n number eka parsarg ce 
*kotuwopAtu/kotuwobAtu	n number eka parsarg wopAtu 
*kotuwokUdi/kotuwokUda/kotuwokUdA/kotuwogUdA	n number eka parsarg wokUdi 
*kotukosaM/kotukE/kotArWaM	n number eka parsarg kosaM 
*kotukoVraku/kotukoVrYaku	n number eka parsarg koVraku 
*kotulonuMdi/kotulonuMci/kotuloniMci	n number eka parsarg lonuMdi 
*kotumIxanuMdi/kotumIxanuMci/kotumIxaniMci	n number eka parsarg mIxanuMdi 
*kotuxAkA/kotuxAka	n number eka parsarg xAkA 
*kotuvaraku	n number eka parsarg varaku 
*kotumIxaki/kotumIxaku/kotumIxiki	n number eka parsarg mIxaki 
*kotuxaggara/kotuxaggira	n number eka parsarg xaggara 
*kotuvaxxa/kotoVxxa	n number eka parsarg vaxxa 
*kotukAda	n number eka parsarg kAda 
*kotukeVxurugA/koteVxurugA	n number eka parsarg keVxurugA 
*kotumuMxu	n number eka parsarg muMxu 
*kotuguriMci/kotuniguriMci/kotunugUrci	n number eka parsarg guriMci 
kotupE/*kotupEna/kotupEni	n number eka parsarg pE 
*kotupEki	n number eka parsarg pEki 
*kotuguMdA	n number eka parsarg guMdA 
kotulA/kotulAga/*kotulAgA	n number eka parsarg lA 
*kotuvale/kotumAxiri/kotunipolina/kotunubolina	n number eka parsarg vale 
*kotukimalle/kotukumalle/kotukimalleV/kotukumalleV	n number eka parsarg kimalle 
*kotukUdA/kotunikUdA/kotunukUdA/kotugUdA/kotunugUdA/kotunigUdA	n number eka parsarg kUdA 
*kotuxqRtilo/kotuxruRtilo	n number eka parsarg xqRtilo 
*kotulekuMdA/kotuleka/kotulekuMda/kotunulekuMdA	n number eka parsarg lekuMdA 
*kotukAkuMdA/kotukAka/kotukAkuMda/kotunukAkuMdA/kotugAkuMdA/kotugAka/kotugAkuMda/kotunugAkuMdA	n number eka parsarg kAkuMdA 
*kotumoVxalukoVni/kotunimoVxalukoVni/kotunumoVxalukoVni	n number eka parsarg moVxalukoVni 
*kotuvEpu/kotuvepu/kotukesi	n number eka parsarg vEpu 
kotupakka/kotuprakka/kotupakkana/*kotuprakkana/kotupakkani	n number eka parsarg pakka 
kotupakkalo/*kotuprakkalo/kotupakkalona/kotupakkaloni	n number eka parsarg pakkalo 
kotuloki/kotuloniki/*kotulopalaki/kotulopalaku/kotulopaliki	n number eka parsarg lopalaki 
kotukiMxa/*kotukriMxa/kotukriMxana/kotukiMxana	n number eka parsarg kiMxa 
kotaduguna/*kotukaduguna	n number eka parsarg aduguna 
kotukeVlla/*kotukalla	n number eka parsarg kalla 
kotuveVnuka/*kotuveVnakAla/kotuveVnakAwala/kotuveVnakana	n number eka parsarg veVnuka 
kotuwaravAwa/kotuwarvAwa/*kotuwaruvAwa/kotuwaravAwana/kotuwarvAwana/kotuwaruvAwana	n number eka parsarg waravAwa 
koteVxuruguMdA/*kotukeVxuruguMdA	n number eka parsarg eVxuruguMdA 
*kotumaXya/kotumaXyalo/kotumaXyana	n number eka parsarg maXya 
*kotunaduma/kotunadumana	n number eka parsarg naduma 
kotubaxulugA/kotubaxulu/*kotukibaxulu/kotukubaxulu	n number eka parsarg baxulugA 
*kotucotlo/kotucotulo/kotucotuna/kotucota	n number eka parsarg cotlo 
*kotusWAnaMlo/kotuswAnaMlo	n number eka parsarg sWAnaMlo 
kotunerugA/kotukunerugA/*kotukinerugA	n number eka parsarg nerugA 
*kotuprakAraM/kotuprakAramu	n number eka parsarg prakAraM 
*kotuxaggaranuMdi/kotuxaggaranuMci/kotuxaggiranuMdi/kotuxaggiranuMci	n number eka parsarg xaggaranuMdi 
*kotuvaxxanuMdi/kotuvaxxanuMci/kotuvaxxaniMci	n number eka parsarg vaxxanuMdi 
*kotupakkanuMdi/kotupakkanuMci/kotupakkaniMci/kotupakkalonuMdi/kotupakkalonuMci/kotupakkaloniMci	n number eka parsarg pakkanuMdi 
*kotulopalanuMdi/kotulopalanuMci/kotulopalaniMci	n number eka parsarg lopalanuMdi 
*kotubEtanuMdi/kotubEtanuMci/kotubEtaniMci	n number eka parsarg bEtanuMdi 
*kotupEnuMdi/kotupEnuMci/kotupEniMci	n number eka parsarg pEnuMdi 
kotukiMxanuMdi/kotukiMxanuMci/kotukiMxaniMci/*kotukriMxanuMdi/kotukriMxanuMci/kotukriMxaniMci	n number eka parsarg kriMxanuMdi 
kotadugunuMdi/kotadugunuMci/*kotukadugunuMdi/kotukadugunuMci/kotukaduguniMci	n number eka parsarg adugunuMdi 
*kotumuMxunuMdi/kotumuMxunuMci/kotumuMxuniMci	n number eka parsarg muMxunuMdi 
kotuveVnukanuMdi/*kotuveVnakAlanuMdi/kotuveVnakAwalanuMdi/kotuveVnakanuMdi/kotuveVnukanuMci/kotuveVnakAlanuMci/kotuveVnakAwalanuMci/kotuveVnakanuMci	n number eka parsarg veVnukanuMdi 
koteVxutinuMdi/kotukeVxutinuMdi/kotukeVxutinuMci/koteVxutinuMci/koteVxutanuMdi/*kotukeVxutanuMdi/kotukeVxutanuMci/koteVxutanuMci	n number eka parsarg eVxutinuMdi 
*kotumaXyanuMdi/kotumaXyanuMci/kotumaXyalonuMdi/kotumaXyalonuMci	n number eka parsarg maXyanuMdi 
*kotunadumanuMdi/kotunadumanuMci	n number eka parsarg nadumanuMdi 
*kotuwaravAwanuMdi/kotuwarvAwanuMdi/kotuwaravAwanuMci/kotuwarvAwanuMci	n number eka parsarg waravAwanuMdi 
*kotucotlonuMdi/kotucotunuMdi/kotucotlonuMci/kotucotunuMci	n number eka parsarg cotlonuMdi 
kotusWAnaMnuMdi/*kotusWAnamunuMdi/kotusWAnaMnuMci/kotusWAnamunuMci/kotusWAnaMlonuMdi/kotusWAnamulonuMdi/kotusWAnaMlonuMci/kotuswAnamulonuMci	n number eka parsarg sWAnaMnuMdi 
kotaMxu/kotunaMxu/*kotuyaMxu	n number eka parsarg aMxu 
*kotaMte/kotaMteV	n number eka parsarg aMte 
*kotukaMteV/kotukaMte/kotukanna/kotukannA	n number eka parsarg kaMteV 
*kotEna	n number eka parsarg Ena 
*kotupAti	n number eka parsarg pAti 
*kotulAMti/kotulAti	n number eka parsarg lAMti 
*kotugAnI/kotukAnI	n number eka parsarg gAni 
*kotugA	n number eka parsarg gA 
*kotlu/kotulu	n number bahu parsarg 0 
*kotlU/kotullArA/kotlulArA	n number bahu parsarg I 
-	n number bahu parsarg gA 
*kotlagAdu/kotulagAdu	n number bahu parsarg gAdu 
*kotlagawweV/kotulagawweV	n number bahu parsarg gawweV 
*kotlavAdu/kotlodu	n number bahu parsarg vAdu 
*kotlAyana/kotulAyana	n number bahu parsarg Ayana 
*kotlavAru/kotloru	n number bahu parsarg vAru 
kotlaxi/*kotulaxi	n number bahu parsarg xi 
kotlavi/*kotulavi	n number bahu parsarg vi 
kotlagAru/*kotulagAru	n number bahu parsarg gAru 
*kotulaM/kotlaM/kotulamu/kotlamu	n number bahu parsarg nu 
*kotlu/kotulu	n number bahu parsarg vu 
kotlayoVkka/*kotulayoVkka	n number bahu parsarg yoVkka 
kotla/*kotula	n number bahu parsarg obl 
kotlani/kotulni/kotlanu/*kotulanu	n number bahu parsarg ni 
*kotlaki/kotlaku	n number bahu parsarg ki 
*kotlawo/kotulwo/kotlawoda/kotlawoti/kotulwoti/kotulwoda	n number bahu parsarg wo 
kotlalo/kotullo/*kotullopala	n number bahu parsarg lo 
*kotlaloni/kotlalopali/kotlayaMxali/kotlalopali	n number bahu parsarg loni 
*kotlamIxa/kotlamIxana	n number bahu parsarg mIxa 
*kotlana/kotlana	n number bahu parsarg na 
kotlaniMci/kotlanuMci/kotlanuMdi/*kotulanuMdi	n number bahu parsarg niMci 
kotlaxvArA/kotlaxvAra/kotulxvArA/*kotulaxvArA	n number bahu parsarg xvArA 
kotlavalana/kotlavalla/kotulavalla/*kotulavalana	n number bahu parsarg valana 
*kotlanubatti/kotlanibatti	n number bahu parsarg batti 
kotlacewa/kotlace/kotulace/*kotulacewa	n number bahu parsarg ce 
*kotlawopAtu/kotlawobAtu/kotulwopAtu/*kotulawopAtu	n number bahu parsarg wopAtu 
kotlawokUdi/kotulawogudA/kotulwogUdA/kotlawogUdi/*kotulawokUdA/kotulwokUdA/kotlawogUdA	n number bahu parsarg wokUdi 
*kotlakosaM/kotlakE/kotlArWaM	n number bahu parsarg kosaM 
*kotlakoVraku/kotlakoVrYaku	n number bahu parsarg koVraku 
kotlalonuMdi/kotlalonuMci/kotlaloniMci/kotullonuMci/*kotullonuMdi	n number bahu parsarg lonuMdi 
*kotlamIxanuMdi/kotlamIxanuMci/kotlamIxaniMci	n number bahu parsarg mIxanuMdi 
*kotlaxAkA/kotlaxAka	n number bahu parsarg xAkA 
*kotlavaraku	n number bahu parsarg varaku 
*kotlamIxaki/kotlamIxaku/kotlamIxiki	n number bahu parsarg mIxaki 
*kotlaxaggara/kotlaxaggira	n number bahu parsarg xaggara 
*kotlavaxxa/kotloVxxa	n number bahu parsarg vaxxa 
*kotlakAda/kotulakAda	n number bahu parsarg kAda 
kotleVxurugA/*kotlakeVxurugA/kotuleVxurugA	n number bahu parsarg keVxurugA 
*kotlamuMxu	n number bahu parsarg muMxu 
*kotlaguriMci/kotlagUrci/kotulniguriMci/kotlanigUrci	n number bahu parsarg guriMci 
kotlapE/kotlapEni/kotlapEna/kotulapE/*kotulapEna/kotulapEni	n number bahu parsarg pE 
kotlapEki/*kotulapEki	n number bahu parsarg pEki 
*kotlaguMdA	n number bahu parsarg guMdA 
kotlalA/kotullA/kotlalAgA/*kotullAgA/kotlalAga	n number bahu parsarg lA 
*kotlavaleV/kotulavaleV/kotlamAxiri/kotulnipolina/kotulnibolina	n number bahu parsarg vale 
*kotlakumalle/kotulakumalle/kotlakumalleV/kotulakumalleV	n number bahu parsarg kimalle 
kotlukUdA/kotlugUdA/*kotulugUdA/kotulnigUdA	n number bahu parsarg kUdA 
*kotlaxqRtilo/kotlaxruRtilo	n number bahu parsarg xqRtilo 
*kotlulekuMdA/kotluleka/kotullekuMdA	n number bahu parsarg lekuMdA 
*kotlukAkuMdA/kotlukAka/kotlugAka/kotlugAkuMdA	n number bahu parsarg kAkuMdA 
*kotlumoVxalukoVni/kotlanumoVxalukoVni	n number bahu parsarg moVxalukoVni 
kotlavEpu/kotlavepu/kotlakesi/kotulavepu/*kotulavEpu/kotulakesi	n number bahu parsarg vEpu 
kotlapakka/kotlapakkana/*kotlaprakka/kotlaprakkana/kotulapakkana	n number bahu parsarg pakka 
kotlapakkalo/*kotlaprakkalo	n number bahu parsarg pakkalo 
kotlaloki/kotulloki/kotlaloniki/kotulloniki/kotlalopalaki/*kotlalopaliki/kotullopaliki/kotlalopalaku/kotullopalaku	n number bahu parsarg lopalaki 
kotlakiMxa/*kotlakriMxa/kotulakiMxa/kotlakriMxana/kotlakiMxana	n number bahu parsarg kiMxa 
kotladuguna/*kotlakaduguna	n number bahu parsarg aduguna 
kotlakeVlla/*kotlakalla	n number bahu parsarg kalla 
kotlaveVnuka/kotlaveVnaka/*kotlaveVnakAla/kotlaveVnukAla/kotlaveVnakAwala/kotlaveVnukAwala	n number bahu parsarg veVnuka 
*kotlawaravAwa/kotlawarvAwa/kotulawaravAwa	n number bahu parsarg waravAwa 
kotleVxuruguMdA/*kotlakeVxuruguMdA	n number bahu parsarg eVxuruguMdA 
*kotlamaXya/kotlamaXyana/kotlamaXyalo	n number bahu parsarg maXya 
*kotlanaduma/kotlakinaduma	n number bahu parsarg naduma 
kotlabaxulugA/kotlakibaxulugA/kotlabaxulu/*kotlakibaxulu	n number bahu parsarg baxulugA 
*kotlacotlo/kotlacotulo	n number bahu parsarg cotlo 
kotlasWAnaMlo/kotlaswAnaMlo/*kotlasWAnamulo	n number bahu parsarg sWAnaMlo 
kotlanerugA/kotlakunerugA/*kotlakinerugA	n number bahu parsarg nerugA 
*kotlaprakAraM/kotlanubatti/kotlabatti/kotlanibatti/kotulnibatti	n number bahu parsarg prakAraM 
*kotlaxaggaranuMdi/kotlaxaggiranuMdi/kotlaxaggaranuMci/kotlaxaggiranuMci	n number bahu parsarg xaggaranuMdi 
*kotlavaxxanuMdi/kotlavaxxanuMci	n number bahu parsarg vaxxanuMdi 
*kotlapakkanuMdi/kotlapakkanuMci/kotlapakkalonuMdi/kotlapakkalonuMci	n number bahu parsarg pakkanuMdi 
*kotlalopalanuMdi/kotulalopalanuMdi/kotlalopalanuMci/kotulalopalanuMci/kotlalopalinuMdi/kotlalopalinuMci	n number bahu parsarg lopalanuMdi 
*kotlabEtanuMdi/kotlabEtanuMci/kotlabEtaniMci	n number bahu parsarg bEtanuMdi 
*kotlapEnuMdi/kotlapEnuMci/kotlapEniMci	n number bahu parsarg pEnuMdi 
kotlakiMxanuMdi/kotlakiMxanuMci/kotlakiMxaniMci/*kotlakriMxanuMdi/kotlakriMxanuMci/kotlakriMxaniMci	n number bahu parsarg kriMxanuMdi 
*kotladugunuMdi/kotladugunuMci/kotladuguniMci	n number bahu parsarg adugunuMdi 
*kotlamuMxunuMdi/kotlamuMxunuMci/kotlamuMxuniMci	n number bahu parsarg muMxunuMdi 
kotlaveVnukanuMdi/kotlaveVnakanuMdi/*kotlaveVnakAlanuMdi/kotlaveVnakAlanuMci/kotlaveVnukanuMci/kotlaveVnakanuMci/kotlaveVnakAwalanuMdi/kotlaveVnakAwalanuMci	n number bahu parsarg veVnukanuMdi 
kotleVxutinuMdi/kotlakeVxutinuMdi/kotleVxutanuMdi/*kotlakeVxutanuMdi/kotleVxutinuMci/kotlakeVxutinuMci/kotleVxutanuMci/kotlakeVxutanuMci	n number bahu parsarg eVxutinuMdi 
*kotlamaXyanuMdi/kotlamaXyanuMci/kotlamaXyaniMci/kotlamaXyalonuMdi/kotlamaXyalonuMci/kotlamaXyaloniMci	n number bahu parsarg maXyanuMdi 
*kotlanadumanuMdi/kotlanadamanuMdi/kotlanadumanuMci/kotlanadamanuMci	n number bahu parsarg nadumanuMdi 
*kotlawaravAwanuMdi/kotlawarvAwanuMdi/kotlawaravAwanuMci/kotlawarvAwanuMci	n number bahu parsarg waravAwanuMdi 
*kotlacotlonuMdi/kotlacotunuMdi/kotlacotlonuMci/kotlacotloniMci/kotlacotunuMci/kotlacotuniMci	n number bahu parsarg cotlonuMdi 
*kotlasWAnamunuMdi/kotlasWAnaMnuMdi/kotlasWAnamunuMci/kotlasWAnaMnuMci/kotlasWAnaMlonuMdi/kotlasWAnamulonuMdi/kotlasWAnaMlonuMci/kotlasWAnamulonuMci	n number bahu parsarg sWAnaMnuMdi 
*kotlayaMxu/kotlaMxu/kotulaMxu	n number bahu parsarg aMxu 
*kotlaMte/kotlaMteV/kotulaMte/kotulaMteV	n number bahu parsarg aMte 
*kotlakaMteV/kotlakaMte/kotlakanna/kotlakannA/kotulakannA	n number bahu parsarg kaMteV 
*kotlEna	n number bahu parsarg Ena 
*kotlupAti	n number bahu parsarg pAti 
*kotlulAMti/kotlulAti	n number bahu parsarg lAMti 
*kotlugAnI/kotlukAnI	n number bahu parsarg gAni 
*kotlugA	n number bahu parsarg gA 
