noun	
kalcar	
kalcar/*kalcaru	n number eka parsarg 0 
-	n number eka parsarg I 
-	n number eka parsarg gA 
kalcargAdu/*kalcarugAdu	n number eka parsarg gAdu 
kalcargawweV/*kalcarugawweV	n number eka parsarg gawweV 
kalcarvAdu/*kalcaruvAdu	n number eka parsarg vAdu 
kalcarAyana/*kalcarAyana	n number eka parsarg Ayana 
kalcarvAru/*kalcaruvAru	n number eka parsarg vAru 
kalcarxi/*kalcaruxi	n number eka parsarg xi 
kalcarvi/*kalcaruvi	n number eka parsarg vi 
kalcargAru/*kalcarugAru	n number eka parsarg gAru 
kalcarnu/*kalcarunu	n number eka parsarg nu 
kalcarvu/*kalcaruvu	n number eka parsarg vu 
kalcaryoVkka/*kalcaruyoVkka	n number eka parsarg yoVkka 
kalcar/*kalcaru	n number eka parsarg obl 
kalcarni/kalcarnu/*kalcaruni/kalcarunu	n number eka parsarg ni 
kalcarki/kalcarku/kalcarnaku/*kalcaruki/kalcaruku/kalcarunaku	n number eka parsarg ki 
kalcarwo/kalcarwoda/kalcarwoti/*kalcaruwo/kalcaruwoda/kalcaruwoti	n number eka parsarg wo 
kalcarlo/kalcarlona/kalcarlopala/*kalcarulo/kalcarulona/kalcarulopala	n number eka parsarg lo 
kalcarloni/kalcarlopali/*kalcaruloni/kalcarulopali	n number eka parsarg loni 
kalcarmIxa/*kalcarumIxa	n number eka parsarg mIxa 
kalcarna/*kalcaruna	n number eka parsarg na 
kalcarniMci/kalcarnuMci/kalcarnuMdi/kalcaruniMci/kalcarunuMci/*kalcarunuMdi	n number eka parsarg niMci 
kalcarxvArA/kalcarxvAra/*kalcaruxvArA/kalcaruxvAra	n number eka parsarg xvArA 
kalcarvalana/kalcarvalla/*kalcaruvalana/kalcaruvalla	n number eka parsarg valana 
*kalcarnubatti/kalcarnibatti/kalcarunubatti/kalcarunibatti	n number eka parsarg batti 
kalcarce/kalcarcewa/kalcaruce/*kalcarucewa	n number eka parsarg ce 
kalcarwopAtu/*kalcaruwopAtu	n number eka parsarg wopAtu 
kalcarwokUdi/kalcarwokUda/kalcarwokUdA/kalcarwogUdi/kalcarwogUda/kalcarwogUdA/*kalcaruwokUdi/kalcaruwokUda/kalcaruwokUdA/kalcaruwogUdi/kalcaruwogUda/kalcaruwogUdA	n number eka parsarg wokUdi 
kalcarkosaM/kalcarkE/kalcarnakE/kalcarArWaM/*kalcarukosaM/kalcarukE/kalcarunakE/kalcarArWaM	n number eka parsarg kosaM 
kalcarkoVraku/kalcarkoVrYaku/*kalcarukoVraku/kalcarukoVrYaku	n number eka parsarg koVraku 
kalcarlonuMdi/kalcarlonuMci/*kalcarulonuMdi/kalcarulonuMci	n number eka parsarg lonuMdi 
kalcarmIxanuMdi/kalcarmIxanuMci/*kalcarumIxanuMdi/kalcarumIxanuMci	n number eka parsarg mIxanuMdi 
kalcarxAkA/kalcarxAka/*kalcaruxAkA/kalcaruxAka	n number eka parsarg xAkA 
kalcarvaraku/*kalcaruvaraku	n number eka parsarg varaku 
kalcarmIxaki/kalcarmIxaku/*kalcarumIxaki/kalcarumIxaku	n number eka parsarg mIxaki 
kalcarxaggara/kalcarxaggira/*kalcaruxaggara/kalcaruxaggira	n number eka parsarg xaggara 
kalcarvaxxa/kalcaryoVxxa/*kalcaruvaxxa/kalcaruyoVxxa	n number eka parsarg vaxxa 
kalcarkAda/*kalcarukAda	n number eka parsarg kAda 
kalcarkeVxurugA/kalcareVxurugA/*kalcarukeVxurugA/kalcareVxurugA	n number eka parsarg keVxurugA 
kalcarmuMxu/*kalcarumuMxu	n number eka parsarg muMxu 
kalcarguriMci/kalcarniguriMci/*kalcaruguriMci/kalcaruniguriMci	n number eka parsarg guriMci 
kalcarpE/kalcarpEna/kalcarpEni/kalcarupE/*kalcarupEna/kalcarupEni	n number eka parsarg pE 
kalcarpEki/*kalcarupEki	n number eka parsarg pEki 
kalcarguMdA/*kalcaruguMdA	n number eka parsarg guMdA 
kalcarlA/kalcarlAga/kalcarlAgA/kalcarulA/kalcarulAga/*kalcarulAgA	n number eka parsarg lA 
kalcarvale/kalcarmAxiri/kalcarnipolina/kalcarvaleV/kalcarnibolina/*kalcaruvale/kalcarumAxiri/kalcarunipolina/kalcaruvaleV/kalcarunibolina	n number eka parsarg vale 
kalcarkimalle/kalcarkumalle/kalcarmalle/kalcarukimalle/*kalcarukumalle/kalcarumalle	n number eka parsarg kimalle 
kalcarkUdA/kalcarnikUdA/kalcargUdA/kalcarnigUdA/*kalcarukUdA/kalcarunikUdA/kalcarugUdA/kalcarunigUdA	n number eka parsarg kUdA 
kalcarxqRtilo/kalcarxruRtilo/*kalcaruxqRtilo/kalcaruxruRtilo	n number eka parsarg xqRtilo 
kalcarlekuMdA/kalcarnilekuMdA/*kalcarulekuMdA/kalcarunilekuMdA	n number eka parsarg lekuMdA 
kalcarkAkuMdA/kalcarnikAkuMdA/*kalcarukAkuMdA/kalcarunikAkuMdA	n number eka parsarg kAkuMdA 
kalcarmoVxalukoVni/kalcarnimoVxalukoVni/*kalcarumoVxalukoVni/kalcarunimoVxalukoVni	n number eka parsarg moVxalukoVni 
kalcarvEpu/kalcarvepu/kalcarkesi/*kalcaruvEpu/kalcaruvepu/kalcarukesi	n number eka parsarg vEpu 
kalcarpakka/kalcarprakka/kalcarpakkana/kalcarupakka/*kalcaruprakka/kalcarupakkana	n number eka parsarg pakka 
kalcarpakkalo/kalcarprakkalo/kalcarupakkalo/*kalcaruprakkalo	n number eka parsarg pakkalo 
kalcarloki/kalcarloniki/kalcarlopalaki/kalcarlopaliki/kalcarlopalaku/*kalcaruloki/kalcaruloniki/kalcarulopalaki/kalcarulopaliki/kalcarulopalaku	n number eka parsarg lopalaki 
kalcarkiMxa/kalcarkriMxa/kalcarkriMxana/kalcarkiMxana/kalcarukiMxa/*kalcarukriMxa/kalcarukriMxana/kalcarukiMxana	n number eka parsarg kiMxa 
kalcaraduguna/kalcarkaduguna/kalcaraduguna/*kalcarukaduguna	n number eka parsarg aduguna 
kalcarkeVlla/kalcarkalla/kalcarukeVlla/*kalcarukalla	n number eka parsarg kalla 
kalcarveVnuka/kalcarveVnakAla/kalcarveVnakAwala/kalcaruveVnuka/*kalcaruveVnakAla/kalcaruveVnakAwala	n number eka parsarg veVnuka 
kalcarwaravAwa/kalcarwarvAwa/kalcarwaruvAwa/kalcaruwaravAwa/kalcaruwarvAwa/*kalcaruwaruvAwa	n number eka parsarg waravAwa 
kalcareVxuruguMdA/kalcarkeVxuruguMdA/kalcareVxuruguMdA/*kalcarukeVxuruguMdA	n number eka parsarg eVxuruguMdA 
kalcarmaXya/kalcarmaXyalo/kalcarmaXyana/*kalcarumaXya/kalcarumaXyalo/kalcarumaXyana	n number eka parsarg maXya 
kalcarnaduma/kalcarnadama/*kalcarunaduma/kalcarunadama	n number eka parsarg naduma 
kalcarbaxulugA/kalcarbaxulu/kalcarkibaxulu/kalcarnibaxulu/kalcarubaxulugA/kalcarubaxulu/*kalcarukibaxulu/kalcarunibaxulu	n number eka parsarg baxulugA 
kalcarcotlo/kalcarcotulo/kalcarcotuna/*kalcarucotlo/kalcarucotulo/kalcarucotuna	n number eka parsarg cotlo 
kalcarsWAnaMlo/kalcarsWAnamulo/kalcarusWAnaMlo/*kalcarusWAnamulo	n number eka parsarg sWAnaMlo 
kalcarnerugA/kalcarkunerugA/kalcarkinerugA/kalcarunerugA/kalcarukunerugA/*kalcarukinerugA	n number eka parsarg nerugA 
kalcarprakAraM/kalcarprakAramu/*kalcaruprakAraM/kalcaruprakAramu	n number eka parsarg prakAraM 
kalcarxaggaranuMdi/kalcarxaggaranuMci/kalcarxaggiranuMdi/kalcarxaggaraniMci/*kalcaruxaggaranuMdi/kalcaruxaggaranuMci/kalcaruxaggiranuMdi/kalcaruxaggaraniMci	n number eka parsarg xaggaranuMdi 
kalcarvaxxanuMdi/kalcarvaxxanuMci/*kalcaruvaxxanuMdi/kalcaruvaxxanuMci	n number eka parsarg vaxxanuMdi 
kalcarpakkanuMdi/kalcarpakkanuMci/*kalcarupakkanuMdi/kalcarupakkanuMci/kalcarpakkalonuMdi/kalcarpakkalonuMci/kalcarupakkalonuMdi/kalcarupakkalonuMci	n number eka parsarg pakkanuMdi 
kalcarlopalanuMdi/kalcarlopalinuMdi/kalcarlopalanuMci/*kalcarulopalanuMdi/kalcarulopalinuMdi/kalcarulopalanuMci	n number eka parsarg lopalanuMdi 
kalcarbEtanuMdi/kalcarbEtanuMci/*kalcarubEtanuMdi/kalcarubEtanuMci	n number eka parsarg bEtanuMdi 
kalcarpEnuMdi/kalcarpEnuMci/*kalcarupEnuMdi/kalcarupEnuMci	n number eka parsarg pEnuMdi 
kalcarkiMxanuMdi/kalcarkiMxanuMci/kalcarukiMxanuMdi/kalcarukiMxanuMci/*kalcarkriMxanuMdi/kalcarkriMxanuMci/kalcarukriMxanuMdi/kalcarukriMxanuMci	n number eka parsarg kriMxanuMdi 
kalcaraduguniMci/kalcaradugunuMdi/kalcarkadugunuMdi/kalcarkadugunuMci/kalcaraduguniMci/kalcaradugunuMdi/*kalcarukadugunuMdi/kalcarukadugunuMci	n number eka parsarg adugunuMdi 
kalcarkimuMxunuMdi/kalcarmuMxunuMci/*kalcarukimuMxunuMdi/kalcarumuMxunuMci	n number eka parsarg muMxunuMdi 
kalcarveVnakanuMdi/kalcarveVnukanuMci/kalcarveVnakAwalanuMdi/kalcarveVnakAwalanuMci/kalcaruveVnakanuMdi/kalcaruveVnukanuMci/kalcaruveVnakAwalanuMdi/kalcaruveVnakAwalanuMci/kalcarveVnakanuMci/kalcarveVnukanuMci/kalcarveVnakAlanuMdi/kalcarveVnakAlanuMci/kalcarveVnakAwalanuMdi/kalcaruveVnakanuMci/kalcaruveVnukanuMci/*kalcaruveVnakAlanuMdi/kalcaruveVnakAlanuMci/kalcaruveVnakAwalanuMdi	n number eka parsarg veVnukanuMdi 
kalcareVxutinuMdi/kalcareVxutanuMci/kalcarkeVxutinuMci/kalcarkeVxutanuMdi/kalcareVxutinuMdi/kalcareVxutanuMci/kalcarukeVxutinuMci/*kalcarukeVxutanuMdi	n number eka parsarg eVxutinuMdi 
kalcarmaXyanuMdi/kalcarmaXyanuMci/*kalcarumaXyanuMdi/kalcarumaXyanuMci/kalcarmaXyalonuMdi/kalcarmaXyalonuMci/kalcarumaXyalonuMdi/kalcarumaXyalonuMci	n number eka parsarg maXyanuMdi 
kalcarnadumanuMdi/kalcarnadumanuMci/*kalcarunadumanuMdi/kalcarunadumanuMci	n number eka parsarg nadumanuMdi 
kalcarwaravAwanuMdi/kalcarwarvAwanuMdi/kalcarwaravAwanuMci/kalcarwarvAwanuMci/*kalcaruwaravAwanuMdi/kalcaruwarvAwanuMdi/kalcaruwaravAwanuMci/kalcaruwarvAwanuMci	n number eka parsarg waravAwanuMdi 
kalcarcotlonuMdi/kalcarcotunuMdi/kalcarcotlonuMci/kalcarcotunuMci/*kalcarucotlonuMdi/kalcarucotunuMdi/kalcarucotlonuMci/kalcarucotunuMci	n number eka parsarg cotlonuMdi 
kalcarsWAnaMnuMdi/kalcarsWAnamunuMdi/kalcarsWAnaMnuMci/kalcarsWAnamunuMci/kalcarusWAnaMnuMdi/*kalcarusWAnamunuMdi/kalcarusWAnaMnuMci/kalcarusWAnamunuMci/kalcarsWAnaMlonuMdi/kalcarsWAnamulonuMdi/kalcarusWAnaMlonuMdi/kalcarusWAnamulonuMdi/kalcarsWAnaMlonuMci/kalcarsWAnamulonuMci/kalcarusWAnaMlonuMci/kalcarusWAnamulonuMci	n number eka parsarg sWAnaMnuMdi 
kalcaraMxu/kalcarnaMxu/kalcaryaMxu/kalcaraMxu/kalcarunaMxu/*kalcaruyaMxu	n number eka parsarg aMxu 
*kalcaraMte/kalcaraMteV/kalcaraMte/kalcaraMteV	n number eka parsarg aMte 
kalcarkaMteV/kalcarkaMte/kalcarkanna/kalcarkannA/*kalcarukaMteV/kalcarukaMte/kalcarukanna/kalcarukannA	n number eka parsarg kaMteV 
*kalcarEna/kalcarEna	n number eka parsarg Ena 
kalcarpAti/*kalcarupAti	n number eka parsarg pAti 
kalcarlAMti/kalcarlAti/*kalcarulAMti/kalcarulAti	n number eka parsarg lAMti 
kalcargAnI/kalcarkAnI/*kalcarugAnI/kalcarukAnI	n number eka parsarg gAni 
kalcargA/*kalcarugA	n number eka parsarg gA 
kalcarlu/*kalcarulu	n number bahu parsarg 0 
*kalcarlU/kalcarlArA/kalcarulU/kalcarulArA	n number bahu parsarg I 
-	n number bahu parsarg gA 
*kalcarlagAdu/kalcarulagAdu	n number bahu parsarg gAdu 
*kalcarlagawweV/kalcarulagawweV	n number bahu parsarg gawweV 
*kalcarlavAdu/kalcarulavAdu	n number bahu parsarg vAdu 
*kalcarlAyana/kalcarulAyana	n number bahu parsarg Ayana 
*kalcarlavAru/kalcarulavAru	n number bahu parsarg vAru 
*kalcarlaxi/kalcarlxi/kalcarulaxi/kalcarulxi	n number bahu parsarg xi 
*kalcarlavi/kalcarliy/kalcarulavi/kalcaruliy	n number bahu parsarg vi 
*kalcarlagAru/kalcarulagAru	n number bahu parsarg gAru 
kalcarlamu/*kalcarlaM/kalcarulamu/kalcarulaM	n number bahu parsarg nu 
*kalcarlu/kalcarulu	n number bahu parsarg vu 
*kalcarlayoVkka/kalcarulayoVkka	n number bahu parsarg yoVkka 
*kalcarla/kalcarula	n number bahu parsarg obl 
*kalcarlani/kalcarlanu/kalcarlni/kalcarulani/kalcarulanu/kalcarulni	n number bahu parsarg ni 
*kalcarlaki/kalcarlaku/kalcarulaki/kalcarulaku	n number bahu parsarg ki 
*kalcarlawo/kalcarlawoda/kalcarlawoti/kalcarulawo/kalcarulawoda/kalcarulawoti	n number bahu parsarg wo 
*kalcarlalo/kalcarlalona/kalcarlalopala/kalcarulalo/kalcarulalona/kalcarulalopala	n number bahu parsarg lo 
*kalcarlaloni/kalcarlalopali/kalcarlayaMxali/kalcarulaloni/kalcarulalopali/kalcarulayaMxali	n number bahu parsarg loni 
*kalcarlamIxa/kalcarulamIxa	n number bahu parsarg mIxa 
*kalcarlana/kalcarulana	n number bahu parsarg na 
kalcarlaniMci/kalcarlanuMci/*kalcarlanuMdi/kalcarulaniMci/kalcarulanuMci/kalcarulanuMdi	n number bahu parsarg niMci 
*kalcarlaxvArA/kalcarulaxvArA	n number bahu parsarg xvArA 
*kalcarlavalana/kalcarlavalla/kalcarulavalana/kalcarulavalla	n number bahu parsarg valana 
*kalcarlacewa/kalcarlace/kalcarulacewa/kalcarulace	n number bahu parsarg batti 
*kalcarlawopAtu/kalcarulawopAtu	n number bahu parsarg ce 
*kalcarlawokUdi/kalcarlawokUda/kalcarlawokUdA/kalcarlawogUdi/kalcarlawogUda/kalcarlawogUdA/kalcarulawokUdi/kalcarulawokUda/kalcarulawokUdA/kalcarulawogUdi/kalcarulawogUda/kalcarulawogUdA	n number bahu parsarg wopAtu 
*kalcarlakosaM/kalcarlakE/kalcarlArWaM/kalcarulakosaM/kalcarulakE/kalcarulArWaM	n number bahu parsarg wokUdi 
*kalcarlakoVraku/kalcarlakoVrYaku/kalcarulakoVraku/kalcarulakoVrYaku	n number bahu parsarg kosaM 
*kalcarlalonuMdi/kalcarlalonuMci/kalcarlaloniMci/kalcarllonuMdi/kalcarllonuMci/kalcarlloniMci/kalcarulalonuMdi/kalcarulalonuMci/kalcarulaloniMci/kalcarullonuMdi/kalcarullonuMci/kalcarulloniMci	n number bahu parsarg koVraku 
kalcarlamIxaniMci/*kalcarlamIxanuMdi/kalcarlamIxanuMci/kalcarulamIxaniMci/kalcarulamIxanuMdi/kalcarulamIxanuMci	n number bahu parsarg lonuMdi 
*kalcarlaxAkA/kalcarulaxAkA	n number bahu parsarg mIxanuMdi 
*kalcarlavaraku/kalcarulavaraku	n number bahu parsarg xAkA 
*kalcarlamIxaki/kalcarlamIxaku/kalcarulamIxaki/kalcarulamIxaku	n number bahu parsarg varaku 
*kalcarlaxaggara/kalcarlaxaggira/kalcarulaxaggara/kalcarulaxaggira	n number bahu parsarg mIxaki 
*kalcarlavaxxa/kalcarlayoVxxa/kalcarulavaxxa/kalcarulayoVxxa	n number bahu parsarg xaggara 
*kalcarlakAda/kalcarulakAda	n number bahu parsarg vaxxa 
*kalcarlakeVxurugA/kalcarleVxurugA/kalcarulakeVxurugA/kalcaruleVxurugA	n number bahu parsarg kAda 
*kalcarlamuMxu/kalcarlakumuMxu/kalcarulamuMxu/kalcarulakumuMxu	n number bahu parsarg keVxurugA 
*kalcarlaguriMci/kalcarlagUrci/kalcarlanuguriMci/kalcarlanugUrci/kalcarulaguriMci/kalcarulagUrci/kalcarulanuguriMci/kalcarulanugUrci	n number bahu parsarg muMxu 
kalcarlapE/*kalcarlapEna/kalcarulapE/kalcarulapEna	n number bahu parsarg guriMci 
*kalcarlapEki/kalcarulapEki	n number bahu parsarg pE 
*kalcarlaguMdA/kalcarulaguMdA	n number bahu parsarg pEki 
kalcarlalA/kalcarlalAga/*kalcarlalAgA/kalcarulalA/kalcarulalAga/kalcarulalAgA	n number bahu parsarg guMdA 
kalcarlavale/*kalcarlavaleV/kalcarlamAxiri/kalcarlapolina/kalcarlabolina/kalcarlanupolina/kalcarlanubolina/kalcarulavale/kalcarulavaleV/kalcarulamAxiri/kalcarulapolina/kalcarulabolina/kalcarulanupolina/kalcarulanubolina	n number bahu parsarg lA 
kalcarlakumalle/*kalcarlakumalleV/kalcarulakumalle/kalcarulakumalleV	n number bahu parsarg vale 
*kalcarlukUdA/kalcarlukUda/kalcarlugUdA/kalcarlugUda/kalcarulukUdA/kalcarulukUda/kalcarulugUdA/kalcarulugUda	n number bahu parsarg kimalle 
*kalcarlaxqRtilo/kalcarlaxruRtilo/kalcarulaxqRtilo/kalcarulaxruRtilo	n number bahu parsarg kUdA 
*kalcarlulekuMdA/kalcarlulekuMda/kalcarululekuMdA/kalcarululekuMda	n number bahu parsarg xqRtilo 
*kalcarlukAkuMdA/kalcarlukAkuMda/kalcarlugAkuMdA/kalcarulukAkuMdA/kalcarulukAkuMda/kalcarulugAkuMdA	n number bahu parsarg lekuMdA 
*kalcarlumoVxalukoVni/kalcarlanumoVxalukoVni/kalcarulumoVxalukoVni/kalcarulanumoVxalukoVni	n number bahu parsarg kAkuMdA 
*kalcarlavEpu/kalcarlavepu/kalcarlakesi/kalcarulavEpu/kalcarulavepu/kalcarulakesi	n number bahu parsarg moVxalukoVni 
kalcarlapakka/kalcarlapakkana/*kalcarlaprakka/kalcarlaprakkana/kalcarulapakka/kalcarulapakkana/kalcarulaprakka/kalcarulaprakkana	n number bahu parsarg vEpu 
*kalcarlapakkalo/kalcarulapakkalo	n number bahu parsarg pakka 
kalcarlaloniki/*kalcarlaloki/kalcarlalopalaki/kalcarlalopaliki/kalcarlalopalaku/kalcarulaloniki/kalcarulaloki/kalcarulalopalaki/kalcarulalopaliki/kalcarulalopalaku	n number bahu parsarg pakkalo 
kalcarlakiMxa/*kalcarlakriMxa/kalcarlakriMxana/kalcarlakiMxana/kalcarulakiMxa/kalcarulakriMxa/kalcarulakriMxana/kalcarulakiMxana	n number bahu parsarg lopalaki 
kalcarladuguna/*kalcarlakaduguna/kalcaruladuguna/kalcarulakaduguna	n number bahu parsarg kiMxa 
kalcarlakeVlla/*kalcarlakalla/kalcarulakeVlla/kalcarulakalla	n number bahu parsarg aduguna 
kalcarlaveVnuka/kalcarlaveVnaka/*kalcarlaveVnakAla/kalcarlaveVnukAla/kalcarlaveVnakAwala/kalcarlaveVnukAwala/kalcarulaveVnuka/kalcarulaveVnaka/kalcarulaveVnakAla/kalcarulaveVnukAla/kalcarulaveVnakAwala/kalcarulaveVnukAwala	n number bahu parsarg kalla 
kalcarlawaravAwa/kalcarlawarvAwa/*kalcarlawaruvAwa/kalcarulawaravAwa/kalcarulawarvAwa/kalcarulawaruvAwa	n number bahu parsarg veVnuka 
kalcarleVxuruguMdA/*kalcarlakeVxuruguMdA/kalcaruleVxuruguMdA/kalcarulakeVxuruguMdA	n number bahu parsarg waravAwa 
*kalcarlamaXya/kalcarlamaXyana/kalcarlamaXyalo/kalcarulamaXya/kalcarulamaXyana/kalcarulamaXyalo	n number bahu parsarg eVxuruguMdA 
*kalcarlanaduma/kalcarlakinaduma/kalcarulanaduma/kalcarulakinaduma	n number bahu parsarg maXya 
kalcarlabaxulugA/kalcarlakibaxulugA/kalcarlabaxulu/*kalcarlakibaxulu/kalcarulabaxulugA/kalcarulakibaxulugA/kalcarulabaxulu/kalcarulakibaxulu	n number bahu parsarg naduma 
*kalcarlacotlo/kalcarlacotulo/kalcarulacotlo/kalcarulacotulo	n number bahu parsarg baxulugA 
kalcarlasWAnaMlo/kalcarlaswAnaMlo/*kalcarlasWAnamulo/kalcarulasWAnaMlo/kalcarulaswAnaMlo/kalcarulasWAnamulo	n number bahu parsarg cotlo 
kalcarlanerugA/kalcarlakunerugA/*kalcarlakinerugA/kalcarulanerugA/kalcarulakunerugA/kalcarulakinerugA	n number bahu parsarg sWAnaMlo 
*kalcarlaprakAraM/kalcarlanubatti/kalcarlabatti/kalcarlanibatti/kalcarulaprakAraM/kalcarulanubatti/kalcarulabatti/kalcarulanibatti	n number bahu parsarg nerugA 
*kalcarlaxaggaranuMdi/kalcarlaxaggiranuMdi/kalcarlaxaggaranuMci/kalcarlaxaggiranuMci/kalcarulaxaggaranuMdi/kalcarulaxaggiranuMdi/kalcarulaxaggaranuMci/kalcarulaxaggiranuMci	n number bahu parsarg prakAraM 
*kalcarlavaxxanuMdi/kalcarlavaxxanuMci/kalcarulavaxxanuMdi/kalcarulavaxxanuMci	n number bahu parsarg xaggaranuMdi 
*kalcarlapakkanuMdi/kalcarlapakkanuMci/kalcarulapakkanuMdi/kalcarulapakkanuMci/kalcarlapakkalonuMdi/kalcarlapakkalonuMci/kalcarulapakkalonuMdi/kalcarulapakkalonuMci	n number bahu parsarg vaxxanuMdi 
*kalcarlalopalanuMdi/kalcarlalopalanuMci/kalcarlalopalaniMci/kalcarulalopalanuMdi/kalcarulalopalanuMci/kalcarulalopalaniMci	n number bahu parsarg pakkanuMdi 
*kalcarlabEtanuMdi/kalcarlabEtanuMci/kalcarlabEtaniMci/kalcarulabEtanuMdi/kalcarulabEtanuMci/kalcarulabEtaniMci	n number bahu parsarg lopalanuMdi 
*kalcarlapEnuMdi/kalcarlapEnuMci/kalcarlapEniMci/kalcarulapEnuMdi/kalcarulapEnuMci/kalcarulapEniMci	n number bahu parsarg bEtanuMdi 
kalcarlakiMxanuMdi/kalcarlakiMxanuMci/kalcarlakiMxaniMci/kalcarulakiMxanuMdi/kalcarulakiMxanuMci/kalcarulakiMxaniMci/*kalcarlakriMxanuMdi/kalcarlakriMxanuMci/kalcarlakriMxaniMci/kalcarulakriMxanuMdi/kalcarulakriMxanuMci/kalcarulakriMxaniMci	n number bahu parsarg pEnuMdi 
*kalcarladugunuMdi/kalcarladugunuMci/kalcarladuguniMci/kalcaruladugunuMdi/kalcaruladugunuMci/kalcaruladuguniMci	n number bahu parsarg kriMxanuMdi 
*kalcarlamuMxunuMdi/kalcarlamuMxunuMci/kalcarlamuMxuniMci/kalcarulamuMxunuMdi/kalcarulamuMxunuMci/kalcarulamuMxuniMci	n number bahu parsarg adugunuMdi 
kalcarlaveVnukanuMdi/kalcarlaveVnakanuMdi/*kalcarlaveVnakAlanuMdi/kalcarulaveVnukanuMdi/kalcarulaveVnakanuMdi/kalcarulaveVnakAlanuMdi/kalcarlaveVnakAlanuMci/kalcarlaveVnukanuMci/kalcarlaveVnakanuMci/kalcarlaveVnakAwalanuMdi/kalcarlaveVnakAwalanuMci/kalcarulaveVnakAlanuMci/kalcarulaveVnukanuMci/kalcarulaveVnakanuMci/kalcarulaveVnakAwalanuMdi/kalcarulaveVnakAwalanuMci	n number bahu parsarg muMxunuMdi 
kalcarleVxutinuMdi/*kalcarlakeVxutinuMdi/kalcarleVxutinuMci/kalcarlakeVxutinuMci/kalcaruleVxutinuMdi/kalcarulakeVxutinuMdi/kalcaruleVxutinuMci/kalcarulakeVxutinuMci	n number bahu parsarg veVnukanuMdi 
*kalcarlamaXyanuMdi/kalcarlamaXyanuMci/kalcarlamaXyaniMci/kalcarulamaXyanuMdi/kalcarulamaXyanuMci/kalcarulamaXyaniMci/kalcarlamaXyalonuMdi/kalcarlamaXyalonuMci/kalcarlamaXyaloniMci/kalcarulamaXyalonuMdi/kalcarulamaXyalonuMci/kalcarulamaXyaloniMci	n number bahu parsarg eVxutinuMdi 
*kalcarlanadumanuMdi/kalcarlanadamanuMdi/kalcarlanadumanuMci/kalcarlanadamanuMci/kalcarulanadumanuMdi/kalcarulanadamanuMdi/kalcarulanadumanuMci/kalcarulanadamanuMci	n number bahu parsarg maXyanuMdi 
*kalcarlawaravAwanuMdi/kalcarlawarvAwanuMdi/kalcarlawaravAwanuMci/kalcarlawarvAwanuMci/kalcarulawaravAwanuMdi/kalcarulawarvAwanuMdi/kalcarulawaravAwanuMci/kalcarulawarvAwanuMci	n number bahu parsarg nadumanuMdi 
kalcarlacotunuMdi/kalcarlacotunuMci/kalcarlacotuniMci/*kalcarlacotlonuMdi/kalcarlacotlonuMci/kalcarlacotloniMci/kalcarulacotunuMdi/kalcarulacotunuMci/kalcarulacotuniMci/kalcarulacotlonuMdi/kalcarulacotlonuMci/kalcarulacotloniMci	n number bahu parsarg waravAwanuMdi 
*kalcarlasWAnamunuMdi/kalcarlasWAnaMnuMdi/kalcarlasWAnamunuMci/kalcarlasWAnaMnuMci/kalcarulasWAnamunuMdi/kalcarulasWAnaMnuMdi/kalcarulasWAnamunuMci/kalcarulasWAnaMnuMci/kalcarlasWAnaMlonuMdi/kalcarlasWAnamulonuMdi/kalcarulasWAnaMlonuMdi/kalcarulasWAnamulonuMdi/kalcarlasWAnaMlonuMci/kalcarlasWAnamulonuMci/kalcarulasWAnaMlonuMci/kalcarulasWAnamulonuMci	n number bahu parsarg cotlonuMdi 
*kalcarlayaMxu/kalcarlaMxu/kalcarulayaMxu/kalcarulaMxu	n number bahu parsarg sWAnaMnuMdi 
*kalcarlaMte/kalcarlaMteV/kalcarulaMte/kalcarulaMteV	n number bahu parsarg aMxu 
*kalcarlakaMteV/kalcarlakaMte/kalcarlakanna/kalcarlakannA/kalcarulakaMteV/kalcarulakaMte/kalcarulakanna/kalcarulakannA	n number bahu parsarg aMte 
*kalcarlEna/kalcarulEna	n number bahu parsarg kaMteV 
*kalcarlapAti/kalcarulapAti	n number bahu parsarg Ena 
*kalcarlalAMti/kalcarlalAti/kalcarulalAMti/kalcarulalAti	n number bahu parsarg pAti 
*kalcarlugAnI/kalcarlukAnI/kalcarulugAnI/kalcarulukAnI	n number bahu parsarg lAMti 
*kalcarlugA/kalcarulugA	n number bahu parsarg gAni 
	n number bahu parsarg gA 
