noun	
kota	
*kota	n number eka parsarg 0 
-	n number eka parsarg I 
-	n number eka parsarg gA 
*kotagAdu	n number eka parsarg gAdu 
*kotagawweV	n number eka parsarg gawweV 
*kotavAdu	n number eka parsarg vAdu 
*kotAyana	n number eka parsarg Ayana 
*kotavAru	n number eka parsarg vAru 
*kotaxi	n number eka parsarg xi 
*kotavi	n number eka parsarg vi 
*kotagAru	n number eka parsarg gAru 
*kotanu	n number eka parsarg nu 
*kotavu	n number eka parsarg vu 
*kotayoVkka	n number eka parsarg yoVkka 
*kota	n number eka parsarg obl 
*kotani/kotanu	n number eka parsarg ni 
*kotaki/kotaku	n number eka parsarg ki 
*kotawo/kotawoda/kotawoti	n number eka parsarg wo 
kotalo/kotalona/*kotalopala	n number eka parsarg lo 
*kotaloni/kotalopali/kotayaMxali	n number eka parsarg loni 
*kotamIxa	n number eka parsarg mIxa 
*kotana	n number eka parsarg na 
kotaniMci/kotanuMci/*kotanuMdi	n number eka parsarg niMci 
*kotaxvArA/kotaxvAra	n number eka parsarg xvArA 
*kotavalana/kotavalla	n number eka parsarg valana 
*kotanubatti/kotanibatti	n number eka parsarg batti 
kotace/*kotacewa	n number eka parsarg ce 
*kotawopAtu	n number eka parsarg wopAtu 
*kotawokUdi/kotawokUda/kotawokUdA/kotawogUdA/kotawogUdi	n number eka parsarg wokUdi 
*kotakosaM/kotakE/kotArWaM	n number eka parsarg kosaM 
*kotakoVraku/kotakoVrYaku	n number eka parsarg koVraku 
*kotalonuMdi/kotalonuMci/kotaloniMci	n number eka parsarg lonuMdi 
*kotamIxanuMdi/kotamIxanuMci/kotamIxaniMci/kotamIxinuMci	n number eka parsarg mIxanuMdi 
*kotaxAkA/kotaxAka	n number eka parsarg xAkA 
*kotavaraku	n number eka parsarg varaku 
*kotamIxaki/kotamIxaku/kotamIxiki	n number eka parsarg mIxaki 
*kotaxaggara/kotaxaggira	n number eka parsarg xaggara 
*kotavaxxa/kotavaxxa	n number eka parsarg vaxxa 
*kotakAda	n number eka parsarg kAda 
*kotakeVxurugA/koteVxurugA	n number eka parsarg keVxurugA 
*kotamuMxu	n number eka parsarg muMxu 
*kotaguriMci/kotaniguriMci/kotanugUrci	n number eka parsarg guriMci 
kotapE/*kotapEna/kotapEni	n number eka parsarg pE 
*kotapEki	n number eka parsarg pEki 
*kotaguMdA	n number eka parsarg guMdA 
kotalA/kotalAga/*kotalAgA	n number eka parsarg lA 
*kotavale/kotavaleV/kotamAxiri/kotanupolina/kotanubolina	n number eka parsarg vale 
*kotakumalle/kotakumalleV	n number eka parsarg kimalle 
*kotakUdA/kotanikUdA/kotanukUdA/kotanugUdA	n number eka parsarg kUdA 
*kotaxqRtilo/kotaxruRtilo	n number eka parsarg xqRtilo 
*kotalekuMdA/kotanilekuMdA/kotalekuMda/kotanulekuMdA	n number eka parsarg lekuMdA 
*kotakAkuMdA/kotanikAkuMdA/kotakAkuMda/kotanukAkuMdA	n number eka parsarg kAkuMdA 
*kotamoVxalukoVni/kotanimoVxalukoVni/kotanumoVxalukoVni	n number eka parsarg moVxalukoVni 
*kotavEpu/kotavepu/kotakesi	n number eka parsarg vEpu 
kotapakka/kotaprakka/kotapakkana/*kotaprakkana/kotapakkani	n number eka parsarg pakka 
kotapakkalo/*kotaprakkalo/kotapakkalona/kotapakkaloni	n number eka parsarg pakkalo 
kotaloki/kotaloniki/*kotalopalaki/kotalopalaku/kotalopaliki	n number eka parsarg lopalaki 
kotakiMxa/*kotakriMxa/kotakriMxane/kotakiMxane	n number eka parsarg kiMxa 
kotaduguna/*kotakaduguna/kotaaduguna	n number eka parsarg aduguna 
kotakeVlla/*kotakalla	n number eka parsarg kalla 
kotaveVnuka/*kotaveVnakAla/kotaveVnakAwala/kotaveVnakana	n number eka parsarg veVnuka 
kotawaravAwa/kotawarvAwa/*kotawaruvAwa/kotawaravAwana/kotawarvAwana/kotawaruvAwana	n number eka parsarg waravAwa 
koteVxuruguMdA/*kotakeVxuruguMdA	n number eka parsarg eVxuruguMdA 
*kotamaXya/kotamaXyalo/kotamaXyana	n number eka parsarg maXya 
*kotanaduma/kotanadumuna	n number eka parsarg naduma 
kotabaxulugA/kotabaxulu/*kotakibaxulu/kotakubaxulu	n number eka parsarg baxulugA 
*kotacotlo/kotacotulo/kotacotuna/kotacotu	n number eka parsarg cotlo 
*kotasWAnaMlo/kotaswAnaMlo	n number eka parsarg sWAnaMlo 
kotanerugA/kotakunerugA/*kotakinerugA	n number eka parsarg nerugA 
*kotaprakAraM/kotaprakAramu	n number eka parsarg prakAraM 
*kotaxaggaranuMdi/kotaxaggaranuMci/kotaxaggiranuMdi/kotaxaggiranuMci	n number eka parsarg xaggaranuMdi 
*kotavaxxanuMdi/kotavaxxanuMci/kotavaxxaniMci	n number eka parsarg vaxxanuMdi 
*kotapakkanuMdi/kotapakkanuMci/kotapakkaniMci/kotapakkalonuMdi/kotapakkalonuMci/kotapakkaloniMci	n number eka parsarg pakkanuMdi 
*kotalopalanuMdi/kotalopalanuMci/kotalopalaniMci	n number eka parsarg lopalanuMdi 
*kotabEtanuMdi/kotabEtanuMci/kotabEtaniMci	n number eka parsarg bEtanuMdi 
*kotapEnuMdi/kotapEnuMci/kotapEniMci	n number eka parsarg pEnuMdi 
kotakiMxanuMdi/kotakiMxanuMci/kotakimIxaniMci/*kotakriMxanuMdi/kotakriMxanuMci/kotakriMxaniMci	n number eka parsarg kriMxanuMdi 
kotadugunuMdi/kotadugunuMci/*kotakadugunuMdi/kotakadugunuMci/kotakaduguniMci	n number eka parsarg adugunuMdi 
*kotamuMxunuMdi/kotamuMxunuMci/kotamuMxuniMci	n number eka parsarg muMxunuMdi 
kotaveVnukanuMdi/*kotaveVnakAlanuMdi/kotaveVnakAwalanuMdi/kotaveVnakanuMdi/kotaveVnukanuMci/kotaveVnakAlanuMci/kotaveVnakAwalanuMci/kotaveVnakanuMci	n number eka parsarg veVnukanuMdi 
koteVxutinuMdi/*kotakeVxutinuMdi/kotakeVxutinuMci/koteVxutinuMci	n number eka parsarg eVxutinuMdi 
*kotamaXyanuMdi/kotamaXyanuMci/kotamaXyalonuMdi/kotamaXyalonuMci	n number eka parsarg maXyanuMdi 
*kotanadumanuMdi/kotanadumanuMci	n number eka parsarg nadumanuMdi 
*kotawaravAwanuMdi/kotawarvAwanuMdi/kotawaravAwanuMci/kotawarvAwanuMci	n number eka parsarg waravAwanuMdi 
*kotacotlonuMdi/kotacotunuMdi/kotacotlonuMci/kotacotunuMci	n number eka parsarg cotlonuMdi 
kotasWAnaMnuMdi/*kotasWAnamunuMdi/kotasWAnaMnuMci/kotasWAnamunuMci/kotasWAnaMlonuMdi/kotasWAnamulonuMdi/kotasWAnaMlonuMci/kotaswAnamulonuMci	n number eka parsarg sWAnaMnuMdi 
kotaMxu/kotanaMxu/*kotayaMxu	n number eka parsarg aMxu 
*kotaMte/kotaMteV	n number eka parsarg aMte 
*kotakaMteV/kotakaMte/kotakanna/kotakannA	n number eka parsarg kaMteV 
*kotEna	n number eka parsarg Ena 
*kotapAti	n number eka parsarg pAti 
*kotalAMti/kotalAti	n number eka parsarg lAMti 
*kotagAnI/kotagAni	n number eka parsarg gAni 
*kotagA	n number eka parsarg gA 
*kotalu	n number bahu parsarg 0 
*kotalU/kotalArA	n number bahu parsarg I 
*kotalagA	n number bahu parsarg gA 
*kotalagAdu	n number bahu parsarg gAdu 
*kotalagawweV	n number bahu parsarg gawweV 
*kotalavAdu/kotalodu	n number bahu parsarg vAdu 
*kotalAyana	n number bahu parsarg Ayana 
*kotalavAru/kotaloru	n number bahu parsarg vAru 
kotalxi/*kotalaxi	n number bahu parsarg xi 
*kotalavi/kotaliy	n number bahu parsarg vi 
*kotalagAru	n number bahu parsarg gAru 
kotalamu/*kotalaM	n number bahu parsarg nu 
*kotalu	n number bahu parsarg vu 
*kotalayoVkka	n number bahu parsarg yoVkka 
*kotala	n number bahu parsarg obl 
*kotalani/kotalni/kotalanu/kotalnu	n number bahu parsarg ni 
*kotalaki/kotalaku	n number bahu parsarg ki 
*kotalawo/kotalwo/kotalawoda/kotalawoti/kotalwoti/kotalwoda	n number bahu parsarg wo 
kotalalo/kotallo/kotalalona/kotallona/*kotalalopala/kotallopala	n number bahu parsarg lo 
*kotalaloni/kotalayaMxali/kotalloni/kotalalopali/kotallopali	n number bahu parsarg loni 
*kotalamIxa	n number bahu parsarg mIxa 
*kotalana	n number bahu parsarg na 
kotalaniMci/kotalniMci/kotalanuMci/kotalnuMci/*kotalanuMdi/kotalnuMdi	n number bahu parsarg niMci 
*kotalaxvArA/kotalaxvAra	n number bahu parsarg xvArA 
*kotalavalana/kotalavalla	n number bahu parsarg valana 
*kotalacewa/kotalcewa/kotalace/kotalce	n number bahu parsarg batti 
*kotalawopAtu/kotalwopAtu	n number bahu parsarg ce 
*kotalawokUdi/kotalwokUdi/kotalawokUda/kotalawokUdA/kotalwokUdA	n number bahu parsarg wopAtu 
*kotalakosaM/kotalakE/kotlArWaM	n number bahu parsarg wokUdi 
*kotalakoVraku/kotalakoVrYaku	n number bahu parsarg kosaM 
*kotalalonuMdi/kotalalonuMci/kotallonuMdi/kotallonuMci/kotalloniMci/kotalaloniMci	n number bahu parsarg koVraku 
*kotalamIxanuMdi/kotalamIxanuMci/kotalamIxaniMci	n number bahu parsarg lonuMdi 
*kotalaxAkA/kotalaxAka	n number bahu parsarg mIxanuMdi 
*kotalavaraku	n number bahu parsarg xAkA 
*kotalamIxaki/kotalamIxaku/kotalamIxiki	n number bahu parsarg varaku 
*kotalaxaggara/kotalaxaggira	n number bahu parsarg mIxaki 
*kotalavaxxa/kotaloVxxa	n number bahu parsarg xaggara 
*kotalakAda	n number bahu parsarg vaxxa 
kotaleVxurugA/*kotalakeVxurugA	n number bahu parsarg kAda 
*kotalamuMxu	n number bahu parsarg keVxurugA 
*kotalaguriMci/kotalnugUrci/kotalanuguriMci/kotalnigUrci/kotalnuguriMci	n number bahu parsarg muMxu 
kotalapE/kotalapEni/*kotalapEna	n number bahu parsarg guriMci 
*kotalapEki	n number bahu parsarg pE 
*kotalaguMdA	n number bahu parsarg pEki 
kotalalA/kotallA/kotalulA/kotalulAgA/kotalalAga/kotallAga/*kotallAgA	n number bahu parsarg guMdA 
*kotalavale/kotalavaleV/kotalamAxiri/kotalanupolina/kotalnibolina	n number bahu parsarg lA 
*kotalakumalle/kotalakumalleV	n number bahu parsarg vale 
*kotalukUdA/kotalugUdA/kotalnigUdA	n number bahu parsarg kimalle 
*kotalaxqRtilo/kotalaxruRtilo	n number bahu parsarg kUdA 
*kotalulekuMdA/kotallekuMdA	n number bahu parsarg xqRtilo 
*kotalukAkuMdA/kotalugAkuMdA/kotalugAka	n number bahu parsarg lekuMdA 
*kotalumoVxalukoVni/kotalanumoVxalukoVni	n number bahu parsarg kAkuMdA 
*kotalavEpu/kotalavepu/kotalakesi	n number bahu parsarg moVxalukoVni 
kotalapakka/kotalapakkana/kotalaprakka/*kotalaprakkana	n number bahu parsarg vEpu 
kotalapakkalo/*kotalaprakkalo	n number bahu parsarg pakka 
kotalaloki/kotalaloniki/*kotalalopalaki/kotalalopaliki/kotallopaliki/kotallopalaku	n number bahu parsarg pakkalo 
kotalakiMxa/*kotalakriMxa/kotalakriMxane/kotalakiMxane	n number bahu parsarg lopalaki 
kotaladuguna/*kotalakaduguna	n number bahu parsarg kiMxa 
kotalakeVlla/*kotalakalla	n number bahu parsarg aduguna 
kotalaveVnuka/kotalaveVnaka/*kotalaveVnakAla/kotalaveVnukAla/kotalaveVnakAwala/kotalaveVnukAwala	n number bahu parsarg kalla 
*kotalawaravAwa/kotalawarvAwa/kotalwaravAwa	n number bahu parsarg veVnuka 
kotaleVxuruguMdA/*kotalakeVxuruguMdA	n number bahu parsarg waravAwa 
*kotalamaXya/kotalamaXyana/kotalamaXyalo	n number bahu parsarg eVxuruguMdA 
*kotalanaduma/kotalakinaduma	n number bahu parsarg maXya 
kotalabaxulugA/kotalakibaxulugA/kotalabaxulu/*kotalakibaxulu	n number bahu parsarg naduma 
*kotalacotlo/kotalacotulo	n number bahu parsarg baxulugA 
kotalasWAnaMlo/kotalaswAnaMlo/*kotalasWAnamulo	n number bahu parsarg cotlo 
kotalanerugA/kotalakunerugA/*kotalakinerugA	n number bahu parsarg sWAnaMlo 
*kotalaprakAraM/kotalanubatti/kotalabatti/kotalanibatti	n number bahu parsarg nerugA 
*kotalaxaggaranuMdi/kotalaxaggiranuMdi/kotalaxaggaranuMci/kotalaxaggiranuMci	n number bahu parsarg prakAraM 
*kotalavaxxanuMdi/kotalavaxxanuMci	n number bahu parsarg xaggaranuMdi 
*kotalapakkanuMdi/kotalapakkanuMci/kotalapakkalonuMdi/kotalapakkalonuMci	n number bahu parsarg vaxxanuMdi 
*kotalalopalanuMdi/kotallopalanuMdi/kotalalopalanuMci/kotallopalanuMci/kotallopalinuMdi/kotalalopalinuMci	n number bahu parsarg pakkanuMdi 
*kotalabEtanuMdi/kotalabEtanuMci/kotalabEtaniMci	n number bahu parsarg lopalanuMdi 
*kotalapEnuMdi/kotalapEnuMci/kotalapEniMci	n number bahu parsarg bEtanuMdi 
kotalakiMxanuMdi/kotalakiMxanuMci/kotalakiMxaniMci/*kotalakriMxanuMdi/kotalakriMxanuMci/kotalakriMxaniMci	n number bahu parsarg pEnuMdi 
*kotaladugunuMdi/kotaladugunuMci/kotaladuguniMci	n number bahu parsarg kriMxanuMdi 
*kotalamuMxunuMdi/kotalamuMxunuMci/kotalamuMxuniMci	n number bahu parsarg adugunuMdi 
kotalaveVnukanuMdi/kotalaveVnakanuMdi/*kotalaveVnakAlanuMdi/kotalaveVnakAlanuMci/kotalaveVnukanuMci/kotalaveVnakanuMci/kotalaveVnakAwalanuMdi/kotalaveVnakAwalanuMci	n number bahu parsarg muMxunuMdi 
kotaleVxutinuMdi/*kotalakeVxutinuMdi/kotaleVxutinuMci/kotalakeVxutinuMci	n number bahu parsarg veVnukanuMdi 
*kotalamaXyanuMdi/kotalamaXyanuMci/kotalamaXyaniMci/kotalamaXyalonuMdi/kotalamaXyalonuMci/kotalamaXyaloniMci	n number bahu parsarg eVxutinuMdi 
*kotalanadumanuMdi/kotalanadamanuMdi/kotalanadumanuMci/kotalanadamanuMci	n number bahu parsarg maXyanuMdi 
*kotalawaravAwanuMdi/kotalawarvAwanuMdi/kotalawaravAwanuMci/kotalawarvAwanuMci	n number bahu parsarg nadumanuMdi 
kotalacotunuMdi/kotalacotunuMci/kotalacotuniMci/*kotalacotlonuMdi/kotalacotloniMci/kotalacotlonuMci	n number bahu parsarg waravAwanuMdi 
*kotalasWAnamunuMdi/kotalasWAnaMnuMdi/kotalasWAnamunuMci/kotalasWAnaMnuMci/kotalasWAnaMlonuMdi/kotalasWAnamulonuMdi/kotalasWAnaMlonuMci/kotalasWAnamulonuMci	n number bahu parsarg cotlonuMdi 
*kotalayaMxu/kotalaMxu	n number bahu parsarg sWAnaMnuMdi 
*kotalaMte/kotalaMteV	n number bahu parsarg aMxu 
*kotalakaMteV/kotalakaMte/kotalakanna/kotalakannA	n number bahu parsarg aMte 
*kotalEna	n number bahu parsarg kaMteV 
*kotalapAti	n number bahu parsarg Ena 
*kotalalAMti/kotalalAti	n number bahu parsarg pAti 
*kotalugAnI/kotalukAnI	n number bahu parsarg lAMti 
*kotalugA	n number bahu parsarg gAni 
	n number bahu parsarg gA 
