noun	
kannu	
*kannu	n number eka parsarg 0  case d
-	n number eka parsarg I 
-	n number eka parsarg gA 
*kannugAdu/kaMtigAdu	n number eka parsarg gAdu  case d
*kannugawweV/kaMtigawweV	n number eka parsarg gawweV  case d
kannuvAdu/*kaMtivAdu	n number eka parsarg vAdu  case d
kannAyana/*kaMtAyana	n number eka parsarg Ayana  case d
kannuvAru/*kaMtivAru	n number eka parsarg vAru  case d
kannuxi/*kaMtixi	n number eka parsarg xi  case d
kannuvi/*kaMtivi/kaMtiy	n number eka parsarg vi  case d
*kannugAru	n number eka parsarg gAru  case d
*kannunu	n number eka parsarg nu 
*kannuvu	n number eka parsarg vu  case d
*kaMtiyoVkka/kannuyoVkka	n number eka parsarg yoVkka 
*kaMti/kannu	n number eka parsarg obl 
*kannuni/kannunu/kaMtini	n number eka parsarg ni 
*kannuki/kannuku/kaMtiki/kaMtiku	n number eka parsarg ki 
*kannuwo/kannuwoda/kaMtiwo/kaMtiwoda	n number eka parsarg wo 
*kannulo/kannulona/kaMtilo/kaMtilona/kannulopala/kaMtilopala	n number eka parsarg lo 
*kannuloni/kaMtiloni/kannulopali/kaMtilopali	n number eka parsarg loni 
kannumIxa/*kaMtimIxa	n number eka parsarg mIxa 
*kannuna/kaMtina	n number eka parsarg na 
kannuniMci/kannunuMci/kannunuMdi/kaMtiniMci/kaMtinuMci/*kaMtinuMdi	n number eka parsarg niMci 
*kannuxvArA/kaMtixvArA/kannuxvAra/kaMtixvAra	n number eka parsarg xvArA 
*kannuvalana/kannuvalla/kaMtivalana/kaMtivalla	n number eka parsarg valana 
kannunubatti/kannunibatti/*kaMtinibatti/kannubatti	n number eka parsarg batti 
kannuce/*kannucewa/kaMtice/kaMticewa	n number eka parsarg ce 
kannuwopAtu/*kaMtiwopAtu	n number eka parsarg wopAtu 
*kannuwokUdi/kannuwokUda/kannuwokUdA/kaMtiwokUdi/kaMtiwokUda/kaMtiwokUdA	n number eka parsarg wokUdi 
*kannukosaM/kannukE/kaMtikosaM/kaMtikE/kannArWaM	n number eka parsarg kosaM 
*kannukoVraku/kannukoVrYaku/kaMtikoVraku/kaMtikoVrYaku	n number eka parsarg koVraku 
kannulonuMdi/kannulonuMci/*kaMtilonuMdi/kaMtilonuMci	n number eka parsarg lonuMdi 
kannumIxanuMdi/kannumIxanuMci/*kaMtimIxanuMdi/kaMtimIxanuMci	n number eka parsarg mIxanuMdi 
kannuxAkA/kannuxAka/*kaMtixAkA/kaMtixAka	n number eka parsarg xAkA 
kannuvaraku/*kaMtivaraku	n number eka parsarg varaku 
kannumIxaki/kannumIxaku/*kaMtimIxaki/kaMtimIxaku	n number eka parsarg mIxaki 
kannuxaggara/*kaMtixaggara/kannuxaggira/kaMtixaggira	n number eka parsarg xaggara 
kannuvaxxa/*kaMtivaxxa	n number eka parsarg vaxxa 
kannukAda/*kaMtikAda	n number eka parsarg kAda 
kannukeVxurugA/kanneVxurugA/*kaMtikeVxurugA	n number eka parsarg keVxurugA 
kannumuMxu/*kaMtimuMxu	n number eka parsarg muMxu 
kannuguriMci/kannuniguriMci/*kaMtiguriMci/kaMtiniguriMci	n number eka parsarg guriMci 
kannupE/kannupEna/kaMtipE/*kaMtipEna	n number eka parsarg pE 
kannupEki/*kaMtipEki	n number eka parsarg pEki 
kannuguMdA/*kaMtiguMdA	n number eka parsarg guMdA 
kannulA/kannulAga/*kannulAgA/kaMtilA/kaMtilAga/kaMtilAgA	n number eka parsarg lA 
*kannuvale/kannumAxiri/kannunipoli/kaMtivale/kaMtimAxiri/kaMtinipoli	n number eka parsarg vale 
kannukimalle/*kaMtikimalle	n number eka parsarg kimalle 
kannukUdA/kannunikUdA/*kaMtinikUdA/kannugUdA/kannunigUdA/kaMtinigUdA	n number eka parsarg kUdA 
kannuxqRtilo/kannuxruRtilo/*kaMtixqRtilo/kaMtixruRtilo	n number eka parsarg xqRtilo 
*kannulekuMdA/kannuleka/kaMtinilekuMdA	n number eka parsarg lekuMdA 
*kannukAkuMdA/kannukAka/kaMtinikAkuMdA	n number eka parsarg kAkuMdA 
*kannumoVxalukoVni/kannunimoVxalukoVni/kaMtinimoVxalukoVni	n number eka parsarg moVxalukoVni 
kannuvEpu/*kaMtivEpu/kannukesi/kaMtikesi	n number eka parsarg vEpu 
kannupakka/kannuprakka/kannupakkana/kaMtipakka/*kaMtiprakka/kaMtipakkana	n number eka parsarg pakka 
kannupakkalo/kannuprakkalo/kaMtipakkalo/*kaMtiprakkalo	n number eka parsarg pakkalo 
kannuloki/*kaMtiloki/kannuloniki/kaMtiloniki/kannulopalaki/kannulopalaku/kannulopaliki/kaMtilopalaku/kaMtilopaliki	n number eka parsarg lopalaki 
kannukiMxa/kannukriMxa/kaMtikiMxa/*kaMtikriMxa/kannukriMxane/kannukiMxane/kaMtikriMxane/kaMtikiMxane	n number eka parsarg kiMxa 
kannaduguna/kannukaduguna/*kaMtikaduguna/kaMtaduguna	n number eka parsarg aduguna 
kannukeVlla/kannukalla/kaMtikeVlla/*kaMtikalla	n number eka parsarg kalla 
kannuveVnuka/kannuveVnakAla/kannuveVnakAwala/kaMtiveVnuka/*kaMtiveVnakAla/kaMtiveVnakAwala	n number eka parsarg veVnuka 
kannuwaravAwa/kannuwarvAwa/*kannuwaruvAwa/kaMtiwaravAwa/kaMtiwarvAwa/kaMtiwaruvAwa	n number eka parsarg waravAwa 
kanneVxuruguMdA/kannukeVxuruguMdA/kaMteVxuruguMdA/*kaMtikeVxuruguMdA	n number eka parsarg eVxuruguMdA 
kannumaXya/kannumaXyalo/kannumaXyana/*kaMtimaXya/kaMtimaXyalo/kaMtimaXyana	n number eka parsarg maXya 
*kannunaduma/kaMtinaduma	n number eka parsarg naduma 
kannubaxulugA/kannubaxulu/kannukibaxulu/kaMtibaxulu/*kaMtikibaxulu	n number eka parsarg baxulugA 
*kannucotlo/kannucotulo/kannucotuna/kaMticotulo/kaMticotlo/kaMticotuna	n number eka parsarg cotlo 
kannusWAnaMlo/kannuswAnaMlo/*kaMtisWAnaMlo/kaMtiswAnaMlo	n number eka parsarg sWAnaMlo 
kannunerugA/kannukunerugA/kannukinerugA/kaMtinerugA/*kaMtikinerugA	n number eka parsarg nerugA 
*kannuprakAraM/kaMtiprakAramu	n number eka parsarg prakAraM 
kannuxaggaranuMdi/kannuxaggaranuMci/*kaMtixaggaranuMdi/kaMtixaggaranuMci	n number eka parsarg xaggaranuMdi 
kannuvaxxanuMdi/kannuvaxxanuMci/*kaMtivaxxanuMdi/kaMtivaxxanuMci	n number eka parsarg vaxxanuMdi 
kannupakkanuMdi/kannupakkanuMci/*kaMtipakkanuMdi/kaMtipakkanuMci/kannupakkalonuMdi/kannupakkalonuMci/kaMtipakkalonuMdi/kaMtipakkalonuMci	n number eka parsarg pakkanuMdi 
kannulopalanuMdi/kannulopalanuMci/*kaMtilopalanuMdi/kaMtilopalanuMci	n number eka parsarg lopalanuMdi 
kannubEtanuMdi/kannubEtanuMci/*kaMtibEtanuMdi/kaMtibEtanuMci	n number eka parsarg bEtanuMdi 
kannupEnuMdi/kannupEnuMci/*kaMtipEnuMdi/kaMtipEnuMci	n number eka parsarg pEnuMdi 
kannukiMxanuMdi/kannukiMxanuMci/kaMtikiMxanuMdi/kaMtikiMxanuMci/kannukriMxanuMdi/kannukriMxanuMci/*kaMtikriMxanuMdi/kaMtikriMxanuMci	n number eka parsarg kriMxanuMdi 
kannadugunuMdi/kannadugunuMci/kannukadugunuMdi/kannukadugunuMci/*kaMtikadugunuMdi/kaMtikadugunuMci	n number eka parsarg adugunuMdi 
kannumuMxunuMdi/kannumuMxunuMci/*kaMtimuMxunuMdi/kaMtimuMxunuMci	n number eka parsarg muMxunuMdi 
kannuveVnukanuMdi/kannuveVnakAlanuMdi/kannuveVnakAwalanuMdi/kaMtiveVnakanuMdi/kaMtiveVnakanuMci/kannuveVnukanuMci/kannuveVnakAlanuMci/kannuveVnakAwalanuMci/*kaMtiveVnakAlanuMdi/kaMtiveVnakAlanuMci	n number eka parsarg veVnukanuMdi 
kanneVxutinuMdi/kanneVxutanuMdi/kannukeVxutinuMdi/*kaMtikeVxutinuMci/kaMtikeVxutinuMdi/kaMteVxutinuMdi	n number eka parsarg eVxutinuMdi 
kannumaXyanuMdi/kannumaXyanuMci/*kaMtimaXyanuMdi/kaMtimaXyanuMci/kannumaXyalonuMdi/kannumaXyalonuMci/kaMtimaXyalonuMdi/kaMtimaXyalonuMci	n number eka parsarg maXyanuMdi 
kannunadumanuMdi/kannunadumanuMci/*kaMtinadumanuMdi/kaMtinadumanuMci	n number eka parsarg nadumanuMdi 
kannuwaravAwanuMdi/kannuwarvAwanuMdi/*kaMtiwaravAwanuMdi/kaMtiwarvAwanuMdi/kannuwaravAwanuMci/kannuwarvAwanuMci/kaMtiwaravAwanuMci/kaMtiwarvAwanuMci	n number eka parsarg waravAwanuMdi 
kannucotunuMdi/kaMticotunuMdi/*kaMticotlonuMdi/kaMticotlonuMci/kaMticotunuMci	n number eka parsarg cotlonuMdi 
kannusWAnaMnuMdi/kannusWAnaMnuMci/*kaMtisWAnaMnuMdi/kaMtisWAnaMnuMci/kannusWAnamunuMci/kaMtisWAnamunuMci/kannusWAnaMlonuMdi/kannusWAnamulonuMdi/kaMtisWAnaMlonuMdi/kaMtisWAnamulonuMdi/kannusWAnaMlonuMci/kannuswAnamulonuMci/kaMtisWAnaMlonuMci/kaMtisWAnamulonuMci	n number eka parsarg sWAnaMnuMdi 
kannaMxu/kannunaMxu/kaMtinaMxu/*kaMtiyaMxu	n number eka parsarg aMxu 
kannaMte/*kannaMteV	n number eka parsarg aMte 
*kannukaMteV/kannukaMte/kaMtikaMte/kaMtikaMteV/kaMtikannA/kaMtikanna/kannukannA/kannukanna	n number eka parsarg kaMteV 
*kannEna	n number eka parsarg Ena 
*kannupAti	n number eka parsarg pAti 
*kannulAMti/kannulAti	n number eka parsarg lAMti 
*kannugAnI/kannukAnI	n number eka parsarg gAni 
*kannugA	n number eka parsarg gA 
kannulu/*kalYlYu/kalYlu/kaMdlu	n number bahu parsarg 0  case d
*kannulU/kannulArA	n number bahu parsarg I  case d
*kannulagA/kaMdlagA	n number bahu parsarg gA 
kannulagAdu/*kalYlYagAdu/kalYlagAdu/kaMdlagAdu	n number bahu parsarg gAdu  case d
kannulagawweV/*kalYlYagawweV/kalYlagawweV/kaMdlagawweV	n number bahu parsarg gawweV  case d
kannulavAdu/*kalYlYavAdu/kalYlavAdu/kaMdlavAdu	n number bahu parsarg vAdu  case d
kannulAyana/*kalYlYAyana/kalYlAyana/kaMdlAyana	n number bahu parsarg Ayana  case d
kannulavAru/*kalYlYavAru/kalYlavAru/kaMdlavAru	n number bahu parsarg vAru  case d
kannulaxi/*kalYlYaxi/kalYlaxi/kaMdlaxi	n number bahu parsarg xi  case d
kannulavi/*kalYlYavi/kalYlavi/kaMdlavi/kalYlay	n number bahu parsarg vi  case d
kannulagAru/*kalYlYugAru/kalYlugAru/kaMdlagAru	n number bahu parsarg gAru  case d
*kannulaM/kalYlaM/kaMdlaM/kannulamu/kalYlamu/kaMdlamu	n number bahu parsarg nu  case d
kannulu/*kalYlYu/kalYlu/kaMdlu	n number bahu parsarg vu 
kannulayoVkka/*kalYlYayoVkka/kalYlayoVkka/kaMdlayoVkka	n number bahu parsarg yoVkka 
kannula/*kalYlYa/kalYla/kaMdla	n number bahu parsarg obl 
kannulani/kannulni/*kalYlYani/kalYlani/kannulanu/kalYlanu/kaMdlanu	n number bahu parsarg ni 
kannulaki/*kalYlYaki/kalYlaki/kannulaku/kalYlaku/kaMdlaku/kaMdlaki	n number bahu parsarg ki 
kannulawo/*kalYlYawo/kalYlawo/kannulawoda/kalYlawoda/kaMdlawo/kaMdlawoda	n number bahu parsarg wo 
kannulalo/kalYlalo/kannullo/*kalYlYallo/kalYlallo/kannulalona/kalYlalona/kannullona/kaMdlallo/kannulalopala/kaMdlalopala/kalYlalopala	n number bahu parsarg lo 
*kannulloni/kalYlalloni/kaMdlalloni/kannulalopali/kaMdlalopali/kalYlalopali/kalYlayaMxali	n number bahu parsarg loni 
kannulamIxa/*kalYlYamIxa/kalYlamIxa/kaMdlamIxa	n number bahu parsarg mIxa 
kannulana/*kalYlYana/kalYlana/kaMdlana	n number bahu parsarg na 
kannulaniMci/kalYlaniMci/kannulanuMci/kalYlanuMci/kannulanuMdi/*kalYlYanuMdi/kalYlanuMdi/kaMdlanuMdi/kaMdlanuMci	n number bahu parsarg niMci 
kannulaxvArA/*kalYlYaxvArA/kalYlaxvArA/kaMdlaxvArA	n number bahu parsarg xvArA 
kannulavalana/*kalYlYavalana/kalYlavalana/kannulavalla/kalYlavalla/kannulavalana/kalYlavalana	n number bahu parsarg valana 
kannulanubatti/*kalYlYanubatti/kalYlanubatti/kaMdlanubatti	n number bahu parsarg batti 
kannulacewa/*kalYlYacewa/kalYlacewa/kannulace/kalYlace/kaMdlace/kaMdlacewa	n number bahu parsarg ce 
kannulawopAtu/*kalYlYawopAtu/kalYlawopAtu/kaMdlawopAtu/kannulawobAtu/kalYlawobAtu/kaMdlawobAtu	n number bahu parsarg wopAtu 
kannulawokUdi/*kalYlYawokUdi/kalYlawokUdi/kannulawokUda/kalYlawokUda/kaMdlawokUdA/kaMdlawokUdi	n number bahu parsarg wokUdi 
kannulakosaM/*kalYlYakosaM/kalYlakosaM/kannulakE/kalYlakE/kaMdlakosaM/kaMdlakE/kannulArWaM	n number bahu parsarg kosaM 
kannulakoVraku/*kalYlYakoVraku/kalYlakoVraku/kannulakoVrYaku/kalYlakoVrYaku/kaMdlakoVraku	n number bahu parsarg koVraku 
kannulalonuMdi/kannulalonuMci/*kalYlYalonuMdi/kalYlalonuMdi/kaMdlalonuMci/kalYlallonuMdi/kannullonuMdi/kaMdlallonuMdi/kalYlalonuMci/kannullonuMci	n number bahu parsarg lonuMdi 
kannulamIxanuMdi/*kalYlYamIxanuMdi/kalYlamIxanuMdi/kannulamIxanuMci/kalYlamIxanuMci	n number bahu parsarg mIxanuMdi 
kannulaxAkA/*kalYlYaxAkA/kalYlaxAkA/kaMdlaxAka/kannulaxAka/kalYlaxAka/kaMdlaxAkA	n number bahu parsarg xAkA 
kannulavaraku/*kalYlYavaraku/kalYlavaraku/kaMdlavaraku	n number bahu parsarg varaku 
kannulamIxaki/*kalYlYamIxaki/kalYlamIxaki/kannulamIxaku/kalYlamIxaku	n number bahu parsarg mIxaki 
kannulaxaggara/*kalYlYaxaggara/kalYlaxaggara/kaMdlaxaggara/kaMdlaxaggira/kalYlaxaggira	n number bahu parsarg xaggara 
kannulavaxxa/*kalYlYavaxxa/kalYlavaxxa/kaMdlavaxxa	n number bahu parsarg vaxxa 
kannulakAda/*kalYlYakAda/kalYlakAda/kaMdlakAda	n number bahu parsarg kAda 
kannuleVxurugA/*kalYlYakeVxurugA/kalYlakeVxurugA/kaMdlakeVxurugA	n number bahu parsarg keVxurugA 
kannulamuMxu/*kalYlYamuMxu/kalYlamuMxu/kaMdlamuMxu	n number bahu parsarg muMxu 
kannulaguriMci/*kalYlYaguriMci/kalYlaguriMci/kaMdlaguriMci	n number bahu parsarg guriMci 
kannulapE/kalYlapE/kannulapEna/*kalYlYapEna/kalYlapEna/kaMdlapE/kaMdlapEna	n number bahu parsarg pE 
kannulapEki/*kalYlYapEki/kalYlapEki/kaMdlapEki	n number bahu parsarg pEki 
kannulaguMdA/*kalYlYaguMdA/kalYlaguMdA/kaMdlaguMdA	n number bahu parsarg guMdA 
kannulalA/kannullA/*kalYlYalA/kalYlalA/kaMdlalA/kalYlallA/kannulalAga/kalYlalAguna/kannullAgA/kalYlallAgA/kaMdlalA/kaMdlallA	n number bahu parsarg lA 
kannulavale/*kalYlYavale/kalYlavale/kaMdlavale/kannulavaleV/kannulamAxiri/kalYlamAxiri/kannulapoli/kalYlapoli/kaMdlanupoli	n number bahu parsarg vale 
kannulakumalleV/*kalYlYukumalleV/kalYlukumalleV/kaMdlakumalleV/kannulakumalle/kalYlukumalle/kaMdlakumalle	n number bahu parsarg kimalle 
kannulukUdA/*kalYlYukUdA/kalYlukUdA/kaMdlukUdA/kannulugUdA/kalYlugUdA/kaMdlugUdA/kalYlanugUdA/kalYlanigUdA	n number bahu parsarg kUdA 
kannulaxqRtilo/*kalYlYaxqRtilo/kalYlaxqRtilo/kannulaxruRtilo/kalYlaxruRtilo	n number bahu parsarg xqRtilo 
kannululekuMdA/*kalYlYulekuMdA/kalYlulekuMdA/kaMdlulekuMdA/kannullekuMdA/kalYluleka/kaMdluleka/kannululeka	n number bahu parsarg lekuMdA 
kannulukAkuMdA/*kalYlYukAkuMdA/kalYlukAkuMdA/kaMdlukAkuMdA/kannulukAka/kalYlukAka/kaMdlukAka	n number bahu parsarg kAkuMdA 
kannulumoVxalukoVni/kalYlumoVxalukoVni/*kalYlYumoVxalukoVni	n number bahu parsarg moVxalukoVni 
kannulavEpu/*kalYlYavEpu/kalYlavEpu/kaMdlavEpu/kannulavepu/kalYlavepu/kaMdlavepu/kannulakesi/kalYlakesi/kaMdlakesi	n number bahu parsarg vEpu 
kannulapakka/kalYlapakka/kannulaprakka/kannulapakkana/*kalYlYaprakka/kalYlaprakka/kalYlapakkana	n number bahu parsarg pakka 
kannulapakkalo/kalYlapakkalo/kannulaprakkalo/*kalYlYaprakkalo/kalYlaprakkalo	n number bahu parsarg pakkalo 
kannulaloki/kannulaloniki/*kalYlYaloki/kalYlaloki/kalYlaloniki/kannulalopalaki/kalYlalopalaki/kannullopalaki/kalYlalopaliki/kannulalopaliki/kalYlalopalaku/kannullopalaku/kalYlalopalaku	n number bahu parsarg lopalaki 
kannulakiMxa/kalYlakiMxa/kannulakriMxa/*kalYlYakriMxa/kalYlakriMxa/kaMdlakriMxa/kaMdlakiMxa/kannulakriMxane/kalYlakriMxane/kannulakiMxane/kalYlakiMxane	n number bahu parsarg kiMxa 
kannuladuguna/*kalYlYakaduguna/kalYlakaduguna/kaMdlakaduguna/kalYladuguna/kaMdladuguna	n number bahu parsarg aduguna 
kannulakeVlla/kalYlakeVlla/kannulakalla/*kalYlYakalla/kalYlakalla	n number bahu parsarg kalla 
kannulaveVnuka/kalYlaveVnuka/kannulaveVnakAla/*kalYlYaveVnakAla/kalYlaveVnakAla/kaMdlaveVnakAla/kaMdlaveVnaka/kannulaveVnakAwala/kalYlaveVnakAwala/kaMdlaveVnakAwala	n number bahu parsarg veVnuka 
kannulawaravAwa/*kalYlYawaravAwa/kalYlawaravAwa/kannulawarvAwa/kalYlawarvAwa	n number bahu parsarg waravAwa 
kannuleVxuruguMdA/*kalYlYakeVxuruguMdA/kalYlakeVxuruguMdA/kaMdlakeVxuruguMdA/kannulakeVxuruguMdA	n number bahu parsarg eVxuruguMdA 
kannulamaXya/*kalYlYamaXya/kalYlamaXya/kannulamaXyalo/kalYlamaXyalo/kaMdlamaXyalo	n number bahu parsarg maXya 
kannulanaduma/*kalYlYanaduma/kalYlanaduma/kaMdlanadama/kaMdlanaduma	n number bahu parsarg naduma 
kannulabaxulugA/kalYlabaxulugA/kannulabaxulu/*kalYlYabaxulu/kalYlabaxulu/kaMdlabaxulu	n number bahu parsarg baxulugA 
kannulacotlo/*kalYlYacotlo/kalYlacotlo/kannulacotulo/kalYlacotulo/kaMdlacotulo	n number bahu parsarg cotlo 
kannulasWAnaMlo/*kalYlYasWAnaMlo/kalYlasWAnaMlo/kannulaswAnaMlo/kalYlaswAnaMlo	n number bahu parsarg sWAnaMlo 
kannulanerugA/kalYlanerugA/kannulakunerugA/kalYlakunerugA/kannulakinerugA/*kalYlYakinerugA/kalYlakinerugA	n number bahu parsarg nerugA 
kannulaprakAraM/*kalYlYaprakAraM/kalYlaprakAraM/kannulanubatti/kalYlanubatti/kaMdlanubatti	n number bahu parsarg prakAraM 
kannulaxaggaranuMdi/*kalYlYaxaggaranuMdi/kalYlaxaggaranuMdi/kannulaxaggaranuMci/kalYlaxaggaranuMci	n number bahu parsarg xaggaranuMdi 
kannulavaxxanuMdi/*kalYlYavaxxanuMdi/kalYlavaxxanuMdi/kannulavaxxanuMci/kalYlavaxxanuMci	n number bahu parsarg vaxxanuMdi 
kannulapakkanuMdi/*kalYlYapakkanuMdi/kalYlapakkanuMdi/kannulapakkanuMci/kalYlapakkanuMci/kannulapakkalonuMdi/kalYlapakkalonuMdi/kannulapakkalonuMci/kalYlapakkalonuMci	n number bahu parsarg pakkanuMdi 
kannulalopalanuMdi/kaMdlalopalanuMdi/*kalYlYalopalanuMdi/kalYlalopalanuMdi/kannullopalanuMdi/kalYlalopalinuMdi/kannulalopalanuMci/kalYlalopalanuMci/kannullopalanuMci/kalYlalopalaniMci	n number bahu parsarg lopalanuMdi 
kannulabEtanuMdi/*kalYlYabEtanuMdi/kalYlabEtanuMdi/kannulabEtanuMci/kalYlabEtanuMci	n number bahu parsarg bEtanuMdi 
kannulapEnuMdi/*kalYlYapEnuMdi/kalYlapEnuMdi/kannulapEnuMci/kalYlapEnuMci	n number bahu parsarg pEnuMdi 
kannulakiMxanuMdi/kalYlakiMxanuMdi/kannulakiMxanuMci/kalYlakiMxanuMci/kannulakriMxanuMdi/*kalYlYakriMxanuMdi/kalYlakriMxanuMdi/kannulakriMxanuMci/kalYlakriMxanuMci	n number bahu parsarg kriMxanuMdi 
kannuladugunuMdi/*kalYlYadugunuMdi/kalYladugunuMdi/kannuladugunuMci/kalYladugunuMci	n number bahu parsarg adugunuMdi 
kannulamuMxunuMdi/*kalYlYamuMxunuMdi/kalYlamuMxunuMdi/kannulamuMxunuMci/kalYlamuMxunuMci	n number bahu parsarg muMxunuMdi 
kannulaveVnukanuMdi/kalYlaveVnukanuMdi/kannulaveVnakAlanuMdi/*kalYlYaveVnakAlanuMdi/kalYlaveVnakAlanuMdi/kannulaveVnukanuMci/kalYlaveVnukanuMci/kannulaveVnakAlanuMci/kalYlaveVnakAlanuMci/kannulaveVnakAwalanuMci/kalYlaveVnakAwalanuMci/kannulaveVnakAwalanuMdi/kalYlaveVnakAwalanuMdi	n number bahu parsarg veVnukanuMdi 
kannuleVxutinuMdi/kalYleVxutinuMdi/*kalYlYakeVxutinuMdi/kalYlakeVxutinuMdi/kaMdleVxutinuMdi/kannuleVxutinuMci/kalYleVxutinuMci/kalYlakeVxutinuMci/kaMdlakeVxutinuMci	n number bahu parsarg eVxutinuMdi 
kannulamaXyanuMdi/*kalYlYamaXyanuMdi/kalYlamaXyanuMdi/kannulamaXyanuMci/kalYlamaXyanuMci/kannulamaXyalonuMdi/kalYlamaXyalonuMdi/kannulamaXyalonuMci/kalYlamaXyalonuMci	n number bahu parsarg maXyanuMdi 
kannulanadumanuMdi/*kalYlYanadumanuMdi/kalYlanadumanuMdi/kannulanadumanuMci/kalYlanadumanuMci	n number bahu parsarg nadumanuMdi 
kannulawaravAwanuMdi/*kalYlYawaravAwanuMdi/kalYlawaravAwanuMdi/kannulawarvAwanuMdi/kalYlawarvAwanuMdi/kannulawaravAwanuMci/kalYlawaravAwanuMci/kannulawarvAwanuMci/kalYlawarvAwanuMci	n number bahu parsarg waravAwanuMdi 
kannulacotlonuMdi/*kalYlYacotlonuMdi/kalYlacotlonuMdi/kannulacotunuMdi/kalYlacotunuMdi/kannulacotlonuMci/kalYlacotlonuMci/kannulacotunuMci/kalYlacotunuMci	n number bahu parsarg cotlonuMdi 
kannulasWAnamunuMdi/*kalYlYasWAnamunuMdi/kalYlasWAnamunuMdi/kannulaswAnaMnuMdi/kalYlaswAnaMnuMdi/kannulasWAnamunuMci/kalYlasWAnamunuMci/kannulaswAnaMnuMci/kalYlaswAnaMnuMci/kannulasWAnaMlonuMdi/kalYlasWAnaMlonuMdi/kannulaswAnamulonuMdi/kalYlaswAnamulonuMdi/kannulasWAnaMlonuMci/kalYlasWAnaMlonuMci/kannulaswAnamulonuMci/kalYlaswAnamulonuMci	n number bahu parsarg sWAnaMnuMdi 
kannulayaMxu/*kalYlYayaMxu/kalYlayaMxu/kannulaMxu/kalYlaMxu	n number bahu parsarg aMxu 
kannulaMte/*kalYlYaMte/kalYlaMte/kaMdlaMte/kaMdlaMteV/kalYlaMteV/kannulaMteV	n number bahu parsarg aMte 
kannulakaMteV/kannulakaMte/*kalYlYakaMteV/kalYlakaMteV/kalYlakaMte/kaMdlakaMteV/kaMdlakaMte/kannulakanna/kannulakannA/kalYlakanna/kalYlakannA/kaMdlakanna/kaMdlakannA	n number bahu parsarg kaMteV 
*kalYlYEna/kalYlEna/kannulEna/kaMdlEna	n number bahu parsarg Ena 
*kalYlYapAti/kalYlapAti/kannulapAti/kaMdlapAti	n number bahu parsarg pAti 
*kalYlYalAMti/kalYlalAMti/kannulalAMti/kalYlalAti/kaMdlalAMti	n number bahu parsarg lAMti 
*kalYlYugAnI/kalYlugAnI/kannulukAnI/kannulugAnI/kaMdlugAnI	n number bahu parsarg gAni 
*kalYlYagA/kalYlagA/kannulugA/kaMdlugA	n number bahu parsarg gA 
