noun	
koti	
*koti	n number eka parsarg 0 
-	n number eka parsarg I 
-	n number eka parsarg gA 
*kotigAdu	n number eka parsarg gAdu 
*kotigawweV	n number eka parsarg gawweV 
*kotivAdu	n number eka parsarg vAdu 
*kotAyana	n number eka parsarg Ayana 
*kotivAru	n number eka parsarg vAru 
*kotixi	n number eka parsarg xi 
*kotivi/kotiy	n number eka parsarg vi 
*kotigAru	n number eka parsarg gAru 
*kotini	n number eka parsarg nu 
kotivu/*kotivi	n number eka parsarg vu 
*kotiyoVkka	n number eka parsarg yoVkka 
*koti	n number eka parsarg obl 
*kotini	n number eka parsarg ni 
*kotiki/kotiku	n number eka parsarg ki 
*kotiwo/kotiwoda/kotiwoti/kotiwoni	n number eka parsarg wo 
kotilo/kotlo/kotilona/*kotilopala	n number eka parsarg lo 
*kotiloni/kotilopali/kotiyaMxali	n number eka parsarg loni 
*kotimIxa	n number eka parsarg mIxa 
*kotina	n number eka parsarg na 
kotiniMci/kotinuMci/*kotinuMdi	n number eka parsarg niMci 
*kotixvArA/kotixvAra	n number eka parsarg xvArA 
*kotivalana/kotivalla	n number eka parsarg valana 
*kotinibatti	n number eka parsarg batti 
kotice/*koticewa	n number eka parsarg ce 
*kotiwopAtu/kotiwobAtu	n number eka parsarg wopAtu 
*kotiwokUdi/kotiwogUdi/kotiwokUda/kotiwokUdA/kotiwogUdA	n number eka parsarg wokUdi 
*kotikosaM/kotikE/kotikosamu/kotArWaM	n number eka parsarg kosaM 
*kotikoVraku/kotikoVrYaku	n number eka parsarg koVraku 
*kotilonuMdi/kotilonuMci/kotiloniMci/kotlonuMdi/kotlonuMci	n number eka parsarg lonuMdi 
*kotimIxanuMdi/kotimIxanuMci/kotimIxaniMci	n number eka parsarg mIxanuMdi 
*kotixAkA/kotixAka	n number eka parsarg xAkA 
*kotivaraku	n number eka parsarg varaku 
*kotimIxaki/kotimIxaku/kotimIxiki	n number eka parsarg mIxaki 
*kotixaggara/kotixaggira	n number eka parsarg xaggara 
*kotivaxxa/kotoVxxa/kotiyoVxxa	n number eka parsarg vaxxa 
*kotikAda	n number eka parsarg kAda 
*kotikeVxurugA/koteVxurugA	n number eka parsarg keVxurugA 
*kotimuMxu	n number eka parsarg muMxu 
*kotiguriMci/kotiniguriMci/kotinigUrci	n number eka parsarg guriMci 
kotipE/*kotipEna/kotipEni	n number eka parsarg pE 
*kotipEki	n number eka parsarg pEki 
*kotiguMdA	n number eka parsarg guMdA 
kotilA/kotilAga/*kotilAgA	n number eka parsarg lA 
*kotivale/kotimAxiri/kotinipolina/kotinibolina	n number eka parsarg vale 
*kotikimalle/kotikimalleV	n number eka parsarg kimalle 
*kotikUdA/kotinikUdA/kotinigUdA/kotigUdA/kotinigUda/kotinikUda	n number eka parsarg kUdA 
*kotixqRtilo/kotixruRtilo	n number eka parsarg xqRtilo 
*kotilekuMdA/kotileka/kotilekuMda/kotinilekuMdA	n number eka parsarg lekuMdA 
*kotikAkuMdA/kotikAka/kotikAkuMda/kotinikAkuMdA/kotigAkuMdA/kotigAka/kotigAkuMda/kotinugAkuMdA	n number eka parsarg kAkuMdA 
*kotimoVxalukoVni/kotinimoVxalukoVni/kotinumoVxalukoVni	n number eka parsarg moVxalukoVni 
*kotivEpu/kotivepu/kotikesi	n number eka parsarg vEpu 
kotipakka/kotiprakka/kotipakkana/*kotiprakkana/kotipakkani	n number eka parsarg pakka 
kotipakkalo/*kotiprakkalo/kotipakkalona/kotipakkaloni	n number eka parsarg pakkalo 
kotiloki/kotiloniki/*kotilopalaki/kotilopalaku/kotilopaliki	n number eka parsarg lopalaki 
kotikiMxa/*kotikriMxa/kotikriMxana/kotikiMxana	n number eka parsarg kiMxa 
kotaduguna/*kotikaduguna	n number eka parsarg aduguna 
kotikeVlla/*kotikalla	n number eka parsarg kalla 
kotiveVnuka/*kotiveVnakAla/kotiveVnakAwala/kotiveVnakana	n number eka parsarg veVnuka 
kotiwaravAwa/kotiwarvAwa/*kotiwaruvAwa/kotiwaravAwana/kotiwarvAwana/kotiwaruvAwana	n number eka parsarg waravAwa 
koteVxuruguMdA/*kotikeVxuruguMdA	n number eka parsarg eVxuruguMdA 
*kotimaXya/kotimaXyalo/kotimaXyana	n number eka parsarg maXya 
*kotinaduma/kotinadumana	n number eka parsarg naduma 
kotibaxulugA/kotibaxulu/*kotikibaxulu/kotinibaxulu	n number eka parsarg baxulugA 
*koticotlo/koticotulo/koticotuna/koticota	n number eka parsarg cotlo 
kotisWAnaMlo/kotiswAnaMlo/*kotisWAnamulo/kotiswAnamulo	n number eka parsarg sWAnaMlo 
kotinerugA/kotikunerugA/*kotikinerugA	n number eka parsarg nerugA 
*kotiprakAraM/kotiprakAramu	n number eka parsarg prakAraM 
*kotixaggaranuMdi/kotixaggaranuMci/kotixaggiranuMdi/kotixaggiranuMci	n number eka parsarg xaggaranuMdi 
*kotivaxxanuMdi/kotivaxxanuMci/kotivaxxaniMci	n number eka parsarg vaxxanuMdi 
*kotipakkanuMdi/kotipakkanuMci/kotipakkaniMci/kotipakkalonuMdi/kotipakkalonuMci/kotipakkaloniMci	n number eka parsarg pakkanuMdi 
*kotilopalanuMdi/kotilopalanuMci/kotilopalaniMci	n number eka parsarg lopalanuMdi 
*kotibEtanuMdi/kotibEtanuMci/kotibEtaniMci	n number eka parsarg bEtanuMdi 
*kotipEnuMdi/kotipEnuMci/kotipEniMci	n number eka parsarg pEnuMdi 
kotikiMxanuMdi/kotikiMxanuMci/kotikiMxaniMci/*kotikriMxanuMdi/kotikriMxanuMci/kotikriMxaniMci	n number eka parsarg kriMxanuMdi 
kotadugunuMdi/kotadugunuMci/*kotikadugunuMdi/kotikadugunuMci/kotikaduguniMci	n number eka parsarg adugunuMdi 
*kotimuMxunuMdi/kotimuMxunuMci/kotimuMxuniMci	n number eka parsarg muMxunuMdi 
kotiveVnukanuMdi/*kotiveVnakAlanuMdi/kotiveVnakAwalanuMdi/kotiveVnakanuMdi/kotiveVnukanuMci/kotiveVnakAlanuMci/kotiveVnakAwalanuMci/kotiveVnakanuMci	n number eka parsarg veVnukanuMdi 
koteVxutinuMdi/kotikeVxutinuMdi/kotikeVxutinuMci/koteVxutinuMci/koteVxutanuMdi/*kotikeVxutanuMdi/kotikeVxutanuMci/koteVxutanuMci	n number eka parsarg eVxutinuMdi 
*kotimaXyanuMdi/kotimaXyanuMci/kotimaXyalonuMdi/kotimaXyalonuMci	n number eka parsarg maXyanuMdi 
*kotinadumanuMdi/kotinadumanuMci	n number eka parsarg nadumanuMdi 
*kotiwaravAwanuMdi/kotiwarvAwanuMdi/kotiwaravAwanuMci/kotiwarvAwanuMci	n number eka parsarg waravAwanuMdi 
*koticotlonuMdi/koticotunuMdi/koticotlonuMci/koticotunuMci	n number eka parsarg cotlonuMdi 
kotisWAnaMnuMdi/*kotisWAnamunuMdi/kotisWAnaMnuMci/kotisWAnamunuMci/kotisWAnaMlonuMdi/kotisWAnamulonuMdi/kotisWAnaMlonuMci/kotiswAnamulonuMci	n number eka parsarg sWAnaMnuMdi 
kotaMxu/kotinaMxu/*kotiyaMxu	n number eka parsarg aMxu 
*kotaMte/kotaMteV	n number eka parsarg aMte 
*kotikaMteV/kotikaMte/kotikanna/kotikannA	n number eka parsarg kaMteV 
*kotEna	n number eka parsarg Ena 
*kotipAti	n number eka parsarg pAti 
*kotilAMti/kotilAti	n number eka parsarg lAMti 
*kotigAnI/kotikAnI	n number eka parsarg gAni 
*kotigA	n number eka parsarg gA 
*kotlu	n number bahu parsarg 0 
*kotlU/kotillArA/kotlulArA	n number bahu parsarg I 
-	n number bahu parsarg gA 
*kotlagAdu	n number bahu parsarg gAdu 
*kotlagawweV	n number bahu parsarg gawweV 
*kotlavAdu/kotlodu	n number bahu parsarg vAdu 
*kotlAyana	n number bahu parsarg Ayana 
*kotlavAru/kotloru	n number bahu parsarg vAru 
*kotlaxi/kotilxi	n number bahu parsarg xi 
*kotlavi/kotliy	n number bahu parsarg vi 
*kotlagAru	n number bahu parsarg gAru 
*kotlaM/kotlamu	n number bahu parsarg nu 
*kotlu	n number bahu parsarg vu 
*kotlayoVkka	n number bahu parsarg yoVkka 
*kotla	n number bahu parsarg obl 
*kotlani/kotilni/kotlanu	n number bahu parsarg ni 
*kotlaki/kotlaku	n number bahu parsarg ki 
*kotlawo/kotilwo/kotlawoni/kotlawoda/kotlawoti/kotilwoti/kotilwoda	n number bahu parsarg wo 
kotlalo/kotillo/*kotlalopala/kotillopala	n number bahu parsarg lo 
*kotlaloni/kotlalopali/kotlayaMxali	n number bahu parsarg loni 
*kotlamIxa/kotlamIxana	n number bahu parsarg mIxa 
*kotlana/kotlana	n number bahu parsarg na 
kotlaniMci/kotlanuMci/*kotlanuMdi/kotilnuMdi	n number bahu parsarg niMci 
*kotlaxvArA/kotlaxvAra	n number bahu parsarg xvArA 
*kotlavalana/kotlavalla	n number bahu parsarg valana 
*kotlanubatti	n number bahu parsarg batti 
*kotlacewa/kotlace	n number bahu parsarg ce 
*kotlawopAtu/kotlawobAtu/kotilwopAtu	n number bahu parsarg wopAtu 
*kotlawokUdi/kotlawogUdi/kotlawokUda/kotlawokUdA/kotlawogUdA	n number bahu parsarg wokUdi 
*kotlakosaM/kotlakE/kotlakosamu/kotlArWaM	n number bahu parsarg kosaM 
*kotlakoVraku/kotlakoVrYaku	n number bahu parsarg koVraku 
*kotlalonuMdi/kotlalonuMci/kotlaloniMci/kotillonuMci/kotillonuMdi	n number bahu parsarg lonuMdi 
*kotlamIxanuMdi/kotlamIxanuMci/kotlamIxaniMci	n number bahu parsarg mIxanuMdi 
*kotlaxAkA/kotlaxAka	n number bahu parsarg xAkA 
*kotlavaraku	n number bahu parsarg varaku 
*kotlamIxaki/kotlamIxaku/kotlamIxiki	n number bahu parsarg mIxaki 
*kotlaxaggara/kotlaxaggira	n number bahu parsarg xaggara 
*kotlavaxxa/kotloVxxa	n number bahu parsarg vaxxa 
*kotlakAda	n number bahu parsarg kAda 
kotleVxurugA/*kotlakeVxurugA/kotileVxurugA	n number bahu parsarg keVxurugA 
*kotlamuMxu	n number bahu parsarg muMxu 
*kotlaguriMci/kotlagUrci/kotilniguriMci/kotlanigUrci	n number bahu parsarg guriMci 
kotlapE/kotlapEni/*kotlapEna	n number bahu parsarg pE 
*kotlapEki	n number bahu parsarg pEki 
*kotlaguMdA/kotlaguMda	n number bahu parsarg guMdA 
kotlalA/kotillA/*kotlalAgA/kotillAgA/kotlalAga	n number bahu parsarg lA 
*kotlavaleV/kotilavaleV/kotlamAxiri/kotilnipolina/kotilnibolina	n number bahu parsarg vale 
*kotlakumalle/kotlakumalleV	n number bahu parsarg kimalle 
*kotlukUdA/kotlugUdA/kotilnigUdA/kotilnikUdA	n number bahu parsarg kUdA 
*kotlaxqRtilo/kotlaxruRtilo	n number bahu parsarg xqRtilo 
*kotlulekuMdA/kotluleka/kotillekuMdA	n number bahu parsarg lekuMdA 
*kotlukAkuMdA/kotlukAka/kotlugAka/kotlugAkuMdA	n number bahu parsarg kAkuMdA 
*kotlumoVxalukoVni/kotlanumoVxalukoVni	n number bahu parsarg moVxalukoVni 
*kotlavEpu/kotlavepu/kotlakesi	n number bahu parsarg vEpu 
kotlapakka/kotlapakkana/kotlaprakka/*kotlaprakkana	n number bahu parsarg pakka 
kotlapakkalo/*kotlaprakkalo	n number bahu parsarg pakkalo 
kotlaloki/kotilloki/kotlaloniki/kotilloniki/*kotlalopalaki/kotlalopaliki/kotillopaliki/kotlalopalaku	n number bahu parsarg lopalaki 
kotlakiMxa/*kotlakriMxa/kotlakriMxana/kotlakiMxana	n number bahu parsarg kiMxa 
kotladuguna/*kotlakaduguna	n number bahu parsarg aduguna 
kotlakeVlla/*kotlakalla	n number bahu parsarg kalla 
kotlaveVnuka/kotlaveVnaka/*kotlaveVnakAla/kotlaveVnukAla/kotlaveVnakAwala/kotlaveVnukAwala	n number bahu parsarg veVnuka 
*kotlawaravAwa/kotlawarvAwa	n number bahu parsarg waravAwa 
kotleVxuruguMdA/*kotlakeVxuruguMdA	n number bahu parsarg eVxuruguMdA 
*kotlamaXya/kotlamaXyana/kotlamaXyalo	n number bahu parsarg maXya 
*kotlanaduma/kotlakinaduma	n number bahu parsarg naduma 
kotlabaxulugA/kotlakibaxulugA/kotlabaxulu/*kotlakibaxulu	n number bahu parsarg baxulugA 
*kotlacotlo/kotlacotulo	n number bahu parsarg cotlo 
kotlasWAnaMlo/kotlaswAnaMlo/*kotlasWAnamulo	n number bahu parsarg sWAnaMlo 
kotlanerugA/kotlakunerugA/*kotlakinerugA	n number bahu parsarg nerugA 
*kotlaprakAraM/kotlanubatti/kotlabatti/kotlanibatti	n number bahu parsarg prakAraM 
*kotlaxaggaranuMdi/kotlaxaggiranuMdi/kotlaxaggaranuMci/kotlaxaggiranuMci	n number bahu parsarg xaggaranuMdi 
*kotlavaxxanuMdi/kotlavaxxanuMci	n number bahu parsarg vaxxanuMdi 
*kotlapakkanuMdi/kotlapakkanuMci/kotlapakkalonuMdi/kotlapakkalonuMci	n number bahu parsarg pakkanuMdi 
*kotlalopalanuMdi/kotillopalanuMdi/kotlalopalanuMci/kotillopalanuMci/kotlalopalinuMdi/kotlalopalinuMci	n number bahu parsarg lopalanuMdi 
*kotlabEtanuMdi/kotlabEtanuMci/kotlabEtaniMci	n number bahu parsarg bEtanuMdi 
*kotlapEnuMdi/kotlapEnuMci/kotlapEniMci	n number bahu parsarg pEnuMdi 
kotlakiMxanuMdi/kotlakiMxanuMci/kotlakiMxaniMci/*kotlakriMxanuMdi/kotlakriMxanuMci/kotlakriMxaniMci	n number bahu parsarg kriMxanuMdi 
*kotladugunuMdi/kotladugunuMci/kotladuguniMci	n number bahu parsarg adugunuMdi 
*kotlamuMxunuMdi/kotlamuMxunuMci/kotlamuMxuniMci	n number bahu parsarg muMxunuMdi 
kotlaveVnukanuMdi/kotlaveVnakanuMdi/*kotlaveVnakAlanuMdi/kotlaveVnakAlanuMci/kotlaveVnukanuMci/kotlaveVnakanuMci/kotlaveVnakAwalanuMdi/kotlaveVnakAwalanuMci	n number bahu parsarg veVnukanuMdi 
kotleVxutinuMdi/kotlakeVxutinuMdi/kotleVxutanuMdi/*kotlakeVxutanuMdi/kotleVxutinuMci/kotlakeVxutinuMci/kotleVxutanuMci/kotlakeVxutanuMci	n number bahu parsarg eVxutinuMdi 
*kotlamaXyanuMdi/kotlamaXyanuMci/kotlamaXyaniMci/kotlamaXyalonuMdi/kotlamaXyalonuMci/kotlamaXyaloniMci	n number bahu parsarg maXyanuMdi 
*kotlanadumanuMdi/kotlanadamanuMdi/kotlanadumanuMci/kotlanadamanuMci	n number bahu parsarg nadumanuMdi 
*kotlawaravAwanuMdi/kotlawarvAwanuMdi/kotlawaravAwanuMci/kotlawarvAwanuMci	n number bahu parsarg waravAwanuMdi 
*kotlacotlonuMdi/kotlacotunuMdi/kotlacotlonuMci/kotlacotloniMci/kotlacotunuMci/kotlacotuniMci	n number bahu parsarg cotlonuMdi 
*kotlasWAnamunuMdi/kotlasWAnaMnuMdi/kotlasWAnamunuMci/kotlasWAnaMnuMci/kotlasWAnaMlonuMdi/kotlasWAnamulonuMdi/kotlasWAnaMlonuMci/kotlasWAnamulonuMci	n number bahu parsarg sWAnaMnuMdi 
*kotlayaMxu/kotlaMxu	n number bahu parsarg aMxu 
*kotlaMte/kotlaMteV	n number bahu parsarg aMte 
*kotlakaMteV/kotlakaMte/kotlakanna/kotlakannA	n number bahu parsarg kaMteV 
*kotlEna	n number bahu parsarg Ena 
*kotlapAti	n number bahu parsarg pAti 
*kotlulAMti/kotlulAti	n number bahu parsarg lAMti 
*kotlugAnI/kotlukAnI	n number bahu parsarg gAni 
*kotlugA	n number bahu parsarg gA 
