noun	
kIlu	
*kIlu	n number eka parsarg 0  case d
-	n number eka parsarg I 
-	n number eka parsarg gA 
*kIlugAdu	n number eka parsarg gAdu  case d
*kIlugawweV	n number eka parsarg gawweV  case d
*kIluvAdu	n number eka parsarg vAdu  case d
*kIlAyana	n number eka parsarg Ayana  case d
*kIluvAru	n number eka parsarg vAru  case d
*kIluxi	n number eka parsarg xi  case d
*kIluvi/kIluy	n number eka parsarg vi  case d
*kIlugAru	n number eka parsarg gAru  case d
*kIlunu	n number eka parsarg nu 
*kIluvu	n number eka parsarg vu  case d
*kIluyoVkka	n number eka parsarg yoVkka 
*kIlu	n number eka parsarg obl 
*kIluni/kIlunu	n number eka parsarg ni 
*kIluki/kIluku	n number eka parsarg ki 
*kIluwo/kIluwoda/kIluwoti/kIlwoti/kIlwo	n number eka parsarg wo 
kIlulo/kIlulona/kIllo/kIllona/*kIlulopala/kIllopala	n number eka parsarg lo 
*kIluloni/kIlloni/kIlulopali/kIllopali	n number eka parsarg loni 
*kIlumIxa	n number eka parsarg mIxa 
*kIluna	n number eka parsarg na 
kIluniMci/kIlunuMci/*kIlunuMdi	n number eka parsarg niMci 
*kIluxvArA/kIluxvAra	n number eka parsarg xvArA 
*kIluvalana/kIluvalla	n number eka parsarg valana 
*kIlunibatti	n number eka parsarg batti 
kIluce/*kIlucewa	n number eka parsarg ce 
*kIluwopAtu	n number eka parsarg wopAtu 
*kIluwokUdi/kIluwokUda/kIluwokUdA/kIluwokUdA/kIluwogUdi/kIluwogUda/kIluwogUdA/kIluwogUdA	n number eka parsarg wokUdi 
*kIlukosaM/kIlukE/kIlukosaM/kIlukosamu/kIlArWaM	n number eka parsarg kosaM 
*kIlukoVraku/kIlukoVrYaku	n number eka parsarg koVraku 
*kIlulonuMdi/kIlulonuMci/kIluloniMci/kIllonuMdi/kIllonuMci/kIlloniMci	n number eka parsarg lonuMdi 
*kIlumIxanuMdi/kIlumIxanuMci/kIlumIxaniMci	n number eka parsarg mIxanuMdi 
*kIluxAkA/kIluxAka	n number eka parsarg xAkA 
*kIluvaraku	n number eka parsarg varaku 
*kIlumIxaki/kIlumIxaku/kIlumIxiki	n number eka parsarg mIxaki 
*kIluxaggara/kIluxaggira	n number eka parsarg xaggara 
*kIluvaxxa/kIloVxxa	n number eka parsarg vaxxa 
*kIlukAda	n number eka parsarg kAda 
*kIlukeVxurugA/kIleVxurugA	n number eka parsarg keVxurugA 
*kIlumuMxu	n number eka parsarg muMxu 
*kIluguriMci/kIluniguriMci/kIlunigUrci/kIlunuguriMci/kIlunugUrci	n number eka parsarg guriMci 
kIlupE/*kIlupEna/kIlupEni	n number eka parsarg pE 
*kIlupEki	n number eka parsarg pEki 
*kIluguMdA	n number eka parsarg guMdA 
kIlulA/kIlulAga/*kIlulAgA	n number eka parsarg lA 
*kIluvale/kIluvaleV/kIlumAxiri/kIlunipoli/kIlunibolina	n number eka parsarg vale 
*kIlukimalle/kIlukimalleV	n number eka parsarg kimalle 
*kIlukUdA/kIlunikUdA/kIlunukUdA/kIlugUdA/kIlunigUdA/kIlunugUdA	n number eka parsarg kUdA 
*kIluxqRtilo/kIluxruRtilo	n number eka parsarg xqRtilo 
*kIlulekuMdA/kIlunilekuMdA/kIlulekuMda/kIluleka	n number eka parsarg lekuMdA 
*kIlukAkuMdA/kIlunikAkuMdA/kIlugAkuMda/kIlugAka	n number eka parsarg kAkuMdA 
*kIlumoVxalukoVni/kIlunimoVxalukoVni/kIlunumoVxalukoVni	n number eka parsarg moVxalukoVni 
*kIluvEpu/kIluvepu/kIlukesi	n number eka parsarg vEpu 
kIlupakka/kIluprakka/kIlupakkana/*kIluprakkana/kIlupakkani	n number eka parsarg pakka 
kIlupakkalo/*kIluprakkalo/kIlupakkalona/kIlupakkaloni	n number eka parsarg pakkalo 
kIluloki/kIluloniki/kIlloki/kIlloniki/kIlulopalaku/kIllopalaku/*kIlulopalaki/kIllopaliki/kIlulopaliki	n number eka parsarg lopalaki 
kIlukiMxa/*kIlukriMxa/kIlukriMxana/kIlukiMxana	n number eka parsarg kiMxa 
kIladuguna/*kIlukaduguna	n number eka parsarg aduguna 
kIlukeVlla/*kIlukalla	n number eka parsarg kalla 
kIluveVnuka/*kIluveVnakAla/kIluveVnakAwala/kIluveVnakana	n number eka parsarg veVnuka 
kIluwaravAwa/kIluwarvAwa/*kIluwaruvAwa/kIluwaravAwana/kIluwarvAwana/kIluwaruvAwana	n number eka parsarg waravAwa 
kIleVxuruguMdA/*kIlukeVxuruguMdA	n number eka parsarg eVxuruguMdA 
*kIlumaXya/kIlumaXyalo/kIlumaXyana	n number eka parsarg maXya 
*kIlunaduma/kIlunadumana	n number eka parsarg naduma 
kIlubaxulugA/kIlubaxulu/*kIlukibaxulu/kIlukubaxulu	n number eka parsarg baxulugA 
*kIlucotlo/kIlucotulo/kIlucotuna/kIlucota	n number eka parsarg cotlo 
*kIlusWAnaMlo/kIluswAnaMlo	n number eka parsarg sWAnaMlo 
kIlunerugA/kIlukunerugA/*kIlukinerugA	n number eka parsarg nerugA 
*kIluprakAraM/kIluprakAramu	n number eka parsarg prakAraM 
*kIluxaggaranuMdi/kIluxaggaranuMci/kIluxaggiranuMdi/kIluxaggiranuMci	n number eka parsarg xaggaranuMdi 
*kIluvaxxanuMdi/kIluvaxxanuMci/kIluvaxxaniMci	n number eka parsarg vaxxanuMdi 
*kIlupakkanuMdi/kIlupakkanuMci/kIlupakkaniMci/kIlupakkalonuMdi/kIlupakkalonuMci/kIlupakkaloniMci	n number eka parsarg pakkanuMdi 
*kIlulopalanuMdi/kIllopalanuMdi/kIlulopalanuMci/kIllopalanuMci/kIlulopalaniMci	n number eka parsarg lopalanuMdi 
*kIlubEtanuMdi/kIlubEtanuMci/kIlubEtaniMci	n number eka parsarg bEtanuMdi 
*kIlupEnuMdi/kIlupEnuMci/kIlupEniMci	n number eka parsarg pEnuMdi 
kIlukiMxanuMdi/kIlukiMxanuMci/kIlukiMxaniMci/*kIlukriMxanuMdi/kIlukriMxanuMci/kIlukriMxaniMci	n number eka parsarg kriMxanuMdi 
kIladugunuMdi/kIladugunuMci/*kIlukadugunuMdi/kIlukadugunuMci/kIlukaduguniMci	n number eka parsarg adugunuMdi 
*kIlumuMxunuMdi/kIlumuMxunuMci/kIlumuMxuniMci	n number eka parsarg muMxunuMdi 
kIluveVnukanuMdi/*kIluveVnakAlanuMdi/kIluveVnakAwalanuMdi/kIluveVnakanuMdi/kIluveVnukanuMci/kIluveVnakAlanuMci/kIluveVnakAwalanuMci/kIluveVnakanuMci	n number eka parsarg veVnukanuMdi 
kIleVxutinuMdi/kIlukeVxutinuMdi/kIlukeVxutinuMci/kIleVxutinuMci/kIleVxutanuMdi/*kIlukeVxutanuMdi/kIlukeVxutanuMci/kIleVxutanuMci	n number eka parsarg eVxutinuMdi 
*kIlumaXyanuMdi/kIlumaXyanuMci/kIlumaXyalonuMdi/kIlumaXyalonuMci	n number eka parsarg maXyanuMdi 
*kIlunadumanuMdi/kIlunadumanuMci	n number eka parsarg nadumanuMdi 
*kIluwaravAwanuMdi/kIluwarvAwanuMdi/kIluwaravAwanuMci/kIluwarvAwanuMci	n number eka parsarg waravAwanuMdi 
*kIlucotlonuMdi/kIlucotunuMdi/kIlucotlonuMci/kIlucotunuMci	n number eka parsarg cotlonuMdi 
kIlusWAnaMnuMdi/*kIlusWAnamunuMdi/kIlusWAnaMnuMci/kIlusWAnamunuMci/kIlusWAnaMlonuMdi/kIlusWAnamulonuMdi/kIlusWAnaMlonuMci/kIlusWAnamulonuMci	n number eka parsarg sWAnaMnuMdi 
kIlaMxu/kIlunaMxu/*kIluyaMxu	n number eka parsarg aMxu 
*kIlaMte/kIlaMteV	n number eka parsarg aMte 
*kIlukaMteV/kIlukaMte/kIlukannA/kIlukanna/kIlukannA/kIlukanna	n number eka parsarg kaMteV 
*kIlEna	n number eka parsarg Ena 
*kIlupAti	n number eka parsarg pAti 
*kIlulAMti/kIlulAti	n number eka parsarg lAMti 
*kIlugAnI/kIlugAni	n number eka parsarg gAni 
*kIlugA	n number eka parsarg gA 
*kIlYlYu/kIlYlu	n number bahu parsarg 0  case d
kIlYlulArA/kIlYlU/*kIlYlYU	n number bahu parsarg I  case d
-	n number bahu parsarg gA 
*kIlYlYagAdu/kIlYlagAdu	n number bahu parsarg gAdu  case d
*kIlYlYagawweV/kIlYlagawweV	n number bahu parsarg gawweV  case d
*kIlYlYavAdu/kIlYlavAdu/kIlYlodu	n number bahu parsarg vAdu  case d
*kIlYlYAyana/kIlYlAyana	n number bahu parsarg Ayana  case d
*kIlYlYavAru/kIlYlavAru/kIlYloru	n number bahu parsarg vAru  case d
*kIlYlYaxi/kIlYlaxi	n number bahu parsarg xi  case d
*kIlYlYavi/kIlYlavi/kIlYlay	n number bahu parsarg vi  case d
*kIlYlYagAru/kIlYlagAru	n number bahu parsarg gAru  case d
*kIlYlYaM/kIlYlaM/kIlYlamu	n number bahu parsarg nu  case d
*kIlYlYu/kIlYlu	n number bahu parsarg vu 
*kIlYlYayoVkka/kIlYlayoVkka	n number bahu parsarg yoVkka 
kIlYlYa/kIlYla	n number bahu parsarg obl 
*kIlYlYani/kIlYlani/kIlYlanu	n number bahu parsarg ni 
*kIlYlYaki/kIlYlaki/kIlYlaku	n number bahu parsarg ki 
*kIlYlYawo/kIlYlawo/kIlYlawoda/kIlYlawoti	n number bahu parsarg wo 
kIlYlalo/kIlYlallo/kIlYlallona/kIlYlalona/kIlYlalopala/*kIlYlYalopala	n number bahu parsarg lo 
kIlYlalloni/kIlYlaloni/*kIlYlYaloni/kIlYlalopali/kIlYlayaMxali	n number bahu parsarg loni 
*kIlYlYamIxa/kIlYlamIxa	n number bahu parsarg mIxa 
*kIlYlYana/kIlYlana	n number bahu parsarg na 
kIlYlaniMci/kIlYlanuMci/kIlYlanuMdi/*kIlYlYanuMdi	n number bahu parsarg niMci 
*kIlYlYaxvArA/kIlYlaxvArA/kIlYlaxvAra	n number bahu parsarg xvArA 
*kIlYlYavalana/kIlYlavalana/kIlYlavalla	n number bahu parsarg valana 
*kIlYlanubatti	n number bahu parsarg batti 
*kIlYlYacewa/kIlYlacewa/kIlYlace	n number bahu parsarg ce 
*kIlYlYawopAtu/kIlYlawopAtu/kIlYlawobAtu	n number bahu parsarg wopAtu 
*kIlYlYawokUdi/kIlYlawokUdi/kIlYlawogUdi/kIlYlawokUda/kIlYlawogUdA/kIlYlawokUdA	n number bahu parsarg wokUdi 
*kIlYlYakosaM/kIlYlakosaM/kIlYlakE/kIlYlArWaM	n number bahu parsarg kosaM 
*kIlYlYakoVraku/kIlYlakoVraku/kIlYlakoVrYaku	n number bahu parsarg koVraku 
*kIlYlYalonuMdi/kIlYlalonuMdi/kIlYlalonuMci/kIlYlaloniMci	n number bahu parsarg lonuMdi 
*kIlYlYamIxanuMdi/kIlYlamIxanuMdi/kIlYlamIxanuMci/kIlYlamIxaniMci	n number bahu parsarg mIxanuMdi 
*kIlYlYaxAkA/kIlYlaxAkA/kIlYlaxAka	n number bahu parsarg xAkA 
*kIlYlYavaraku/kIlYlavaraku	n number bahu parsarg varaku 
*kIlYlYamIxaki/kIlYlamIxaki/kIlYlamIxaku/kIlYlamIxiki	n number bahu parsarg mIxaki 
*kIlYlYaxaggara/kIlYlaxaggara/kIlYlaxaggira	n number bahu parsarg xaggara 
*kIlYlYavaxxa/kIlYlavaxxa/kIlYloVxxa	n number bahu parsarg vaxxa 
*kIlYlYakAda/kIlYlakAda	n number bahu parsarg kAda 
kIlYleVxurugA/*kIlYlYakeVxurugA/kIlYlakeVxurugA	n number bahu parsarg keVxurugA 
*kIlYlYamuMxu/kIlYlamuMxu	n number bahu parsarg muMxu 
*kIlYlYaguriMci/kIlYlaguriMci/kIlYlagUrci/kIlYlanuguriMci/kIlYlanigUrci	n number bahu parsarg guriMci 
kIlYlapE/kIlYlapEni/kIlYlapEna/*kIlYlYapEna	n number bahu parsarg pE 
*kIlYlYapEki/kIlYlapEki	n number bahu parsarg pEki 
*kIlYlYaguMdA/kIlYlaguMdA	n number bahu parsarg guMdA 
kIlYlalA/kIlYlalAga/kIlYlalAgA/*kIlYlYalAgA	n number bahu parsarg lA 
*kIlYlYavale/kIlYlavale/kIlYlavaleV/kIlYlamAxiri/kIlYlanupoli/kIlYlanubolina	n number bahu parsarg vale 
*kIlYlYakumalle/kIlYlakumalle/kIlYlakumalleV	n number bahu parsarg kimalle 
kIlYlanukUdA/*kIlYlYukUdA/kIlYlukUdA/kIlYlugUdA/kIlYlanugUdA	n number bahu parsarg kUdA 
*kIlYlYaxqRtilo/kIlYlaxqRtilo/kIlYlaxruRtilo	n number bahu parsarg xqRtilo 
*kIlYlYulekuMdA/kIlYlulekuMdA/kIlYlanulekuMdA/kIlYluleka	n number bahu parsarg lekuMdA 
*kIlYlYukAkuMdA/kIlYlukAkuMdA/kIlYlukAkuMda/kIlYlukAka/kIlYlugAkuMdA/kIlYlugAkuMda/kIlYlugAka	n number bahu parsarg kAkuMdA 
*kIlYlYumoVxalukoVni/kIlYlumoVxalukoVni/kIlYlanumoVxalukoVni	n number bahu parsarg moVxalukoVni 
*kIlYlYavEpu/kIlYlavEpu/kIlYlavepu/kIlYlakesi	n number bahu parsarg vEpu 
kIlYlapakka/kIlYlapakkana/kIlYlaprakka/kIlYlaprakkana/*kIlYlYaprakkana	n number bahu parsarg pakka 
kIlYlapakkalo/kIlYlaprakkalo/*kIlYlYaprakkalo	n number bahu parsarg pakkalo 
kIlYlaloki/kIlYlaloniki/*kIlYlYalopalaki/kIlYlalopalaki/kIlYlalopaliki/kIlYlalopaliki/kIlYlalopalaku	n number bahu parsarg lopalaki 
kIlYlakiMxa/*kIlYlYakriMxa/kIlYlakriMxa/kIlYlakriMxane/kIlYlakiMxane	n number bahu parsarg kiMxa 
kIlYladuguna/*kIlYlYakaduguna/kIlYlakaduguna	n number bahu parsarg aduguna 
kIlYlakeVlla/*kIlYlYakalla/kIlYlakalla	n number bahu parsarg kalla 
kIlYlaveVnuka/kIlYlaveVnaka/*kIlYlYaveVnakAla/kIlYlaveVnakAla/kIlYlaveVnukAla/kIlYlaveVnakAwala/kIlYlaveVnukAwala	n number bahu parsarg veVnuka 
kIlYlawaravAwa/kIlYlawarvAwa/kIlYlawaruvAwa/*kIlYlYawaruvAwa	n number bahu parsarg waravAwa 
kIlYleVxuruguMdA/kIlYlakeVxuruguMdA/*kIlYlYakeVxuruguMdA	n number bahu parsarg eVxuruguMdA 
*kIlYlYamaXya/kIlYlamaXya/kIlYlamaXyana/kIlYlamaXyalo	n number bahu parsarg maXya 
*kIlYlYanaduma/kIlYlanaduma/kIlYlakinaduma	n number bahu parsarg naduma 
kIlYlabaxulugA/kIlYlakibaxulugA/kIlYlabaxulu/*kIlYlYakibaxulu/kIlYlakibaxulu/kIlYlanubaxulu	n number bahu parsarg baxulugA 
*kIlYlYacotlo/kIlYlacotlo/kIlYlacotulo	n number bahu parsarg cotlo 
kIlYlasWAnaMlo/kIlYlaswAnaMlo/kIlYlasWAnamulo/*kIlYlYasWAnamulo	n number bahu parsarg sWAnaMlo 
kIlYlanerugA/kIlYlakunerugA/kIlYlakinerugA/*kIlYlYakinerugA	n number bahu parsarg nerugA 
*kIlYlYaprakAraM/kIlYlaprakAraM/kIlYlanubatti/kIlYlabatti/kIlYlanibatti	n number bahu parsarg prakAraM 
*kIlYlYaxaggaranuMdi/kIlYlaxaggaranuMdi/kIlYlaxaggiranuMdi/kIlYlaxaggaranuMci/kIlYlaxaggiranuMci	n number bahu parsarg xaggaranuMdi 
*kIlYlYavaxxanuMdi/kIlYlavaxxanuMdi/kIlYlavaxxanuMci	n number bahu parsarg vaxxanuMdi 
*kIlYlYapakkanuMdi/kIlYlapakkanuMdi/kIlYlapakkanuMci/kIlYlYapakkalonuMdi/kIlYlapakkalonuMdi/kIlYlapakkalonuMci	n number bahu parsarg pakkanuMdi 
*kIlYlYalopalanuMdi/kIlYlalopalanuMdi/kIlYlalopalanuMci/kIlYlalopalinuMdi/kIlYlalopalinuMci	n number bahu parsarg lopalanuMdi 
*kIlYlYabEtanuMdi/kIlYlabEtanuMdi/kIlYlabEtanuMci/kIlYlabEtaniMci	n number bahu parsarg bEtanuMdi 
*kIlYlYapEnuMdi/kIlYlapEnuMdi/kIlYlapEnuMci/kIlYlapEniMci	n number bahu parsarg pEnuMdi 
kIlYlYakiMxanuMdi/kIlYlakiMxanuMdi/kIlYlakiMxanuMci/kIlYlakiMxaniMci/*kIlYlYakriMxanuMdi/kIlYlakriMxanuMdi/kIlYlakriMxanuMci/kIlYlakriMxaniMci	n number bahu parsarg kriMxanuMdi 
*kIlYlYadugunuMdi/kIlYladugunuMdi/kIlYladugunuMci/kIlYladuguniMci	n number bahu parsarg adugunuMdi 
*kIlYlYamuMxunuMdi/kIlYlamuMxunuMdi/kIlYlamuMxunuMci/kIlYlamuMxuniMci	n number bahu parsarg muMxunuMdi 
kIlYlaveVnukanuMdi/kIlYlaveVnakanuMdi/kIlYlaveVnakAlanuMdi/*kIlYlYaveVnakAlanuMdi/kIlYlYaveVnakAlanuMci/kIlYlaveVnakAlanuMci/kIlYlaveVnukanuMci/kIlYlaveVnakanuMci/kIlYlaveVnakAwalanuMdi/kIlYlaveVnakAwalanuMci	n number bahu parsarg veVnukanuMdi 
kIlYleVxutinuMdi/kIlYlakeVxutinuMdi/kIlYleVxutanuMdi/kIlYlakeVxutanuMdi/*kIlYlYakeVxutanuMdi/kIlYleVxutinuMci/kIlYlakeVxutinuMci/kIlYleVxutanuMci/kIlYlakeVxutanuMci	n number bahu parsarg eVxutinuMdi 
*kIlYlYamaXyanuMdi/kIlYlamaXyanuMdi/kIlYlamaXyanuMci/kIlYlamaXyaniMci/kIlYlYamaXyalonuMdi/kIlYlamaXyalonuMdi/kIlYlamaXyalonuMci/kIlYlamaXyaloniMci	n number bahu parsarg maXyanuMdi 
*kIlYlYanadumanuMdi/kIlYlanadumanuMdi/kIlYlanadamanuMdi/kIlYlanadumanuMci/kIlYlanadumaniMci/kIlYlanadamanuMci	n number bahu parsarg nadumanuMdi 
*kIlYlYawaravAwanuMdi/kIlYlawaravAwanuMdi/kIlYlawarvAwanuMdi/kIlYlawaravAwanuMci/kIlYlawarvAwanuMci	n number bahu parsarg waravAwanuMdi 
kIlYlacotunuMdi/kIlYlacotunuMci/kIlYlacotlonuMci/kIlYlacotloniMci/kIlYlacotlonuMdi/*kIlYlYacotlonuMdi	n number bahu parsarg cotlonuMdi 
*kIlYlYasWAnamunuMdi/kIlYlasWAnamunuMdi/kIlYlasWAnaMnuMdi/kIlYlasWAnamunuMci/kIlYlasWAnaMnuMci/kIlYlasWAnaMlonuMdi/kIlYlasWAnamulonuMdi/kIlYlYasWAnamulonuMdi/kIlYlasWAnaMlonuMci/kIlYlasWAnamulonuMci/kIlYlYasWAnamulonuMci	n number bahu parsarg sWAnaMnuMdi 
*kIlYlYayaMxu/kIlYlayaMxu/kIlYlaMxu	n number bahu parsarg aMxu 
kIlYlaMte/kIlYlaMteV	n number bahu parsarg aMte 
*kIlYlYakaMteV/kIlYlakaMteV/kIlYlakaMte/kIlYlakanna/kIlYlakannA	n number bahu parsarg kaMteV 
*kIlYlYEna/kIlYlEna	n number bahu parsarg Ena 
*kIlYlYapAti/kIlYlapAti	n number bahu parsarg pAti 
*kIlYlYalAMti/kIlYlalAMti/kIlYlalAti	n number bahu parsarg lAMti 
*kIlYlYugAnI/kIlYlugAnI/kIlYlugAni	n number bahu parsarg gAni 
*kIlYlYugA/kIlYlugA	n number bahu parsarg gA 
