noun	
man?Ri	
*maniRi	n number eka parsarg 0 
-	n number eka parsarg I 
-	n number eka parsarg gA 
*maniRigAdu	n number eka parsarg gAdu 
*maniRigawweV	n number eka parsarg gawweV 
*maniRivAdu	n number eka parsarg vAdu 
*maniRAyana	n number eka parsarg Ayana 
*maniRivAru	n number eka parsarg vAru 
*maniRixi	n number eka parsarg xi 
*maniRivi/maniRiy	n number eka parsarg vi 
*maniRigAru	n number eka parsarg gAru 
*maniRini	n number eka parsarg nu 
*maniRivi	n number eka parsarg vu 
*maniRiyoVkka	n number eka parsarg yoVkka 
*maniRi	n number eka parsarg obl 
*maniRini/maniRinu	n number eka parsarg ni 
*maniRiki/maniRiku	n number eka parsarg ki 
*maniRiwo/maniRiwoda/maniRiwoti	n number eka parsarg wo 
maniRilo/maniRilona/*maniRilopala	n number eka parsarg lo 
maniRiloni/*maniRilopali/maniRiyaMxali	n number eka parsarg loni 
*maniRimIxa	n number eka parsarg mIxa 
*maniRina	n number eka parsarg na 
maniRiniMci/maniRinuMci/*maniRinuMdi	n number eka parsarg niMci 
*maniRixvArA/maniRixvAra	n number eka parsarg xvArA 
*maniRivalana/maniRivalla	n number eka parsarg valana 
*maniRinibatti	n number eka parsarg batti 
maniRice/*maniRicewa	n number eka parsarg ce 
*maniRiwopAtu	n number eka parsarg wopAtu 
*maniRiwokUdi/maniRiwokUda/maniRiwokUdA	n number eka parsarg wokUdi 
*maniRikosaM/maniRikE/maniRArWaM	n number eka parsarg kosaM 
*maniRikoVraku/maniRikoVrYaku	n number eka parsarg koVraku 
*maniRilonuMdi/maniRilonuMci/maniRiloniMci	n number eka parsarg lonuMdi 
*maniRimIxanuMdi/maniRimIxanuMci/maniRimIxaniMci	n number eka parsarg mIxanuMdi 
*maniRixAkA/maniRixAka	n number eka parsarg xAkA 
*maniRivaraku	n number eka parsarg varaku 
*maniRimIxaki/maniRimIxaku/maniRimIxiki	n number eka parsarg mIxaki 
*maniRixaggara/maniRixaggira	n number eka parsarg xaggara 
*maniRivaxxa/maniRoVxxa	n number eka parsarg vaxxa 
*maniRikAda	n number eka parsarg kAda 
*maniRikeVxurugA/maniReVxurugA	n number eka parsarg keVxurugA 
*maniRimuMxu	n number eka parsarg muMxu 
*maniRiguriMci/maniRiniguriMci/maniRinugUrci	n number eka parsarg guriMci 
maniRipE/*maniRipEna/maniRipEni	n number eka parsarg pE 
*maniRipEki	n number eka parsarg pEki 
*maniRiguMdA	n number eka parsarg guMdA 
maniRilA/maniRilAga/*maniRilAgA	n number eka parsarg lA 
*maniRivale/maniRimAxiri/maniRinipoli/maniRinuboli	n number eka parsarg vale 
*maniRikimalle/maniRikimalleV	n number eka parsarg kimalle 
*maniRikUdA/maniRinikUdA/maniRinukUdA	n number eka parsarg kUdA 
*maniRixqRtilo/maniRixruRtilo	n number eka parsarg xqRtilo 
*maniRilekuMdA/maniRinilekuMdA/maniRileka	n number eka parsarg lekuMdA 
*maniRikAkuMdA/maniRinikAkuMdA/maniRikAka/maniRigAka	n number eka parsarg kAkuMdA 
*maniRimoVxalukoVni/maniRinimoVxalukoVni/maniRinumoVxalukoVni	n number eka parsarg moVxalukoVni 
*maniRivEpu/maniRivepu/maniRikesi	n number eka parsarg vEpu 
maniRipakka/maniRiprakka/maniRipakkana/*maniRiprakkana/maniRipakkani	n number eka parsarg pakka 
maniRipakkalo/*maniRiprakkalo/maniRipakkalona/maniRipakkaloni	n number eka parsarg pakkalo 
maniRiloki/maniRiloniki/*maniRilopalaki/maniRilopalaku/maniRilopaliki	n number eka parsarg lopalaki 
maniRikiMxa/*maniRikriMxa/maniRikriMxana/maniRikiMxana	n number eka parsarg kiMxa 
maniRaduguna/*maniRikaduguna	n number eka parsarg aduguna 
maniRikeVlla/*maniRikalla	n number eka parsarg kalla 
maniRiveVnuka/*maniRiveVnakAla/maniRiveVnakAwala/maniRiveVnakana	n number eka parsarg veVnuka 
maniRiwaravAwa/maniRiwarvAwa/*maniRiwaruvAwa/maniRiwaravAwana/maniRiwarvAwana/maniRiwaruvAwana	n number eka parsarg waravAwa 
maniReVxuruguMdA/*maniRikeVxuruguMdA	n number eka parsarg eVxuruguMdA 
*maniRimaXya/maniRimaXyalo/maniRimaXyana	n number eka parsarg maXya 
*maniRinaduma/maniRinadumana	n number eka parsarg naduma 
maniRibaxulugA/maniRibaxulu/*maniRikibaxulu/maniRikubaxulu	n number eka parsarg baxulugA 
*maniRicotlo/maniRicotulo/maniRicotuna/maniRicota	n number eka parsarg cotlo 
*maniRisWAnaMlo/maniRiswAnaMlo	n number eka parsarg sWAnaMlo 
maniRinerugA/maniRikunerugA/*maniRikinerugA	n number eka parsarg nerugA 
*maniRiprakAraM/maniRiprakAramu	n number eka parsarg prakAraM 
*maniRixaggaranuMdi/maniRixaggaranuMci/maniRixaggiranuMdi/maniRixaggiranuMci	n number eka parsarg xaggaranuMdi 
*maniRivaxxanuMdi/maniRivaxxanuMci/maniRivaxxaniMci	n number eka parsarg vaxxanuMdi 
*maniRipakkanuMdi/maniRipakkanuMci/maniRipakkaniMci/maniRipakkalonuMdi/maniRipakkalonuMci/maniRipakkaloniMci	n number eka parsarg pakkanuMdi 
*maniRilopalanuMdi/maniRilopalanuMci/maniRilopalaniMci	n number eka parsarg lopalanuMdi 
*maniRibEtanuMdi/maniRibEtanuMci/maniRibEtaniMci	n number eka parsarg bEtanuMdi 
*maniRipEnuMdi/maniRipEnuMci/maniRipEniMci	n number eka parsarg pEnuMdi 
maniRikiMxanuMdi/maniRikiMxanuMci/maniRikiMxaniMci/*maniRikriMxanuMdi/maniRikriMxanuMci/maniRikriMxaniMci	n number eka parsarg kriMxanuMdi 
maniRadugunuMdi/maniRadugunuMci/*maniRikadugunuMdi/maniRikadugunuMci/maniRikaduguniMci	n number eka parsarg adugunuMdi 
*maniRimuMxunuMdi/maniRimuMxunuMci/maniRimuMxuniMci	n number eka parsarg muMxunuMdi 
maniRiveVnukanuMdi/*maniRiveVnakAlanuMdi/maniRiveVnakAwalanuMdi/maniRiveVnakanuMdi/maniRiveVnukanuMci/maniRiveVnakAlanuMci/maniRiveVnakAwalanuMci/maniRiveVnakanuMci	n number eka parsarg veVnukanuMdi 
maniReVxutinuMdi/maniRikeVxutinuMdi/maniRikeVxutinuMci/maniReVxutinuMci/maniReVxutanuMdi/*maniRikeVxutanuMdi/maniRikeVxutanuMci/maniReVxutanuMci	n number eka parsarg eVxutinuMdi 
*maniRimaXyanuMdi/maniRimaXyanuMci/maniRimaXyalonuMdi/maniRimaXyalonuMci	n number eka parsarg maXyanuMdi 
*maniRinadumanuMdi/maniRinadumanuMci	n number eka parsarg nadumanuMdi 
*maniRiwaravAwanuMdi/maniRiwarvAwanuMdi/maniRiwaravAwanuMci/maniRiwarvAwanuMci	n number eka parsarg waravAwanuMdi 
*maniRicotlonuMdi/maniRicotunuMdi/maniRicotlonuMci/maniRicotunuMci	n number eka parsarg cotlonuMdi 
maniRisWAnaMnuMdi/*maniRisWAnamunuMdi/maniRisWAnaMnuMci/maniRisWAnamunuMci/maniRisWAnaMlonuMdi/maniRisWAnamulonuMdi/maniRisWAnaMlonuMci/maniRiswAnamulonuMci	n number eka parsarg sWAnaMnuMdi 
maniRaMxu/maniRinaMxu/*maniRiyaMxu	n number eka parsarg aMxu 
*maniRaMte/maniRaMteV	n number eka parsarg aMte 
*maniRikaMteV/maniRikaMte/maniRikanna/maniRikannA	n number eka parsarg kaMteV 
*maniREna/maniRayina	n number eka parsarg Ena 
*maniRipAti	n number eka parsarg pAti 
*maniRilAMti/maniRilAti/maniRivaMti	n number eka parsarg lAMti 
*maniRigAnI/maniRikAnI	n number eka parsarg gAni 
*maniRigA	n number eka parsarg gA 
*manuRulu	n number bahu parsarg 0 
*manuRulU/manuRulArA	n number bahu parsarg I 
-	n number bahu parsarg gA 
*manuRulagAdu	n number bahu parsarg gAdu 
*manuRulagawweV	n number bahu parsarg gawweV 
*manuRulavAdu/manuRulodu	n number bahu parsarg vAdu 
*manuRulAyana	n number bahu parsarg Ayana 
*manuRulavAru/manuRuloru	n number bahu parsarg vAru 
*manuRulaxi/manuRulxi	n number bahu parsarg xi 
*manuRulavi/manuRuliy	n number bahu parsarg vi 
*manuRulagAru	n number bahu parsarg gAru 
*manuRulaM/manuRulamu	n number bahu parsarg nu 
*manuRulu	n number bahu parsarg vu 
*manuRulayoVkka	n number bahu parsarg yoVkka 
*manuRula	n number bahu parsarg obl 
*manuRulani/manuRulni/manuRulanu/manuRulnu	n number bahu parsarg ni 
*manuRulaki/manuRulaku	n number bahu parsarg ki 
*manuRulawo/manuRulwo/manuRulawoda/manuRulawoti/manuRulwoti/manuRulwoda	n number bahu parsarg wo 
manuRulalo/manuRullo/manuRulalona/manuRullona/manuRullopala/*manuRulalopala	n number bahu parsarg lo 
*manuRulaloni/manuRulayaMxali/manuRulloni/manuRullopali/manuRulalopali	n number bahu parsarg loni 
*manuRulamIxa	n number bahu parsarg mIxa 
*manuRulana	n number bahu parsarg na 
manuRulaniMci/manuRulniMci/manuRulanuMci/manuRulnuMci/*manuRulanuMdi/manuRulnuMdi	n number bahu parsarg niMci 
*manuRulaxvArA/manuRulaxvAra	n number bahu parsarg xvArA 
*manuRulavalana/manuRulavalla	n number bahu parsarg valana 
*manuRulanubatti/manuRulnibatti	n number bahu parsarg batti 
*manuRulacewa/manuRulcewa/manuRulace/manuRulce	n number bahu parsarg ce 
*manuRulawopAtu/manuRulwopAtu	n number bahu parsarg wopAtu 
*manuRulawokUdi/manuRulwokUdi/manuRulawokUda/manuRulawokUdA/manuRulwokUdA	n number bahu parsarg wokUdi 
*manuRulakosaM/manuRulakE/manuRulArWaM	n number bahu parsarg kosaM 
*manuRulakoVraku/manuRulakoVrYaku	n number bahu parsarg koVraku 
*manuRulalonuMdi/manuRulalonuMci/manuRullonuMdi/manuRullonuMci/manuRulloniMci/manuRulaloniMci	n number bahu parsarg lonuMdi 
*manuRulamIxanuMdi/manuRulamIxanuMci/manuRulamIxaniMci	n number bahu parsarg mIxanuMdi 
*manuRulaxAkA/manuRulaxAka	n number bahu parsarg xAkA 
*manuRulavaraku	n number bahu parsarg varaku 
*manuRulamIxaki/manuRulamIxaku/manuRulamIxiki	n number bahu parsarg mIxaki 
*manuRulaxaggara/manuRulaxaggira	n number bahu parsarg xaggara 
*manuRulavaxxa/manuRuloVxxa	n number bahu parsarg vaxxa 
*manuRulakAda	n number bahu parsarg kAda 
manuRuleVxurugA/*manuRulakeVxurugA	n number bahu parsarg keVxurugA 
*manuRulamuMxu	n number bahu parsarg muMxu 
*manuRulaguriMci/manuRulagUrci/manuRulanuguriMci/manuRulanigUrci	n number bahu parsarg guriMci 
manuRulapE/manuRulapEni/*manuRulapEna	n number bahu parsarg pE 
*manuRulapEki	n number bahu parsarg pEki 
*manuRulaguMdA	n number bahu parsarg guMdA 
manuRulalA/manuRullA/manuRulalAga/manuRullAga/*manuRullAgA	n number bahu parsarg lA 
*manuRulavale/manuRulavaleV/manuRulamAxiri/manuRulanupolina/manuRulanubolina	n number bahu parsarg vale 
*manuRulakumalle/manuRulakumalleV	n number bahu parsarg kimalle 
*manuRulukUdA/manuRulugUdA	n number bahu parsarg kUdA 
*manuRulaxqRtilo/manuRulaxruRtilo	n number bahu parsarg xqRtilo 
*manuRululekuMdA/manuRullekuMdA/manuRululeka	n number bahu parsarg lekuMdA 
*manuRulukAkuMdA/manuRulukAkuMda/manuRulukAka/manuRulugAka	n number bahu parsarg kAkuMdA 
*manuRulumoVxalukoVni/manuRulanumoVxalukoVni	n number bahu parsarg moVxalukoVni 
*manuRulavEpu/manuRulavepu/manuRulakesi	n number bahu parsarg vEpu 
manuRulapakka/manuRulapakkana/manuRulaprakka/*manuRulaprakkana	n number bahu parsarg pakka 
manuRulapakkalo/*manuRulaprakkalo	n number bahu parsarg pakkalo 
manuRulaloki/manuRulaloniki/manuRulloki/manuRullaniki/*manuRulalopalaki/manuRulalopaliki/manuRullopaliki/manuRullopalaku	n number bahu parsarg lopalaki 
manuRulakiMxa/*manuRulakriMxa/manuRulakriMxana/manuRulakiMxana	n number bahu parsarg kiMxa 
manuRuladuguna/*manuRulakaduguna	n number bahu parsarg aduguna 
manuRulakeVlla/*manuRulakalla	n number bahu parsarg kalla 
manuRulaveVnuka/manuRulaveVnaka/*manuRulaveVnakAla/manuRulaveVnukAla/manuRulaveVnakAwala/manuRulaveVnukAwala	n number bahu parsarg veVnuka 
*manuRulawaravAwa/manuRulawarvAwa/manuRulwaravAwa	n number bahu parsarg waravAwa 
manuRuleVxuruguMdA/*manuRulakeVxuruguMdA	n number bahu parsarg eVxuruguMdA 
*manuRulamaXya/manuRulamaXyana/manuRulamaXyalo	n number bahu parsarg maXya 
*manuRulanaduma/manuRulakinaduma	n number bahu parsarg naduma 
manuRulabaxulugA/manuRulakibaxulugA/manuRulabaxulu/*manuRulakibaxulu	n number bahu parsarg baxulugA 
*manuRulacotlo/manuRulacotulo	n number bahu parsarg cotlo 
manuRulasWAnaMlo/manuRulaswAnaMlo/*manuRulasWAnamulo	n number bahu parsarg sWAnaMlo 
manuRulanerugA/manuRulakunerugA/*manuRulakinerugA	n number bahu parsarg nerugA 
*manuRulaprakAraM/manuRulanubatti/manuRulabatti/manuRulanibatti	n number bahu parsarg prakAraM 
*manuRulaxaggaranuMdi/manuRulaxaggiranuMdi/manuRulaxaggaranuMci/manuRulaxaggiranuMci	n number bahu parsarg xaggaranuMdi 
*manuRulavaxxanuMdi/manuRulavaxxanuMci	n number bahu parsarg vaxxanuMdi 
*manuRulapakkanuMdi/manuRulapakkanuMci/manuRulapakkalonuMdi/manuRulapakkalonuMci	n number bahu parsarg pakkanuMdi 
manuRulalopalanuMdi/*manuRullopalanuMdi/manuRulalopalanuMci/manuRullopalanuMci/manuRullopalinuMdi/manuRulalopalinuMci	n number bahu parsarg lopalanuMdi 
*manuRulabEtanuMdi/manuRulabEtanuMci/manuRulabEtaniMci	n number bahu parsarg bEtanuMdi 
*manuRulapEnuMdi/manuRulapEnuMci/manuRulapEniMci	n number bahu parsarg pEnuMdi 
manuRulakiMxanuMdi/manuRulakiMxanuMci/manuRulakiMxaniMci/*manuRulakriMxanuMdi/manuRulakriMxanuMci/manuRulakriMxaniMci	n number bahu parsarg kriMxanuMdi 
*manuRuladugunuMdi/manuRuladugunuMci/manuRuladuguniMci	n number bahu parsarg adugunuMdi 
*manuRulamuMxunuMdi/manuRulamuMxunuMci/manuRulamuMxuniMci	n number bahu parsarg muMxunuMdi 
manuRulaveVnukanuMdi/manuRulaveVnakanuMdi/*manuRulaveVnakAlanuMdi/manuRulaveVnakAlanuMci/manuRulaveVnukanuMci/manuRulaveVnakanuMci/manuRulaveVnakAwalanuMdi/manuRulaveVnakAwalanuMci	n number bahu parsarg veVnukanuMdi 
manuRuleVxutinuMdi/manuRulakeVxutinuMdi/manuRuleVxutanuMdi/*manuRulakeVxutanuMdi/manuRuleVxutinuMci/manuRulakeVxutinuMci/manuRuleVxutanuMci/manuRulakeVxutanuMci	n number bahu parsarg eVxutinuMdi 
*manuRulamaXyanuMdi/manuRulamaXyanuMci/manuRulamaXyaniMci/manuRulamaXyalonuMdi/manuRulamaXyalonuMci/manuRulamaXyaloniMci	n number bahu parsarg maXyanuMdi 
*manuRulanadumanuMdi/manuRulanadamanuMdi/manuRulanadumanuMci/manuRulanadamanuMci	n number bahu parsarg nadumanuMdi 
*manuRulawaravAwanuMdi/manuRulawarvAwanuMdi/manuRulawaravAwanuMci/manuRulawarvAwanuMci	n number bahu parsarg waravAwanuMdi 
manuRulacotunuMci/manuRulacotunuMdi/manuRulacotlonuMci/manuRulacotloniMci/*manuRulacotlonuMdi/manuRulacotulonuMdi	n number bahu parsarg cotlonuMdi 
*manuRulasWAnamunuMdi/manuRulasWAnaMnuMdi/manuRulasWAnamunuMci/manuRulasWAnaMnuMci/manuRulasWAnaMlonuMdi/manuRulasWAnamulonuMdi/manuRulasWAnaMlonuMci/manuRulasWAnamulonuMci	n number bahu parsarg sWAnaMnuMdi 
*manuRulayaMxu/manuRulaMxu	n number bahu parsarg aMxu 
*manuRulaMte/manuRulaMteV	n number bahu parsarg aMte 
*manuRulakaMteV/manuRulakaMte/manuRalakanna/manuRulakannA	n number bahu parsarg kaMteV 
*manuRulEna/manuRulayina	n number bahu parsarg Ena 
*manuRulapAti	n number bahu parsarg pAti 
*manuRululAMti/manuRulalAti/manuRulavaMti	n number bahu parsarg lAMti 
*manuRulugAnI/manuRulukAnI	n number bahu parsarg gAni 
*manuRulugA	n number bahu parsarg gA 
