noun	
meVxadu	
*meVxadu	n number eka parsarg 0 
-	n number eka parsarg I 
-	n number eka parsarg gA 
*meVxadugAdu	n number eka parsarg gAdu 
*meVxadugawweV	n number eka parsarg gawweV 
*meVxaduvAdu	n number eka parsarg vAdu 
*meVxadAyana	n number eka parsarg Ayana 
*meVxaduvAru	n number eka parsarg vAru 
*meVxaduxi	n number eka parsarg xi 
*meVxaduvi/meVxadiy	n number eka parsarg vi 
*meVxadugAru	n number eka parsarg gAru 
meVxadunu/*meVxaduni	n number eka parsarg nu 
meVxaduvu/*meVxaduvi/meVxadavu	n number eka parsarg vu 
*meVxaduyoVkka	n number eka parsarg yoVkka 
*meVxadu	n number eka parsarg obl 
*meVxaduni	n number eka parsarg ni 
*meVxaduki/meVxaduku	n number eka parsarg ki 
*meVxaduwo/meVxaduwoda/meVxaduwoti	n number eka parsarg wo 
meVxadulo/meVxadulona/*meVxadulopala	n number eka parsarg lo 
*meVxaduloni/meVxadulopali/meVxadunaMxali	n number eka parsarg loni 
*meVxadumIxa	n number eka parsarg mIxa 
*meVxaduna	n number eka parsarg na 
meVxaduniMci/meVxadunuMci/*meVxadunuMdi	n number eka parsarg niMci 
*meVxaduxvArA/meVxaduxvAra	n number eka parsarg xvArA 
*meVxaduvalana/meVxaduvalla	n number eka parsarg valana 
*meVxadunubatti/meVxadunibatti/meVxadnibatti	n number eka parsarg batti 
meVxaduce/*meVxaducewa	n number eka parsarg ce 
*meVxaduwopAtu/meVxaduwobAtu	n number eka parsarg wopAtu 
*meVxaduwokUdi/meVxaduwokUda/meVxaduwokUdA/meVxaduwomeVxada/meVxaduwomeVxadA	n number eka parsarg wokUdi 
*meVxadukosaM/meVxadukE/meVxadArWaM	n number eka parsarg kosaM 
*meVxadukoVraku/meVxadukoVrYaku	n number eka parsarg koVraku 
*meVxadulonuMdi/meVxadulonuMci/meVxadlonuMdi/meVxadlonuMci	n number eka parsarg lonuMdi 
*meVxadumIxanuMdi/meVxadumIxanuMci	n number eka parsarg mIxanuMdi 
*meVxaduxAkA/meVxaduxAka	n number eka parsarg xAkA 
*meVxaduvaraku	n number eka parsarg varaku 
*meVxadumIxaki/meVxadumIxaku	n number eka parsarg mIxaki 
*meVxaduxaggara/meVxaduxaggira	n number eka parsarg xaggara 
*meVxaduvaxxa	n number eka parsarg vaxxa 
*meVxadukAda	n number eka parsarg kAda 
*meVxadukeVxurugA/meVxadeVxurugA	n number eka parsarg keVxurugA 
*meVxadumuMxu	n number eka parsarg muMxu 
*meVxaduguriMci/meVxaduniguriMci/meVxadunigUrci	n number eka parsarg guriMci 
meVxadupE/*meVxadupEna/meVxadupEni	n number eka parsarg pE 
*meVxadupEki	n number eka parsarg pEki 
*meVxaduguMdA	n number eka parsarg guMdA 
meVxadulA/meVxadulAga/*meVxadulAgA	n number eka parsarg lA 
*meVxaduvale/meVxadumAxiri/meVxadunipoli/meVxaduvaleV/meVxadunibolina	n number eka parsarg vale 
*meVxadukimalle	n number eka parsarg kimalle 
*meVxadukUdA/meVxadunikUdA/meVxadumeVxadA/meVxadunimeVxadA	n number eka parsarg kUdA 
*meVxaduxqRtilo/meVxaduxruRtilo	n number eka parsarg xqRtilo 
*meVxadulekuMdA/meVxaduleka	n number eka parsarg lekuMdA 
*meVxadukAkuMdA/meVxadukAka/meVxadugAka	n number eka parsarg kAkuMdA 
*meVxadumoVxalukoVni/meVxadunimoVxalukoVni	n number eka parsarg moVxalukoVni 
*meVxaduvEpu/meVxaduvepu/meVxaduvepu	n number eka parsarg vEpu 
meVxadupakka/*meVxaduprakka/meVxadupakkana	n number eka parsarg pakka 
meVxadupakkalo/*meVxaduprakkalo	n number eka parsarg pakkalo 
meVxaduloki/meVxaduloniki/*meVxadulopalaki/meVxadulopalaku/meVxadulopaliki	n number eka parsarg lopalaki 
meVxadukiMxa/*meVxadukriMxa/meVxadukriMxane/meVxadukiMxane	n number eka parsarg kiMxa 
meVxadaduguna/*meVxadukaduguna	n number eka parsarg aduguna 
meVxadukeVlla/*meVxadukalla	n number eka parsarg kalla 
meVxaduveVnuka/*meVxaduveVnakAla/meVxaduveVnakAwala	n number eka parsarg veVnuka 
meVxaduwaravAwa/meVxaduwarvAwa/*meVxaduwaruvAwa	n number eka parsarg waravAwa 
meVxadeVxuruguMdA/*meVxadukeVxuruguMdA	n number eka parsarg eVxuruguMdA 
meVxadumaXya/*meVxadumaXyalo/meVxadumaXyana	n number eka parsarg maXya 
*meVxadunaduma/meVxadunadama	n number eka parsarg naduma 
meVxadubaxulugA/meVxadubaxulu/*meVxadukibaxulu/meVxadunibaxulu	n number eka parsarg baxulugA 
*meVxaducotlo/meVxaducotulo/meVxaducotuna	n number eka parsarg cotlo 
meVxadusWAnaMlo/*meVxadusWAnamulo	n number eka parsarg sWAnaMlo 
meVxadunerugA/meVxadukunerugA/*meVxadukinerugA	n number eka parsarg nerugA 
*meVxaduprakAraM/meVxaduprakAramu	n number eka parsarg prakAraM 
*meVxaduxaggaranuMdi/meVxaduxaggaranuMci/meVxaduxaggiranuMdi/meVxaduxaggiranuMci	n number eka parsarg xaggaranuMdi 
*meVxaduvaxxanuMdi/meVxaduvaxxanuMci	n number eka parsarg vaxxanuMdi 
*meVxadupakkanuMdi/meVxadupakkanuMci/meVxadupakkalonuMdi/meVxadupakkalonuMci	n number eka parsarg pakkanuMdi 
*meVxadulopalanuMdi/meVxadulopalanuMci/meVxadulopalinuMci/meVxadulopalinuMdi	n number eka parsarg lopalanuMdi 
*meVxadubEtanuMdi/meVxadubEtanuMci	n number eka parsarg bEtanuMdi 
*meVxadupEnuMdi/meVxadupEnuMci	n number eka parsarg pEnuMdi 
meVxadukiMxanuMdi/meVxadukiMxanuMci/*meVxadukriMxanuMdi/meVxadukriMxanuMci	n number eka parsarg kriMxanuMdi 
meVxadadugunuMdi/meVxadadugunuMci/*meVxadukadugunuMdi/meVxadukadugunuMci	n number eka parsarg adugunuMdi 
*meVxadumuMxunuMdi/meVxadumuMxunuMci	n number eka parsarg muMxunuMdi 
meVxaduveVnukanuMdi/*meVxaduveVnakAlanuMdi/meVxaduveVnakAwalanuMdi/meVxaduveVnakanuMdi/meVxaduveVnukanuMci/meVxaduveVnakAlanuMci/meVxaduveVnakAwalanuMci/meVxaduveVnakanuMci	n number eka parsarg veVnukanuMdi 
meVxadeVxutinuMdi/meVxadeVxutanuMdi/*meVxadukeVxutinuMdi/meVxadeVxutinuMci/meVxadeVxutanuMci/meVxadukeVxutinuMci	n number eka parsarg eVxutinuMdi 
*meVxadumaXyanuMdi/meVxadumaXyanuMci/meVxadumaXyalonuMdi/meVxadumaXyalonuMci	n number eka parsarg maXyanuMdi 
*meVxadunadumanuMdi/meVxadunadumanuMci	n number eka parsarg nadumanuMdi 
*meVxaduwaravAwanuMdi/meVxaduwarvAwanuMdi/meVxaduwaravAwanuMci/meVxaduwarvAwanuMci	n number eka parsarg waravAwanuMdi 
*meVxaducotlonuMdi/meVxaducotunuMdi/meVxaducotlonuMci/meVxaducotunuMci	n number eka parsarg cotlonuMdi 
*meVxadusWAnamunuMdi/meVxadusWAnaMnuMdi/meVxadusWAnaMnuMdi/meVxadusWAnamunuMci/meVxadusWAnaMnuMci/meVxadusWAnaMlonuMdi/meVxadusWAnamulonuMdi/meVxadusWAnaMlonuMci/meVxaduswAnamulonuMci	n number eka parsarg sWAnaMnuMdi 
meVxadaMxu/meVxadunaMxu/*meVxaduyaMxu	n number eka parsarg aMxu 
*meVxadaMte/meVxadaMteV	n number eka parsarg aMte 
*meVxadukaMteV/meVxadukaMte/meVxadukanna/meVxadukannA	n number eka parsarg kaMteV 
*meVxadEna	n number eka parsarg Ena 
*meVxadupAti	n number eka parsarg pAti 
*meVxadulAMti/meVxadulAti	n number eka parsarg lAMti 
*meVxadugAnI/meVxadukAnI	n number eka parsarg gAni 
*meVxadugA	n number eka parsarg gA 
*meVxalYlYu/meVxalYlu	n number bahu parsarg 0 
*meVxalYlYU/meVxalYlU/meVxalYlulArA/meVxalYlArA/meVxadlU/meVxadlulArA/meVxadlArA	n number bahu parsarg I 
-	n number bahu parsarg gA 
*meVxalYlYagAdu/meVxalYlagAdu/meVxalYlugAdu	n number bahu parsarg gAdu 
*meVxalYlagawweV/meVxalYlagawweV/meVxalYlugawweV	n number bahu parsarg gawweV 
*meVxalYlYavAdu/meVxalYlavAdu/meVxadlavAdu	n number bahu parsarg vAdu 
*meVxalYlYAyana/meVxalYlAyana/meVxadlAyana	n number bahu parsarg Ayana 
*meVxalYlavAru/meVxalYlavAru/meVxadlavAru	n number bahu parsarg vAru 
*meVxalYlYaxi/meVxalYlaxi/meVxadlaxi	n number bahu parsarg xi 
*meVxalYlYavi/meVxalYlavi/meVxadlavi	n number bahu parsarg vi 
*meVxalYlYagAru/meVxalYlagAru/meVxadlagAru	n number bahu parsarg gAru 
*meVxalYlYaM/meVxalYlaM/meVxalYlamu/meVxadlaM/meVxadlamu	n number bahu parsarg nu 
*meVxalYlYu/meVxalYlu/meVxadlu	n number bahu parsarg vu 
*meVxalYlYayoVkka/meVxalYlayoVkka/meVxadlayoVkka	n number bahu parsarg yoVkka 
*meVxalYlYa/meVxalYla/meVxadla	n number bahu parsarg obl 
*meVxalYlYani/meVxalYlani/meVxalYlanu/meVxadlanu/meVxadlani	n number bahu parsarg ni 
*meVxalYlYaki/meVxalYlaki/meVxadlaki/meVxalYlaku/meVxadlaku	n number bahu parsarg ki 
*meVxalYlYawo/meVxalYlawo/meVxadlawo/meVxalYlawoda/meVxadlawoda/meVxadlawo/meVxadlawoda	n number bahu parsarg wo 
meVxalYlallo/meVxadlallo/meVxalYlalo/meVxadlalo/meVxalYlalona/meVxadlalona/*meVxalYlYalopala/meVxalYlalopala/meVxadlalopala	n number bahu parsarg lo 
*meVxalYlYaloni/meVxalYlaloni/meVxadlaloni/meVxalYlalopali/meVxadlayaMxali/meVxadlalopali	n number bahu parsarg loni 
*meVxalYlYamIxa/meVxalYlamIxa/meVxadlamIxa	n number bahu parsarg mIxa 
*meVxalYlYana/meVxalYlana/meVxadlana	n number bahu parsarg na 
meVxalYlaniMci/meVxadlaniMci/meVxalYlanuMci/meVxadlanuMci/*meVxalYlYanuMdi/meVxalYlanuMdi/meVxadlanuMdi	n number bahu parsarg niMci 
*meVxalYlYaxvArA/meVxalYlaxvArA/meVxadlaxvArA	n number bahu parsarg xvArA 
*meVxalYlYavalana/meVxalYlavalana/meVxalYlavalla/meVxadlavalana/meVxadlavalla	n number bahu parsarg valana 
*meVxalYlYanubatti/meVxalYlanubatti/meVxadlanubatti	n number bahu parsarg batti 
*meVxalYlYacewa/meVxalYlacewa/meVxadlacewa/meVxalYlace/meVxadlace	n number bahu parsarg ce 
*meVxalYlYawopAtu/meVxalYlawopAtu/meVxadlawopAtu	n number bahu parsarg wopAtu 
*meVxalYlYawokUdi/meVxalYlawokUdi/meVxadlawokUdi/meVxalYlawokUda/meVxadlawokUda/meVxalYlawokUdA/meVxadlawokUdA	n number bahu parsarg wokUdi 
*meVxalYlYakosaM/meVxalYlakosaM/meVxadlakosaM/meVxalYlakE/meVxadlakE/meVxalYlArWaM	n number bahu parsarg kosaM 
*meVxalYlYakoVraku/meVxalYlakoVraku/meVxadlakoVraku/meVxalYlakoVrYaku/meVxadlakoVrYaku	n number bahu parsarg koVraku 
*meVxalYlYalonuMdi/meVxalYlalonuMdi/meVxalYlalonuMci/meVxadlalonuMdi/meVxadlalonuMci/meVxalYlaloniMci/meVxadlaloniMci	n number bahu parsarg lonuMdi 
*meVxalYlYamIxanuMdi/meVxalYlamIxanuMdi/meVxadlamIxanuMdi/meVxalYlamIxanuMci/meVxadlamIxanuMci	n number bahu parsarg mIxanuMdi 
*meVxalYlYaxAkA/meVxalYlaxAkA/meVxadlaxAkA	n number bahu parsarg xAkA 
*meVxalYlYavaraku/meVxalYlavaraku/meVxadlavaraku	n number bahu parsarg varaku 
*meVxalYlYamIxaki/meVxalYlamIxaki/meVxadlamIxaki/meVxalYlamIxaku/meVxadlamIxaku	n number bahu parsarg mIxaki 
*meVxalYlYaxaggara/meVxalYlaxaggara/meVxadlaxaggara/meVxadlaxaggira/meVxalYlaxaggira	n number bahu parsarg xaggara 
*meVxalYlYavaxxa/meVxalYlavaxxa/meVxadlavaxxa	n number bahu parsarg vaxxa 
*meVxalYlYakAda/meVxalYlakAda/meVxadlakAda	n number bahu parsarg kAda 
meVxalYleVxurugA/meVxadleVxurugA/*meVxalYlYakeVxurugA/meVxalYlakeVxurugA/meVxadlakeVxurugA	n number bahu parsarg keVxurugA 
*meVxalYlYamuMxu/meVxalYlamuMxu/meVxadlamuMxu	n number bahu parsarg muMxu 
*meVxalYlYaguriMci/meVxalYlaguriMci/meVxalYlagUrci/meVxalYlanuguriMci/meVxalYlanigUrci	n number bahu parsarg guriMci 
meVxalYlapE/meVxalYlapEni/meVxalYlapEna/*meVxalYlapEna	n number bahu parsarg pE 
*meVxalYlYapEki/meVxalYlapEki/meVxadlapEki	n number bahu parsarg pEki 
*meVxalYlaguMdA/meVxalYlaguMdA/meVxadlaguMdA	n number bahu parsarg guMdA 
meVxalYlalA/meVxadlalA/meVxalYlalAga/*meVxalYlYulAgA/meVxalYlulAgA/meVxadlalAga/meVxadlulAgA	n number bahu parsarg lA 
*meVxalYlYavale/meVxalYlavale/meVxalYlavaleV/meVxalYlamAxiri/meVxalYlanupolina/meVxalYlanubolina/meVxadlavale/meVxadlavaleV/meVxadlamAxiri/meVxadlanupolina/meVxadlanubolina	n number bahu parsarg vale 
*meVxalYlYakumalle/meVxalYlakumalle/meVxadlakumalle/meVxalYlakumalleV/meVxadlakumalleV	n number bahu parsarg kimalle 
meVxadlukUdA/*meVxalYlYukUdA/meVxalYlukUdA/meVxadlumeVxadA/meVxalYlumeVxadA/meVxadlanumeVxadA/meVxalYlanumeVxadA	n number bahu parsarg kUdA 
*meVxalYlYaxqRtilo/meVxalYlaxqRtilo/meVxalYlaxruRtilo/meVxadlaxqRtilo/meVxadlaxruRtilo	n number bahu parsarg xqRtilo 
meVxadlulekuMdA/meVxadluleka/meVxalYluleka/*meVxalYlYulekuMdA/meVxalYlulekuMdA/meVxalYluleka	n number bahu parsarg lekuMdA 
meVxadlukAkuMdA/meVxadlukAka/*meVxalYlYukAka/meVxalYlukAka/meVxalYlugAka/meVxadlugAka	n number bahu parsarg kAkuMdA 
*meVxalYlYumoVxalukoVni/meVxalYlumoVxalukoVni/meVxalYlanumoVxalukoVni/meVxadlumoVxalukoVni/meVxadlanumoVxalukoVni	n number bahu parsarg moVxalukoVni 
*meVxalYlYavEpu/meVxalYlavEpu/meVxalYlavepu/meVxadlavEpu/meVxalYlakesi/meVxadlakesi	n number bahu parsarg vEpu 
meVxalYlapakka/meVxalYlapakkana/meVxalYlaprakka/*meVxalYlYaprakkana/meVxalYlaprakkana/meVxadlapakka/meVxadlapakkana/meVxadlaprakka/meVxadlaprakkana	n number bahu parsarg pakka 
meVxalYlapakkalo/*meVxalYlYaprakkalo/meVxalYlaprakkalo/meVxadlapakkalo/meVxadlaprakkalo	n number bahu parsarg pakkalo 
meVxalYlaloki/meVxalYlaloniki/meVxadlaloki/meVxadlaloniki/*meVxalYlYalopalaki/meVxalYlalopalaki/meVxalYlalopaliki/meVxadlalopaliki/meVxadlalopalaku	n number bahu parsarg lopalaki 
meVxalYlakiMxa/*meVxalYlYakriMxa/meVxalYlakriMxa/meVxadlakiMxa/meVxadlakriMxa/meVxalYlakriMxane/meVxalYlakiMxane/meVxadlakiMxane/meVxadlakriMxane	n number bahu parsarg kiMxa 
meVxalYladuguna/*meVxalYlYakaduguna/meVxalYlakaduguna/meVxadladuguna/meVxadlakaduguna	n number bahu parsarg aduguna 
meVxalYlakeVlla/*meVxalYlYakalla/meVxalYlakalla/meVxadlakalla/meVxadlakeVlla	n number bahu parsarg kalla 
meVxalYlaveVnuka/meVxalYlaveVnaka/*meVxalYlYaveVnakAla/meVxalYlaveVnakAla/meVxalYlaveVnukAla/meVxalYlaveVnakAwala/meVxalYlaveVnukAwala/meVxadlaveVnakAwala/meVxadlaveVnukAwala	n number bahu parsarg veVnuka 
*meVxalYlYawaravAwa/meVxalYlawaravAwa/meVxalYlawarvAwa/meVxadlawaravAwa	n number bahu parsarg waravAwa 
meVxadleVxuruguMdA/*meVxalYlYakeVxuruguMdA/meVxalYlakeVxuruguMdA/meVxadlakeVxuruguMdA/meVxalYleVxuruguMdA	n number bahu parsarg eVxuruguMdA 
*meVxalYlYamaXya/meVxalYlamaXya/meVxalYlamaXyana/meVxalYlamaXyalo/meVxadlamaXya/meVxadlamaXyana/meVxadlamaXyalo	n number bahu parsarg maXya 
*meVxalYlYanaduma/meVxalYlanaduma/meVxalYlakinaduma/meVxadlanaduma/meVxadlakinaduma	n number bahu parsarg naduma 
meVxalYlabaxulugA/meVxalYlakibaxulugA/meVxalYlabaxulu/meVxalYlakibaxulu/*meVxalYlYakibaxulu	n number bahu parsarg baxulugA 
*meVxalYlYacotlo/meVxalYlacotlo/meVxalYlacotulo/meVxadlacotlo/meVxadlacotulo	n number bahu parsarg cotlo 
meVxalYlasWAnaMlo/meVxalYlaswAnaMlo/*meVxalYlYasWAnamulo/meVxalYlasWAnamulo/meVxadlasWAnaMlo/meVxadlaswAnaMlo/meVxadlasWAnamulo	n number bahu parsarg sWAnaMlo 
meVxalYlanerugA/meVxalYlakunerugA/*meVxalYlYakinerugA/meVxalYlakinerugA/meVxadlanerugA/meVxadlakunerugA/meVxadlakinerugA	n number bahu parsarg nerugA 
*meVxalYlYaprakAraM/meVxalYlaprakAraM/meVxalYlanubatti/meVxalYlabatti/meVxalYlanibatti/meVxadlaprakAraM/meVxadlanubatti/meVxadlabatti/meVxadlanibatti	n number bahu parsarg prakAraM 
*meVxalYlYaxaggaranuMdi/meVxalYlaxaggaranuMdi/meVxalYlaxaggiranuMdi/meVxalYlaxaggaranuMci/meVxalYlaxaggiranuMci/meVxadlaxaggaranuMdi/meVxadlaxaggiranuMdi/meVxadlaxaggaranuMci/meVxadlaxaggiranuMci	n number bahu parsarg xaggaranuMdi 
*meVxalYlYavaxxanuMdi/meVxalYlavaxxanuMdi/meVxalYlavaxxanuMci/meVxadlavaxxanuMdi/meVxadlavaxxanuMci	n number bahu parsarg vaxxanuMdi 
*meVxalYlYapakkanuMdi/meVxalYlapakkanuMdi/meVxalYlapakkanuMci/meVxadlapakkanuMdi/meVxadlapakkanuMci/meVxalYlapakkalonuMdi/meVxalYlapakkalonuMci/meVxadlapakkalonuMdi/meVxadlapakkalonuMci	n number bahu parsarg pakkanuMdi 
*meVxalYlYalopalanuMdi/meVxalYlalopalanuMdi/meVxadlalopalanuMdi/meVxalYlalopalanuMci/meVxadlalopalanuMci/meVxadlalopalinuMdi/meVxalYlalopalinuMci	n number bahu parsarg lopalanuMdi 
*meVxalYlYabEtanuMdi/meVxalYlabEtanuMdi/meVxalYlabEtanuMci/meVxalYlabEtaniMci/meVxadlabEtanuMdi/meVxadlabEtanuMci/meVxadlabEtaniMci	n number bahu parsarg bEtanuMdi 
*meVxalYlYapEnuMdi/meVxalYlapEnuMdi/meVxalYlapEnuMci/meVxalYlapEniMci/meVxadlapEnuMdi/meVxadlapEnuMci/meVxadlapEniMci	n number bahu parsarg pEnuMdi 
meVxalYlakiMxanuMdi/meVxalYlakiMxanuMci/meVxalYlakiMxaniMci/meVxadlakiMxanuMdi/meVxadlakiMxanuMci/meVxadlakiMxaniMci/*meVxalYlYakriMxanuMdi/meVxalYlakriMxanuMdi/meVxalYlakriMxanuMci/meVxalYlakriMxaniMci/meVxadlakriMxanuMdi/meVxadlakriMxanuMci/meVxadlakriMxaniMci	n number bahu parsarg kriMxanuMdi 
*meVxalYlYadugunuMdi/meVxalYladugunuMdi/meVxalYladugunuMci/meVxalYladuguniMci/meVxadladugunuMdi/meVxadladugunuMci/meVxadladuguniMci	n number bahu parsarg adugunuMdi 
*meVxalYlYamuMxunuMdi/meVxalYlamuMxunuMdi/meVxalYlamuMxunuMci/meVxalYlamuMxuniMci/meVxadlamuMxunuMdi/meVxadlamuMxunuMci/meVxadlamuMxuniMci	n number bahu parsarg muMxunuMdi 
meVxalYlaveVnukanuMdi/meVxalYlaveVnakanuMdi/*meVxalYlYaveVnakAlanuMdi/meVxalYlaveVnakAlanuMdi/meVxadlaveVnukanuMdi/mexalYlaveVnakanuMdi/meVxalYlaveVnakAlanuMdi/meVxalYlaveVnakAlanuMci/meVxalYlaveVnukanuMci/meVxalYlaveVnakanuMci/meVxalYlaveVnakAlanuMci/meVaxalYlaveVnukanuMci/meVxalYlaveVnakanuMci/meVxalYlaveVnakAwalanuMdi/meVxalYlaveVnakAwalanuMci/meVxadlaveVnakAwalanuMdi/meVxadlaveVnakAwalanuMci	n number bahu parsarg veVnukanuMdi 
meVxadleVxutinuMdi/meVxalYlakeVxutinuMdi/meVxadleVxutanuMdi/*meVxalYlYakeVxutanuMdi/meVxalYlakeVxutanuMdi/meVxadleVxutinuMci/meVxalYlakeVxutinuMci/meVxadleVxutanuMci/meVxalYlakeVxutanuMci	n number bahu parsarg eVxutinuMdi 
*meVxalYlYamaXyanuMdi/meVxalYlamaXyanuMdi/meVxalYlamaXyanuMci/meVxalYlamaXyaniMci/meVxadlamaXyanuMdi/meVxadlamaXyanuMci/meVxadlamaXyaniMci/meVxalYlamaXyalonuMdi/meVxalYlamaXyalonuMci/meVxalYlamaXyaloniMci/meVxadlamaXyalonuMdi/meVxadlamaXyalonuMci/meVxadlamaXyaloniMci	n number bahu parsarg maXyanuMdi 
*meVxalYlYanadumanuMdi/meVxalYlanadumanuMdi/meVxalYlanadamanuMdi/meVxalYlanadumanuMci/meVxalYlanadamanuMci/meVxadlanadumanuMdi/meVxadlanadamanuMdi/meVxadlanadumanuMci/meVxadlanadamanuMci	n number bahu parsarg nadumanuMdi 
*meVxalYlYawaravAwanuMdi/meVxalYlawaravAwanuMdi/meVxalYlawarvAwanuMdi/meVxadlawaravAwanuMdi/meVxadlawarvAwanuMdi/meVxalYlawaravAwanuMci/meVxalYlawarvAwanuMci/meVxadlawaravAwanuMci/meVxadlawarvAwanuMci	n number bahu parsarg waravAwanuMdi 
meVxalYlacotunuMdi/meVxalYlacotunuMci/meVxalYlacotuniMci/meVxadlacotunuMdi/meVxadlacotunuMci/*meVxalYlYacotlonuMdi/meVxalYlacotlonuMdi/meVxalYlacotlonuMci/meVxalYlacotloniMci/meVxadlacotlonuMdi/meVxadlacotlonuMci	n number bahu parsarg cotlonuMdi 
*meVxalYlYasWAnamunuMdi/meVxalYlasWAnamunuMdi/meVxalYlasWAnaMnuMdi/meVxadlasWAnamunuMdi/meVxadlasWAnaMnuMdi/meVxalYlasWAnamunuMci/meVxalYlasWAnaMnuMci/meVxadlasWAnamunuMci/meVxadlasWAnaMnuMci/meVxalYlasWAnaMlonuMdi/meVxalYlasWAnamulonuMdi/meVxadlasWAnaMlonuMdi/meVxadlasWAnamulonuMdi/meVxalYlasWAnaMlonuMci/meVxalYlasWAnamulonuMci/meVxadlasWAnaMlonuMci/meVxadlasWAnamulonuMci	n number bahu parsarg sWAnaMnuMdi 
*meVxalYlYayaMxu/meVxalYlayaMxu/meVxalYlaMxu/meVxadlayaMxu/meVxadlaMxu	n number bahu parsarg aMxu 
meVxalYlaMte/meVxalYlaMteV/meVxadlaMte/meVxadlaMteV	n number bahu parsarg aMte 
*meVxalYlYakaMteV/meVxalYlakaMteV/meVxalYlakaMte/meVxadlakaMteV/meVxadlakaMte/meVxalYlakanna/meVxalYlakannA/meVxadlakanna/meVxadlakannA	n number bahu parsarg kaMteV 
*meVxalYlYEna/meVxalYlEna/meVxadlEna	n number bahu parsarg Ena 
*meVxalYlYapAti/meVxalYlapAti/meVxadlapAti	n number bahu parsarg pAti 
*meVxalYlYalAMti/meVxalYlalAMti/meVxadlalAti/meVxalYlulAMti/meVxadlulAti	n number bahu parsarg lAMti 
*meVxalYlYugAnI/meVxalYlugAnI/meVxadlukAnI/meVxadlugAnI/meVxadlukAnI	n number bahu parsarg gAni 
*meVxalYlYugA/meVxalYlugA/meVxadlugA	n number bahu parsarg gA 
