noun	
meku	
*meku	n number eka parsarg 0 
-	n number eka parsarg I 
-	n number eka parsarg gA 
*mekugAdu	n number eka parsarg gAdu 
*mekugawweV	n number eka parsarg gawweV 
*mekuvAdu	n number eka parsarg vAdu 
*mekAyana	n number eka parsarg Ayana 
*mekuvAru	n number eka parsarg vAru 
*mekuxi	n number eka parsarg xi 
*mekuvi	n number eka parsarg vi 
*mekugAru	n number eka parsarg gAru 
*mekunu	n number eka parsarg nu 
*mekuvu	n number eka parsarg vu 
*mekuyoVkka	n number eka parsarg yoVkka 
*meku	n number eka parsarg obl 
*mekuni/mekunu	n number eka parsarg ni 
*mekuki/mekuku/mekunaku	n number eka parsarg ki 
*mekuwo/mekuwoda/mekuwoti	n number eka parsarg wo 
mekulo/mekulona/*mekulopala	n number eka parsarg lo 
*mekuloni/mekulopali/mekunaMxali	n number eka parsarg loni 
*mekumIxa	n number eka parsarg mIxa 
*mekuna	n number eka parsarg na 
mekuniMci/mekunuMci/*mekunuMdi	n number eka parsarg niMci 
*mekuxvArA/mekuxvAra	n number eka parsarg xvArA 
*mekuvalana/mekuvalla	n number eka parsarg valana 
*mekunubatti/mekunibatti	n number eka parsarg batti 
mekuce/*mekucewa	n number eka parsarg ce 
*mekuwopAtu	n number eka parsarg wopAtu 
*mekuwokUdi/mekuwokUda/mekuwokUdA/mekuwogUdi/mekuwogUda/mekuwogUdA	n number eka parsarg wokUdi 
*mekukosaM/mekukE/mekunakE/mekArWaM	n number eka parsarg kosaM 
*mekukoVraku/mekukoVrYaku	n number eka parsarg koVraku 
*mekulonuMdi/mekulonuMci	n number eka parsarg lonuMdi 
*mekumIxanuMdi/mekumIxanuMci	n number eka parsarg mIxanuMdi 
*mekuxAkA/mekuxAka	n number eka parsarg xAkA 
*mekuvaraku	n number eka parsarg varaku 
*mekumIxaki/mekumIxaku	n number eka parsarg mIxaki 
*mekuxaggara/mekuxaggira	n number eka parsarg xaggara 
*mekuvaxxa/mekuyoVxxa	n number eka parsarg vaxxa 
*mekukAda	n number eka parsarg kAda 
*mekukeVxurugA/mekeVxurugA	n number eka parsarg keVxurugA 
*mekumuMxu	n number eka parsarg muMxu 
*mekuguriMci/mekuniguriMci	n number eka parsarg guriMci 
mekupE/*mekupEna/mekupEni	n number eka parsarg pE 
*mekupEki	n number eka parsarg pEki 
*mekuguMdA	n number eka parsarg guMdA 
mekulA/mekulAga/*mekulAgA	n number eka parsarg lA 
*mekuvale/mekumAxiri/mekunipolina/mekuvaleV/mekunibolina	n number eka parsarg vale 
*mekukimalle/mekukumalleV/mekumalle	n number eka parsarg kimalle 
*mekukUdA/mekunikUdA/mekugUdA/mekunigUdA	n number eka parsarg kUdA 
*mekuxqRtilo/mekuxruRtilo	n number eka parsarg xqRtilo 
*mekulekuMdA/mekunilekuMdA	n number eka parsarg lekuMdA 
*mekukAkuMdA/mekunikAkuMdA	n number eka parsarg kAkuMdA 
*mekumoVxalukoVni/mekunimoVxalukoVni	n number eka parsarg moVxalukoVni 
*mekuvEpu/mekuvepu/mekukesi	n number eka parsarg vEpu 
mekupakka/*mekuprakka/mekupakkana	n number eka parsarg pakka 
mekupakkalo/*mekuprakkalo	n number eka parsarg pakkalo 
mekuloki/mekuloniki/*mekulopalaki/mekulopaliki/mekulopalaku	n number eka parsarg lopalaki 
mekukiMxa/*mekukriMxa/mekukriMxana/mekukiMxana	n number eka parsarg kiMxa 
mekaduguna/*mekukaduguna	n number eka parsarg aduguna 
mekukeVlla/*mekukalla	n number eka parsarg kalla 
mekuveVnuka/*mekuveVnakAla/mekuveVnakAwala	n number eka parsarg veVnuka 
mekuwaravAwa/mekuwarvAwa/*mekuwaruvAwa	n number eka parsarg waravAwa 
mekeVxuruguMdA/*mekukeVxuruguMdA	n number eka parsarg eVxuruguMdA 
*mekumaXya/mekumaXyalo/mekumaXyana	n number eka parsarg maXya 
*mekunaduma/mekunadama	n number eka parsarg naduma 
mekubaxulugA/mekubaxulu/*mekukibaxulu/mekunibaxulu	n number eka parsarg baxulugA 
*mekucotlo/mekucotulo/mekucotuna	n number eka parsarg cotlo 
mekusWAnaMlo/*mekusWAnamulo	n number eka parsarg sWAnaMlo 
mekunerugA/mekukunerugA/*mekukinerugA	n number eka parsarg nerugA 
*mekuprakAraM/mekuprakAramu	n number eka parsarg prakAraM 
*mekuxaggaranuMdi/mekuxaggaranuMci/mekuxaggiranuMdi/mekuxaggaraniMci	n number eka parsarg xaggaranuMdi 
*mekuvaxxanuMdi/mekuvaxxanuMci	n number eka parsarg vaxxanuMdi 
*mekupakkanuMdi/mekupakkanuMci/mekupakkalonuMdi/mekupakkalonuMci	n number eka parsarg pakkanuMdi 
*mekulopalanuMdi/mekulopalinuMdi/mekulopalanuMci	n number eka parsarg lopalanuMdi 
*mekubEtanuMdi/mekubEtanuMci	n number eka parsarg bEtanuMdi 
*mekupEnuMdi/mekupEnuMci	n number eka parsarg pEnuMdi 
mekukiMxanuMdi/mekukiMxanuMci/*mekukriMxanuMdi/mekukriMxanuMci	n number eka parsarg kriMxanuMdi 
mekaduguniMci/mekadugunuMdi/*mekukadugunuMdi/mekukadugunuMci	n number eka parsarg adugunuMdi 
*mekukimuMxunuMdi/mekumuMxunuMci	n number eka parsarg muMxunuMdi 
*mekuveVnakanuMdi/mekuveVnukanuMci/mekuveVnakAwalanuMdi/mekuveVnakAwalanuMci/mekuveVnakanuMci/mekuveVnukanuMci/mekuveVnakAlanuMdi/mekuveVnakAlanuMci/mekuveVnakAwalanuMdi	n number eka parsarg veVnukanuMdi 
mekeVxutinuMdi/mekeVxutanuMci/mekukeVxutinuMci/*mekukeVxutanuMdi	n number eka parsarg eVxutinuMdi 
*mekumaXyanuMdi/mekumaXyanuMci/mekumaXyalonuMdi/mekumaXyalonuMci	n number eka parsarg maXyanuMdi 
*mekunadumanuMdi/mekunadumanuMci	n number eka parsarg nadumanuMdi 
*mekuwaravAwanuMdi/mekuwarvAwanuMdi/mekuwaravAwanuMci/mekuwarvAwanuMci	n number eka parsarg waravAwanuMdi 
*mekucotlonuMdi/mekucotunuMdi/mekucotlonuMci/mekucotunuMci	n number eka parsarg cotlonuMdi 
mekusWAnaMnuMdi/*mekusWAnamunuMdi/mekusWAnaMnuMci/mekusWAnamunuMci/mekusWAnaMlonuMdi/mekusWAnamulonuMdi/mekusWAnaMlonuMci/mekusWAnamulonuMci	n number eka parsarg sWAnaMnuMdi 
mekaMxu/mekunaMxu/*mekuyaMxu	n number eka parsarg aMxu 
*mekaMte/mekaMteV	n number eka parsarg aMte 
*mekukaMteV/mekukaMte/mekukanna/mekukannA	n number eka parsarg kaMteV 
*mekEna	n number eka parsarg Ena 
*mekupAti	n number eka parsarg pAti 
*mekulAMti/mekulAti	n number eka parsarg lAMti 
*mekugAnI/mekukAnI	n number eka parsarg gAni 
*mekugA	n number eka parsarg gA 
*mekulu	n number bahu parsarg 0 
*mekulU/mekulArA/mekullArA	n number bahu parsarg I 
-	n number bahu parsarg gA 
*mekulagAdu	n number bahu parsarg gAdu 
*mekulagawweV	n number bahu parsarg gawweV 
*mekulavAdu	n number bahu parsarg vAdu 
*mekulAyana	n number bahu parsarg Ayana 
*mekulavAru	n number bahu parsarg vAru 
*mekulaxi/mekulxi	n number bahu parsarg xi 
*mekulavi/mekuliy	n number bahu parsarg vi 
*mekulagAru	n number bahu parsarg gAru 
mekulamu/*mekulaM	n number bahu parsarg nu 
*mekulu	n number bahu parsarg vu 
*mekulayoVkka	n number bahu parsarg yoVkka 
*mekula	n number bahu parsarg obl 
*mekulani/mekulanu/mekulni	n number bahu parsarg ni 
*mekulaki/mekulaku	n number bahu parsarg ki 
*mekulawo/mekulawoda/mekulawoti	n number bahu parsarg wo 
mekulYlo/mekulalo/mekulalona/*mekulalopala	n number bahu parsarg lo 
*mekulaloni/mekulalopali/mekulayaMxali	n number bahu parsarg loni 
*mekulamIxa	n number bahu parsarg mIxa 
*mekulana	n number bahu parsarg na 
mekulaniMci/mekulanuMci/*mekulanuMdi	n number bahu parsarg niMci 
*mekulaxvArA	n number bahu parsarg xvArA 
*mekulavalana/mekulavalla	n number bahu parsarg valana 
*mekulanubatti	n number bahu parsarg batti 
*mekulacewa/mekulace	n number bahu parsarg ce 
*mekulawopAtu	n number bahu parsarg wopAtu 
*mekulawokUdi/mekulawokUda/mekulawokUdA/mekulawogUdi/mekulawogUda/mekulawogUdA	n number bahu parsarg wokUdi 
*mekulakosaM/mekulakE/mekulArWaM	n number bahu parsarg kosaM 
*mekulakoVraku/mekulakoVrYaku	n number bahu parsarg koVraku 
*mekulalonuMdi/mekulalonuMci/mekulaloniMci/mekullonuMdi/mekullonuMci/mekulloniMci	n number bahu parsarg lonuMdi 
mekulamIxaniMci/*mekulamIxanuMdi/mekulamIxanuMci	n number bahu parsarg mIxanuMdi 
*mekulaxAkA	n number bahu parsarg xAkA 
*mekulavaraku	n number bahu parsarg varaku 
*mekulamIxaki/mekulamIxaku	n number bahu parsarg mIxaki 
*mekulaxaggara/mekulaxaggira	n number bahu parsarg xaggara 
*mekulavaxxa/mekuloVxxa	n number bahu parsarg vaxxa 
*mekulakAda	n number bahu parsarg kAda 
*mekulakeVxurugA/mekuleVxurugA	n number bahu parsarg keVxurugA 
*mekulamuMxu	n number bahu parsarg muMxu 
*mekulaguriMci/mekulagUrci/mekulanuguriMci/mekulanigUrci	n number bahu parsarg guriMci 
mekulapE/mekulapEni/*mekulapEna	n number bahu parsarg pE 
*mekulapEki	n number bahu parsarg pEki 
*mekulaguMdA	n number bahu parsarg guMdA 
mekulalA/mekulalAga/*mekulalAgA	n number bahu parsarg lA 
*mekulavale/mekulavaleV/mekulamAxiri/mekulapolina/mekulabolina/mekulanupolina/mekulanubolina	n number bahu parsarg vale 
*mekulakumalle/mekulakumalleV	n number bahu parsarg kimalle 
*mekulanukUdA/mekulakUdA/mekulanugUdA/mekulugUdA/mekulnigUdA/mekulnikUdA	n number bahu parsarg kUdA 
*mekulaxqRtilo/mekulaxruRtilo	n number bahu parsarg xqRtilo 
*mekululekuMdA/mekullekuMdA	n number bahu parsarg lekuMdA 
*mekulukAkuMdA/mekulukAkuMda/mekulugAkuMdA	n number bahu parsarg kAkuMdA 
*mekulumoVxalukoVni	n number bahu parsarg moVxalukoVni 
*mekulavEpu/mekulavepu/mekulakesi	n number bahu parsarg vEpu 
mekulapakka/mekulapakkana/mekulaprakka/*mekulaprakkana	n number bahu parsarg pakka 
*mekulapakkalo	n number bahu parsarg pakkalo 
mekulaloniki/mekulaloki/*mekulalopalaki/mekulalopaliki/mekulalopalaku	n number bahu parsarg lopalaki 
mekulakiMxa/*mekulakriMxa/mekulakriMxana/mekulakiMxana	n number bahu parsarg kiMxa 
mekuladuguna/*mekulakaduguna	n number bahu parsarg aduguna 
mekulakeVlla/*mekulakalla	n number bahu parsarg kalla 
mekulaveVnuka/mekulaveVnaka/*mekulaveVnakAla/mekulaveVnukAla/mekulaveVnakAwala/mekulaveVnukAwala	n number bahu parsarg veVnuka 
mekulawaravAwa/mekulawarvAwa/*mekulawaruvAwa	n number bahu parsarg waravAwa 
mekuleVxuruguMdA/*mekulakeVxuruguMdA	n number bahu parsarg eVxuruguMdA 
*mekulamaXya/mekulamaXyana/mekulamaXyalo	n number bahu parsarg maXya 
mekulanaduma/*mekulakinaduma	n number bahu parsarg naduma 
mekulabaxulugA/mekulakibaxulugA/mekulabaxulu/*mekulakibaxulu	n number bahu parsarg baxulugA 
*mekulacotlo/mekulacotulo	n number bahu parsarg cotlo 
mekulasWAnaMlo/mekulaswAnaMlo/*mekulasWAnamulo	n number bahu parsarg sWAnaMlo 
mekulanerugA/mekulakunerugA/*mekulakinerugA	n number bahu parsarg nerugA 
*mekulaprakAraM/mekulanubatti/mekulabatti/mekulanibatti	n number bahu parsarg prakAraM 
*mekulaxaggaranuMdi/mekulaxaggiranuMdi/mekulaxaggaranuMci/mekulaxaggiranuMci	n number bahu parsarg xaggaranuMdi 
*mekulavaxxanuMdi/mekulavaxxanuMci	n number bahu parsarg vaxxanuMdi 
*mekulapakkanuMdi/mekulapakkanuMci/mekulapakkalonuMdi/mekulapakkalonuMci	n number bahu parsarg pakkanuMdi 
*mekulalopalanuMdi/mekullopalanuMdi/mekulalopalanuMci/mekullopalanuMci/mekulalopalinuMdi/mekulalopalinuMci	n number bahu parsarg lopalanuMdi 
*mekulabEtanuMdi/mekulabEtanuMci/mekulabEtaniMci	n number bahu parsarg bEtanuMdi 
*mekulapEnuMdi/mekulapEnuMci/mekulapEniMci	n number bahu parsarg pEnuMdi 
mekulakiMxanuMdi/mekulakiMxanuMci/mekulakiMxaniMci/*mekulakriMxanuMdi/mekulakriMxanuMci/mekulakriMxaniMci	n number bahu parsarg kriMxanuMdi 
*mekuladugunuMdi/mekuladugunuMci/mekuladuguniMci	n number bahu parsarg adugunuMdi 
*mekulamuMxunuMdi/mekulamuMxunuMci/mekulamuMxuniMci	n number bahu parsarg muMxunuMdi 
mekulaveVnukanuMdi/mekulaveVnakanuMdi/*mekulaveVnakAlanuMdi/mekulaveVnakAlanuMci/mekulaveVnukanuMci/mekulaveVnakanuMci/mekulaveVnakAwalanuMdi/mekulaveVnakAwalanuMci	n number bahu parsarg veVnukanuMdi 
mekuleVxutinuMdi/*mekulakeVxutinuMdi/mekuleVxutinuMci/mekulakeVxutinuMci	n number bahu parsarg eVxutinuMdi 
*mekulamaXyanuMdi/mekulamaXyanuMci/mekulamaXyaniMci/mekulamaXyalonuMdi/mekulamaXyalonuMci/mekulamaXyaloniMci	n number bahu parsarg maXyanuMdi 
*mekulanadumanuMdi/mekulanadamanuMdi/mekulanadumanuMci/mekulanadamanuMci	n number bahu parsarg nadumanuMdi 
*mekulawaravAwanuMdi/mekulawarvAwanuMdi/mekulawaravAwanuMci/mekulawarvAwanuMci	n number bahu parsarg waravAwanuMdi 
mekulacotunuMdi/mekulacotunuMci/mekulacotuniMci/*mekulacotlonuMdi/mekulacotlonuMci/mekulacotloniMci	n number bahu parsarg cotlonuMdi 
*mekulasWAnamunuMdi/mekulasWAnaMnuMdi/mekulasWAnamunuMci/mekulasWAnaMnuMci/mekulasWAnaMlonuMdi/mekulasWAnamulonuMdi/mekulasWAnaMlonuMci/mekulasWAnamulonuMci	n number bahu parsarg sWAnaMnuMdi 
*mekulayaMxu/mekulaMxu	n number bahu parsarg aMxu 
*mekulaMte/mekulaMteV	n number bahu parsarg aMte 
*mekulakaMteV/mekulakaMte/mekulakanna/mekulakannA	n number bahu parsarg kaMteV 
*mekulEna	n number bahu parsarg Ena 
*mekulapAti	n number bahu parsarg pAti 
*mekulalAMti/mekulalAti	n number bahu parsarg lAMti 
*mekulugAnI/mekulukAnI	n number bahu parsarg gAni 
*mekulugA	n number bahu parsarg gA 
