noun	
nOkaru	
*nOkaru	n number eka parsarg 0  case d
-	n number eka parsarg I 
-	n number eka parsarg gA 
*nOkarugAdu	n number eka parsarg gAdu  case d
*nOkarugawweV	n number eka parsarg gawweV  case d
*nOkaruvAdu/nOkarodu	n number eka parsarg vAdu  case d
*nOkarAyana	n number eka parsarg Ayana  case d
*nOkaruvAru	n number eka parsarg vAru  case d
*nOkarixi/nOkaruxi	n number eka parsarg xi  case d
*nOkarivi	n number eka parsarg vi  case d
*nOkarugAru	n number eka parsarg gAru  case d
*nOkarunu	n number eka parsarg nu 
*nOkaruvu	n number eka parsarg vu  case d
*nOkaruyoVkka	n number eka parsarg yoVkka 
*nOkaru	n number eka parsarg obl 
*nOkarini/nOkarni/nOkarnu/nOkarunu	n number eka parsarg ni 
*nOkariki/nOkaruku	n number eka parsarg ki 
*nOkaruwo/nOkaruwoda/nOkaruwoti	n number eka parsarg wo 
nOkarulo/nOkarlo/nOkarulona/*nOkarulopala/nOkarlopala	n number eka parsarg lo 
*nOkaruloni/nOkarloni/nOkaruloni/nOkarulopali/nOkarunaMxali/nOkarlopali	n number eka parsarg loni 
*nOkarumIxa/nOkarmIxa	n number eka parsarg mIxa 
nOkaruna/nOkarna	n number eka parsarg na 
nOkaruniMci/nOkarunuMci/*nOkarunuMdi/nOkarniMci/nOkarnuMci/nOkarnuMdi	n number eka parsarg niMci 
*nOkaruxvArA/nOkaruxvAra/nOkarxvArA/nOkarxvAra	n number eka parsarg xvArA 
nOkaruvalla/*nOkaruvalana	n number eka parsarg valana 
*nOkarunubatti/nOkarnubatti	n number eka parsarg batti 
nOkaruce/*nOkarucewa	n number eka parsarg ce 
*nOkaruwopAtu/nOkaruwobAtu	n number eka parsarg wopAtu 
*nOkaruwokUdi/nOkaruwokUda/nOkaruwokUdA/nOkaruwogUdi/nOkaruwogUda/nOkaruwogUdA	n number eka parsarg wokUdi 
*nOkarukosaM/nOkarukE/nOkarArWaM	n number eka parsarg kosaM 
*nOkarukoVraku/nOkarukoVrYaku	n number eka parsarg koVraku 
*nOkarulonuMdi/nOkarulonuMci/nOkaruloniMci/nOkarlonuMdi/nOkarlonuMci/nOkarloniMci	n number eka parsarg lonuMdi 
*nOkarumIxanuMdi/nOkarumIxanuMci/nOkarumIxaniMci	n number eka parsarg mIxanuMdi 
*nOkaruxAkA/nOkaruxAka	n number eka parsarg xAkA 
*nOkaruvaraku	n number eka parsarg varaku 
*nOkarumIxaki/nOkarumIxaku/nOkarumIxiki	n number eka parsarg mIxaki 
*nOkaruxaggara/nOkaruxaggira	n number eka parsarg xaggara 
*nOkaruvaxxa/nOkaroVxxa	n number eka parsarg vaxxa 
*nOkarukAda	n number eka parsarg kAda 
*nOkarukeVxurugA/nOkareVxurugA	n number eka parsarg keVxurugA 
*nOkarumuMxu	n number eka parsarg muMxu 
*nOkaruguriMci/nOkaruniguriMci/nOkarunigUrci	n number eka parsarg guriMci 
*nOkarupE	n number eka parsarg pE 
*nOkarupEki	n number eka parsarg pEki 
*nOkaruguMdA	n number eka parsarg guMdA 
nOkarulA/nOkarulAga/*nOkarulAgA	n number eka parsarg lA 
*nOkaruvale/nOkaruvaleV/nOkarumAxiri/nOkarunipoli/nOkarunibolina	n number eka parsarg vale 
nOkarukumalle/*nOkarukimalle/nOkarukimalleV/nOkarukumalleV	n number eka parsarg kimalle 
*nOkarukUdA/nOkarunikUdA/nOkarunukUdA/nOkarugUdA/nOkarunigUdA/nOkarunugUdA	n number eka parsarg kUdA 
*nOkaruxqRtilo/nOkaruxruRtilo	n number eka parsarg xqRtilo 
*nOkarulekuMdA/nOkarunilekuMdA/nOkarulekuMda/nOkarunulekuMdA	n number eka parsarg lekuMdA 
*nOkarukAkuMdA/nOkarunikAkuMdA/nOkarukAkuMda/nOkarukAka/nOkarugAkuMdA/nOkarunigAkuMdA/nOkarugAka/nOkarnigAkuMdA	n number eka parsarg kAkuMdA 
*nOkarumoVxalukoVni/nOkarunimoVxalukoVni/nOkarunumoVxalukoVni	n number eka parsarg moVxalukoVni 
*nOkaruvEpu/nOkaruvepu/nOkarukesi	n number eka parsarg vEpu 
nOkarupakka/nOkaruprakka/nOkarupakkana/*nOkaruprakkana/nOkarupakkani	n number eka parsarg pakka 
nOkarupakkalo/*nOkaruprakkalo/nOkarupakkalona/nOkarupakkaloni	n number eka parsarg pakkalo 
nOkaruloki/nOkaruloniki/*nOkarulopalaki/nOkarulopalaku/nOkarlopalaku/nOkarulopaliki	n number eka parsarg lopalaki 
nOkarukiMxa/*nOkarukriMxa/nOkarukriMxane/nOkarukiMxane	n number eka parsarg kiMxa 
nOkaraduguna/*nOkarukaduguna	n number eka parsarg aduguna 
nOkarukeVlla/*nOkarukalla	n number eka parsarg kalla 
nOkaruveVnuka/nOkaruveVnaka/nOkaruveVnakAwala/*nOkaruveVnakAla/nOkaruveVnakana	n number eka parsarg veVnuka 
nOkaruwaravAwa/nOkaruwarvAwa/*nOkaruwaruvAwa/nOkaruwaravAwana/nOkaruwarvAwana/nOkaruwaruvAwana	n number eka parsarg waravAwa 
nOkareVxuruguMdA/*nOkarukeVxuruguMdA	n number eka parsarg eVxuruguMdA 
*nOkarumaXya/nOkarumaXyalo/nOkarumaXyana	n number eka parsarg maXya 
*nOkarunaduma/nOkarunadumana	n number eka parsarg naduma 
nOkarubaxulugA/*nOkarubaxulu	n number eka parsarg baxulugA 
*nOkarucotlo/nOkarucotulo/nOkarucotuna	n number eka parsarg cotlo 
*nOkarusWAnaMlo/nOkaruswAnaMlo	n number eka parsarg sWAnaMlo 
nOkarunerugA/nOkarukunerugA/*nOkarukinerugA	n number eka parsarg nerugA 
*nOkaruprakAraM	n number eka parsarg prakAraM 
*nOkaruxaggaranuMdi/nOkaruxaggaranuMci/nOkaruxaggiranuMdi	n number eka parsarg xaggaranuMdi 
*nOkaruvaxxanuMdi/nOkaruvaxxanuMci/nOkaruvaxxaniMci	n number eka parsarg vaxxanuMdi 
*nOkarupakkanuMdi/nOkarupakkanuMci/nOkarupakkaniMci/nOkarupakkalonuMdi/nOkarupakkalonuMci/nOkarupakkaloniMci	n number eka parsarg pakkanuMdi 
*nOkarulopalanuMdi/nOkarulopalinuMdi/nOkarulopalinuMci/nOkarulopalanuMci/nOkarulopalaniMci	n number eka parsarg lopalanuMdi 
*nOkarubEtanuMdi/nOkarubEtanuMci/nOkarubEtaniMci	n number eka parsarg bEtanuMdi 
*nOkarupEnuMdi/nOkarupEnuMci/nOkarupEniMci	n number eka parsarg pEnuMdi 
nOkarukiMxanuMdi/nOkarukiMxanuMci/nOkarukiMxaniMci/*nOkarukriMxanuMdi/nOkarukriMxanuMci/nOkarukriMxaniMci	n number eka parsarg kriMxanuMdi 
nOkaradugunuMdi/nOkaradugunuMci/*nOkarukadugunuMdi/nOkarukadugunuMci/nOkarukaduguniMci	n number eka parsarg adugunuMdi 
*nOkarumuMxunuMdi/nOkarumuMxunuMci/nOkarumuMxuniMci	n number eka parsarg muMxunuMdi 
nOkaruveVnukanuMdi/*nOkaruveVnakAlanuMdi/nOkaruveVnakAwalanuMdi/nOkaruveVnakanuMdi/nOkaruveVnukanuMci/nOkaruveVnakAlanuMci/nOkaruveVnakAwalanuMci/nOkaruveVnakanuMci	n number eka parsarg veVnukanuMdi 
nOkareVxutinuMdi/*nOkarukeVxutinuMdi/nOkarukeVxutinuMci/nOkareVxutinuMci/nOkarukeVxutiniMci/nOkareVxutiniMci/nOkareVxutanuMdi/nOkarukeVxutanuMdi/nOkarukeVxutanuMci/nOkareVxutanuMci/nOkarukeVxutaniMci/nOkareVxutaniMci	n number eka parsarg eVxutinuMdi 
*nOkarumaXyanuMdi/nOkarumaXyanuMci/nOkarumaXyalonuMdi/nOkarumaXyalonuMci	n number eka parsarg maXyanuMdi 
*nOkarunadumanuMdi/nOkarunadumanuMci	n number eka parsarg nadumanuMdi 
*nOkaruwaravAwanuMdi/nOkaruwarvAwanuMdi/nOkaruwaravAwanuMci/nOkaruwarvAwanuMci	n number eka parsarg waravAwanuMdi 
*nOkarucotlonuMdi/nOkarucotunuMdi/nOkarucotlonuMci/nOkarucotunuMci	n number eka parsarg cotlonuMdi 
nOkarusWAnaMnuMdi/*nOkarusWAnamunuMdi/nOkarusWAnaMnuMci/nOkarusWAnamunuMci/nOkarusWAnaMlonuMdi/nOkarusWAnamulonuMdi/nOkarusWAnaMlonuMci/nOkarusWAnamulonuMci	n number eka parsarg sWAnaMnuMdi 
nOkaraMxu/nOkarunaMxu/*nOkaruyaMxu	n number eka parsarg aMxu 
*nOkaraMte/nOkaraMteV	n number eka parsarg aMte 
*nOkarukaMteV/nOkarukaMte/nOkarukanna/nOkarukannA	n number eka parsarg kaMteV 
*nOkarEna	n number eka parsarg Ena 
*nOkarupAti	n number eka parsarg pAti 
*nOkarulAMti/nOkarulAti	n number eka parsarg lAMti 
*nOkarugAnI/nOkarukAnI	n number eka parsarg gAni 
*nOkarugA	n number eka parsarg gA 
*nOkarlu/nOkarulu	n number bahu parsarg 0  case d
nOkarlU/nOkarulArA/*nOkarlArA	n number bahu parsarg I  case d
-	n number bahu parsarg gA 
*nOkarlagAdu/nOkarulagAdu	n number bahu parsarg gAdu  case d
*nOkarlagawweV/nOkarulagawweV	n number bahu parsarg gawweV  case d
*nOkarlavAdu/nOkarulavAdu	n number bahu parsarg vAdu  case d
*nOkarlAyana/nOkarulAyana	n number bahu parsarg Ayana  case d
*nOkarlavAru/nOkarulavAru	n number bahu parsarg vAru  case d
*nOkarlaxi/nOkarulaxi	n number bahu parsarg xi  case d
*nOkarlavi/nOkarulavi	n number bahu parsarg vi  case d
*nOkarlagAru/nOkarulagAru	n number bahu parsarg gAru  case d
*nOkarlaM/nOkarulamu	n number bahu parsarg nu  case d
*nOkarlu/nOkarulu	n number bahu parsarg vu 
*nOkarlayoVkka/nOkarulayoVkka	n number bahu parsarg yoVkka 
*nOkarla/nOkarula	n number bahu parsarg obl 
*nOkarlani/nOkarulanu/nOkarulni	n number bahu parsarg ni 
*nOkarlaki/nOkarulaku	n number bahu parsarg ki 
*nOkarlawo/nOkarulawo/nOkarlawoti/nOkarulawoti	n number bahu parsarg wo 
*nOkarlalo/nOkarlalopala/nOkarlalona/nOkarulalo/nOkarulalopala/nOkarulalona	n number bahu parsarg lo 
*nOkarlaloni/nOkarulaloni/nOkarulayaMxali	n number bahu parsarg loni 
*nOkarlamIxa/nOkarulamIxa	n number bahu parsarg mIxa 
*nOkarlana/nOkarulana	n number bahu parsarg na 
nOkarlaniMci/nOkarulaniMci/nOkarlanuMci/nOkarulanuMci/*nOkarlanuMdi/nOkarulanuMdi	n number bahu parsarg niMci 
*nOkarlaxvArA/nOkarulaxvArA	n number bahu parsarg xvArA 
*nOkarlavalana/nOkarlavalla	n number bahu parsarg valana 
*nOkarlanubatti/nOkarlanibatti/nOkarulavalana/nOkarulavalla/nOkarulanubatti/nOkarulanibatti	n number bahu parsarg batti 
*nOkarlacewa/nOkarulacewa/nOkarulace/nOkarlace	n number bahu parsarg ce 
*nOkarlawopAtu/nOkarulawopAtu/nOkarulawobatu/nOkarlawobAtu	n number bahu parsarg wopAtu 
*nOkarlawokUdi/nOkarlawogUdi/nOkarlawokUda/nOkarlawogUdA/nOkarulawokUdA/nOkarulawogUdA	n number bahu parsarg wokUdi 
*nOkarlakosaM/nOkarlakE/nOkarulakosaM/nOkarulakE/nOkarlArWaM	n number bahu parsarg kosaM 
*nOkarlakoVraku/nOkarlakoVrYaku/nOkarulakoVraku/nOkarulakoVrYaku	n number bahu parsarg koVraku 
*nOkarlalonuMdi/nOkarlalonuMci/nOkarulalonuMdi/nOkarulalonuMci/nOkarlaloniMci/nOkarlaloniMci	n number bahu parsarg lonuMdi 
*nOkarlamIxanuMdi/nOkarlamIxanuMci/nOkarlamIxaniMci/nOkarulamIxanuMdi/nOkarulamIxanuMci/nOkarulamIxaniMci	n number bahu parsarg mIxanuMdi 
*nOkarlaxAkA/nOkarlaxAka/nOkarulaxAkA/nOkarulaxAka	n number bahu parsarg xAkA 
*nOkarlavaraku/nOkarulavaraku	n number bahu parsarg varaku 
*nOkarlamIxaki/nOkarlamIxaku/nOkarlamIxiki/nOkarulamIxaki/nOkarulamIxaku/nOkarulamIxiki	n number bahu parsarg mIxaki 
*nOkarlaxaggara/nOkarlaxaggira/nOkarulaxaggara/nOkarulaxaggira	n number bahu parsarg xaggara 
*nOkarlavaxxa/nOkarloVxxa/nOkarulavaxxa/nOkaruloVxxa	n number bahu parsarg vaxxa 
*nOkarlakAda/nOkarulakAda	n number bahu parsarg kAda 
nOkarleVxurugA/*nOkarlakeVxurugA/nOkaruleVxurugA/nOkarulakeVxurugA	n number bahu parsarg keVxurugA 
*nOkarlamuMxu/nOkarulamuMxu	n number bahu parsarg muMxu 
*nOkarlaguriMci/nOkarlagUrci/nOkarlanuguriMci/nOkarulaguriMci/nOkarulanuguriMci/nOkarulagUrcia/nOkarulanugUrci	n number bahu parsarg guriMci 
nOkarlapE/nOkarulapE/*nOkarlapEna/nOkarulapEna	n number bahu parsarg pE 
*nOkarlapEki/nOkarulapEki	n number bahu parsarg pEki 
*nOkarlaguMdA/nOkarulaguMdA	n number bahu parsarg guMdA 
nOkarlalA/nOkarulalA/nOkarlalAga/nOkarulalAga/*nOkarlalAgA	n number bahu parsarg lA 
*nOkarlavale/nOkarlavaleV/nOkarlamAxiri/nOkarlanupoli/nOkarlanubolina	n number bahu parsarg vale 
*nOkarlakumalle/nOkarulakumalle/nOkarlakimalleV/nOkarulakumalleV	n number bahu parsarg kimalle 
*nOkarlukUdA/nOkarlugUdA/nOkarlugUda/nOkarlakUda	n number bahu parsarg kUdA 
*nOkarlaxqRtilo/nOkarlaxruRtilo	n number bahu parsarg xqRtilo 
*nOkarlulekuMdA/nOkarlanulekuMdA/nOkarluleka	n number bahu parsarg lekuMdA 
*nOkarlukAkuMdA/nOkarlanukAkuMda/nOkarlukAka/nOkarlugAka/nOkarlugAkuMdA	n number bahu parsarg kAkuMdA 
*nOkarlumoVxalukoVni/nOkarlanumoVxalukoVni	n number bahu parsarg moVxalukoVni 
*nOkarlavEpu/nOkarlavepu/nOkarlakesi	n number bahu parsarg vEpu 
nOkarlapakka/nOkarlapakkana/nOkarlaprakka/*nOkarlaprakkana	n number bahu parsarg pakka 
nOkarlapakkalo/*nOkarlaprakkalo	n number bahu parsarg pakkalo 
nOkarlaloki/nOkarlaloniki/*nOkarlalopalaki/nOkarlalopaliki/nOkarlalopaliki/nOkarlalopalaku	n number bahu parsarg lopalaki 
nOkarlakiMxa/*nOkarlakriMxa/nOkarlakriMxana/nOkarlakiMxana	n number bahu parsarg kiMxa 
nOkarladuguna/*nOkarlakaduguna	n number bahu parsarg aduguna 
nOkarlakeVlla/*nOkarlakalla	n number bahu parsarg kalla 
nOkarlaveVnuka/nOkarlaveVnaka/*nOkarlaveVnakAla/nOkarlaveVnukAla/nOkarlaveVnakAwala/nOkarlaveVnukAwala	n number bahu parsarg veVnuka 
nOkarlawaravAwa/nOkarlawarvAwa/*nOkarlawaruvAwa	n number bahu parsarg waravAwa 
nOkarleVxuruguMdA/*nOkarlakeVxuruguMdA	n number bahu parsarg eVxuruguMdA 
*nOkarlamaXya/nOkarlamaXyana/nOkarlamaXyalo	n number bahu parsarg maXya 
nOkarlanaduma/*nOkarlakinaduma	n number bahu parsarg naduma 
nOkarlabaxulugA/nOkarlakibaxulugA/nOkarlabaxulu/*nOkarlakibaxulu/nOkarlanubaxulu	n number bahu parsarg baxulugA 
*nOkarlacotlo/nOkarlacotulo	n number bahu parsarg cotlo 
nOkarlasWAnaMlo/nOkarlaswAnaMlo/*nOkarlasWAnamulo	n number bahu parsarg sWAnaMlo 
nOkarlanerugA/nOkarlakunerugA/*nOkarlakinerugA	n number bahu parsarg nerugA 
*nOkarlaprakAraM/nOkarlanubatti/nOkarlabatti/nOkarlanibatti	n number bahu parsarg prakAraM 
*nOkarlaxaggaranuMdi/nOkarlaxaggiranuMdi/nOkarlaxaggaranuMci/nOkarlaxaggiranuMci	n number bahu parsarg xaggaranuMdi 
*nOkarlavaxxanuMdi/nOkarlavaxxanuMci	n number bahu parsarg vaxxanuMdi 
*nOkarlapakkanuMdi/nOkarlapakkanuMci/nOkarlapakkalonuMdi/nOkarlapakkalonuMci	n number bahu parsarg pakkanuMdi 
*nOkarlalopalanuMdi/nOkarlalopalanuMci/nOkarlalopalinuMdi/nOkarlalopalinuMci	n number bahu parsarg lopalanuMdi 
*nOkarlabEtanuMdi/nOkarlabEtanuMci/nOkarlabEtaniMci	n number bahu parsarg bEtanuMdi 
*nOkarlapEnuMdi/nOkarlapEnuMci/nOkarlapEniMci	n number bahu parsarg pEnuMdi 
nOkarlakiMxanuMdi/nOkarlakiMxanuMci/nOkarlakiMxaniMci/*nOkarlakriMxanuMdi/nOkarlakriMxanuMci/nOkarlakriMxaniMci	n number bahu parsarg kriMxanuMdi 
*nOkarladugunuMdi/nOkarladugunuMci/nOkarladuguniMci	n number bahu parsarg adugunuMdi 
*nOkarlamuMxunuMdi/nOkarlamuMxunuMci/nOkarlamuMxuniMci	n number bahu parsarg muMxunuMdi 
nOkarlaveVnukanuMdi/nOkarlaveVnakanuMdi/*nOkarlaveVnakAlanuMdi/nOkarlaveVnakAlanuMci/nOkarlaveVnukanuMci/nOkarlaveVnakanuMci/nOkarlaveVnakAwalanuMdi/nOkarlaveVnakAwalanuMci	n number bahu parsarg veVnukanuMdi 
nOkarleVxutinuMdi/nOkarlakeVxutinuMdi/nOkarleVxutanuMdi/*nOkarlakeVxutanuMdi/nOkarleVxutinuMci/nOkarlakeVxutinuMci/nOkarleVxutanuMci/nOkarlakeVxutanuMci	n number bahu parsarg eVxutinuMdi 
*nOkarlamaXyanuMdi/nOkarlamaXyanuMci/nOkarlamaXyaniMci/nOkarlamaXyalonuMdi/nOkarlamaXyalonuMci/nOkarlamaXyaloniMci	n number bahu parsarg maXyanuMdi 
*nOkarlanadumanuMdi/nOkarlanadamanuMdi/nOkarlanadumanuMci/nOkarlanadamanuMci	n number bahu parsarg nadumanuMdi 
*nOkarlawaravAwanuMdi/nOkarlawarvAwanuMdi/nOkarlawaravAwanuMci/nOkarlawarvAwanuMci	n number bahu parsarg waravAwanuMdi 
nOkarlacotunuMdi/nOkarulacotunuMdi/*nOkarlacotlonuMci/nOkarlacotloniMci/nOkarlacotulonuMci/nOkarlacotulonuMdi	n number bahu parsarg cotlonuMdi 
*nOkarlasWAnamunuMdi/nOkarlasWAnaMnuMdi/nOkarlasWAnamunuMci/nOkarlasWAnaMnuMci/nOkarlasWAnaMlonuMdi/nOkarlasWAnamulonuMdi/nOkarlasWAnaMlonuMci/nOkarlasWAnamulonuMci	n number bahu parsarg sWAnaMnuMdi 
*nOkarlayaMxu/nOkarlaMxu	n number bahu parsarg aMxu 
*nOkarlaMte/nOkarlaMteV	n number bahu parsarg aMte 
*nOkarlakaMteV/nOkarlakaMte/nOkarlakanna/nOkarulakannA/nOkarlakannA	n number bahu parsarg kaMteV 
*nOkarlEna	n number bahu parsarg Ena 
*nOkarlapAti	n number bahu parsarg pAti 
*nOkarlalAMti/nOkarlalAti	n number bahu parsarg lAMti 
*nOkarlugAnI/nOkarlukAnI	n number bahu parsarg gAni 
*nOkarlugA	n number bahu parsarg gA 
