noun	
pUvu	
*pUvu	n number eka parsarg 0  case d
pU/*pUvU/pUvA	n number eka parsarg I 
-	n number eka parsarg gA 
*pUvugAdu	n number eka parsarg gAdu  case d
*pUvugawweV	n number eka parsarg gawweV  case d
*pUvuvAdu	n number eka parsarg vAdu  case d
*pUvAyana	n number eka parsarg Ayana  case d
*pUvuvAru	n number eka parsarg vAru  case d
*pUvuxi	n number eka parsarg xi  case d
*pUvuvi/pUviy	n number eka parsarg vi  case d
*pUvugAru	n number eka parsarg gAru  case d
*pUvunu	n number eka parsarg nu 
*pUvuvu	n number eka parsarg vu  case d
*pUvuyoVkka	n number eka parsarg yoVkka 
*pUvu/pU	n number eka parsarg obl 
pUvuni/*pUvunu	n number eka parsarg ni 
*pUvuki/pUvuku	n number eka parsarg ki 
*pUvuwo/pUvuwoda/pUvuwoti	n number eka parsarg wo 
*pUvulo/pUvulona/pUvulopala	n number eka parsarg lo 
*pUvuloni/pUvulopali/pUvunaMxali	n number eka parsarg loni 
*pUvumIxa	n number eka parsarg mIxa 
*pUvuna	n number eka parsarg na 
pUvuniMci/pUvunuMci/*pUvunuMdi	n number eka parsarg niMci 
*pUvuxvArA	n number eka parsarg xvArA 
*pUvuvalana/pUvuvalla	n number eka parsarg valana 
*pUvunubatti/pUvunibatti	n number eka parsarg batti 
pUvuce/*pUvucewa	n number eka parsarg ce 
*pUvuwopAtu	n number eka parsarg wopAtu 
*pUvuwokUdi/pUvuwokUda/pUvuwokUdA/pUvuwogUdi/pUvuwogUda/pUvuwogUdA	n number eka parsarg wokUdi 
*pUvukosaM/pUvukE/pUvArWaM	n number eka parsarg kosaM 
*pUvukoVraku/pUvukoVrYaku	n number eka parsarg koVraku 
*pUvulonuMdi/pUvulonuMci	n number eka parsarg lonuMdi 
*pUvumIxanuMdi/pUvumIxanuMci	n number eka parsarg mIxanuMdi 
*pUvuxAkA/pUvuxAka	n number eka parsarg xAkA 
*pUvuvaraku	n number eka parsarg varaku 
*pUvumIxaki/pUvumIxaku	n number eka parsarg mIxaki 
*pUvuxaggara/pUvuxaggira	n number eka parsarg xaggara 
*pUvuvaxxa/pUvuyoVxxa	n number eka parsarg vaxxa 
*pUvukAda	n number eka parsarg kAda 
*pUvukeVxurugA/pUveVxurugA	n number eka parsarg keVxurugA 
*pUvumuMxu	n number eka parsarg muMxu 
*pUvuguriMci/pUvunuguriMci/pUvuniguriMci/pUvunigUrci	n number eka parsarg guriMci 
pUvupE/*pUvupEna/pUvupEni	n number eka parsarg pE 
*pUvupEki	n number eka parsarg pEki 
*pUvuguMdA	n number eka parsarg guMdA 
pUvulA/pUvulAga/*pUvulAgA/pUvugA	n number eka parsarg lA 
pUvuvale/pUvumAxiri/pUvunipolina/pUvunupolina/*pUvuvaleV/pUvunibolina/pUvunubolina	n number eka parsarg vale 
pUvukimalle/pUvukumalle/pUvukumalleV/*pUvukimalleV	n number eka parsarg kimalle 
*pUvukUdA/pUvukUda/pUvugUdA/pUvugUda	n number eka parsarg kUdA 
*pUvuxqRtilo/pUvuxruRtilo	n number eka parsarg xqRtilo 
*pUvulekuMdA/pUvunilekuMdA/pUvuleka	n number eka parsarg lekuMdA 
*pUvukAkuMdA/pUvunikAkuMdA/pUvukAka	n number eka parsarg kAkuMdA 
*pUvumoVxalukoVni/pUvunimoVxalukoVni	n number eka parsarg moVxalukoVni 
*pUvuvEpu/pUvuvepu/pUvukesi	n number eka parsarg vEpu 
pUvupakka/pUvuprakka/pUvupakkana/*pUvuprakkana	n number eka parsarg pakka 
pUvupakkalo/*pUvuprakkalo	n number eka parsarg pakkalo 
*pUvuloki/pUvuloniki/pUvulopaliki/pUvulopalaku	n number eka parsarg lopalaki 
pUvukiMxa/*pUvukriMxa/pUvukriMxane/pUvukiMxane	n number eka parsarg kiMxa 
pUvaduguna/*pUvukaduguna	n number eka parsarg aduguna 
*pUvukeVlla/pUvukalla	n number eka parsarg kalla 
pUvuveVnuka/*pUvuveVnakAla/pUvuveVnakAwala	n number eka parsarg veVnuka 
pUvuwaravAwa/pUvuwarvAwa/*pUvuwaruvAwa	n number eka parsarg waravAwa 
pUveVxuruguMdA/*pUvukeVxuruguMdA	n number eka parsarg eVxuruguMdA 
pUvumaXya/*pUvumaXyalo/pUvumaXyana	n number eka parsarg maXya 
*pUvunaduma/pUvunadama	n number eka parsarg naduma 
pUvubaxulugA/pUvubaxulu/*pUvukibaxulu/pUvunibaxulu	n number eka parsarg baxulugA 
*pUvucotlo/pUvucotulo/pUvucotuna	n number eka parsarg cotlo 
pUvusWAnaMlo/*pUvusWAnamulo	n number eka parsarg sWAnaMlo 
pUvunerugA/pUvukunerugA/*pUvukinerugA	n number eka parsarg nerugA 
*pUvuprakAraM/pUvuprakAramu	n number eka parsarg prakAraM 
*pUvuxaggaranuMdi/pUvuxaggaranuMci/pUvuxaggiranuMdi/pUvuxaggaranuMci	n number eka parsarg xaggaranuMdi 
*pUvuvaxxanuMdi/pUvuvaxxanuMci	n number eka parsarg vaxxanuMdi 
*pUvupakkanuMdi/pUvupakkanuMci/pUvupakkalonuMdi/pUvupakkalonuMci	n number eka parsarg pakkanuMdi 
*pUvulopalanuMdi/pUvulopalinuMdi/pUvulopalanuMci/pUvulopalinuMci	n number eka parsarg lopalanuMdi 
*pUvubEtanuMdi/pUvubEtanuMci	n number eka parsarg bEtanuMdi 
*pUvupEnuMdi/pUvupEnuMci	n number eka parsarg pEnuMdi 
pUvukiMxanuMdi/pUvukiMxanuMci/*pUvukriMxanuMdi/pUvukriMxanuMci	n number eka parsarg kriMxanuMdi 
pUvaduguniMci/pUvadugunuMdi/*pUvukadugunuMdi/pUvukadugunuMci	n number eka parsarg adugunuMdi 
*pUvukimuMxunuMdi/pUvumuMxunuMci/pUvukumuMxunuMci/pUvukumuMxunuMdi	n number eka parsarg muMxunuMdi 
pUvuveVnakanuMdi/pUvuveVnukanuMci/pUvuveVnakAwalanuMdi/pUvuveVnakAwalanuMci/pUvuveVnakanuMci/pUvuveVnukanuMci/*pUvuveVnakAlanuMdi/pUvuveVnakAlanuMci/pUvuveVnakAwalanuMdi	n number eka parsarg veVnukanuMdi 
pUveVxutinuMdi/pUveVxutanuMci/*pUvukeVxutinuMci	n number eka parsarg eVxutinuMdi 
*pUvumaXyanuMdi/pUvumaXyanuMci/pUvumaXyalonuMdi/pUvumaXyalonuMci	n number eka parsarg maXyanuMdi 
*pUvunadumanuMdi/pUvunadumanuMci	n number eka parsarg nadumanuMdi 
*pUvuwaravAwanuMdi/pUvuwarvAwanuMdi/pUvuwarAwanuMdi/pUvuwarvAwanuMci	n number eka parsarg waravAwanuMdi 
*pUvucotlonuMdi/pUvucotunuMdi/pUvucotlonuMci/pUvucotunuMci	n number eka parsarg cotlonuMdi 
pUvusWAnaMnuMdi/*pUvusWAnamunuMdi/pUvusWAnaMnuMci/pUvusWAnamunuMci/pUvusWAnaMlonuMdi/pUvusWAnamulonuMdi/pUvusWAnaMlonuMci/pUvusWAnamulonuMci	n number eka parsarg sWAnaMnuMdi 
pUvaMxu/pUvunaMxu/*pUvuyaMxu	n number eka parsarg aMxu 
pUvaMte/*pUvaMteV	n number eka parsarg aMte 
pUvukaMte/*pUvukaMteV/pUvukanna/pUvukannA	n number eka parsarg kaMteV 
*pUvEna	n number eka parsarg Ena 
*pUvupAti	n number eka parsarg pAti 
*pUvulAMti/pUvulAti	n number eka parsarg lAMti 
*pUvugAnI/pUvukAnI	n number eka parsarg gAni 
*pUvugA	n number eka parsarg gA 
*pUlu/pUvulu	n number bahu parsarg 0  case d
*pUlU/pUvulU	n number bahu parsarg I  case d
-	n number bahu parsarg gA 
*pUlagAdu/pUvulagAdu	n number bahu parsarg gAdu  case d
*pUlagawweV/pUvulagawweV	n number bahu parsarg gawweV  case d
*pUlavAdu/pUvulavAdu	n number bahu parsarg vAdu  case d
*pUlAyana/pUvulAyana	n number bahu parsarg Ayana  case d
*pUlavAru/pUvulavAru	n number bahu parsarg vAru  case d
*pUlaxi/pUvulaxi	n number bahu parsarg xi  case d
pUlavi/pUlayyi/pUlay/*pUvulavi/pUvulayyi/pUvulay	n number bahu parsarg vi  case d
*pUlagAru/pUvulagAru	n number bahu parsarg gAru  case d
pUlaM/pUlamu/*pUvulaM/pUvulamu	n number bahu parsarg nu  case d
-	n number bahu parsarg vu 
*pUvulayoVkka/pUlayoVkka	n number bahu parsarg yoVkka 
*pUla/pUvula	n number bahu parsarg obl 
pUlani/*pUlanu/pUvulani/pUvulanu/pUvulni/pUvulni	n number bahu parsarg ni 
*pUlaki/pUlaku/pUvulaki/pUvulaku	n number bahu parsarg ki 
*pUlawo/pUlawoda/pUlawoti/pUvulawo/pUvulawoda/pUvulawoti	n number bahu parsarg wo 
pUlalo/*pUlallo/pUlallona/pUlalona/pUlalopala/pUlallopala/pUvulalo/pUvulallo/pUvulallona/pUvulalona/pUvulalopala/pUvulallopala	n number bahu parsarg lo 
pUlaloni/pUlayaMxali/*pUlalloni/pUlalopali/pUlallopali/pUvulaloni/pUvulayaMxali/pUvulalloni/pUvulalopali/pUvulallopali	n number bahu parsarg loni 
*pUlamIxa/pUvulamIxa	n number bahu parsarg mIxa 
*pUlana/pUvulana	n number bahu parsarg na 
pUlaniMci/pUlanuMci/*pUlanuMdi/pUvulaniMci/pUvulanuMci/pUvulanuMdi	n number bahu parsarg niMci 
*pUlaxvArA/pUvulaxvArA	n number bahu parsarg xvArA 
*pUlavalana/pUlavalla/pUvulavalana/pUvulavalla	n number bahu parsarg valana 
*pUlanubatti/pUlanibatti/pUvulanubatti/pUvulanibatti	n number bahu parsarg batti 
*pUlacewa/pUlace/pUvulacewa/pUvulace	n number bahu parsarg ce 
*pUlawopAtu/pUlawobAtu/pUvulawopAtu/pUvulawobAtu	n number bahu parsarg wopAtu 
*pUlawokUdi/pUlawokUda/pUlawokUdA/pUlawogUdi/pUlawogUda/pUlawogUdA/pUvulawokUdi/pUvulawokUda/pUvulawokUdA/pUvulawogUdi/pUvulawogUda/pUvulawogUdA	n number bahu parsarg wokUdi 
*pUlakosaM/pUlakE/pUlakosamu/pUvulakosaM/pUvulakE/pUvulakosamu/pUvulArWaM	n number bahu parsarg kosaM 
*pUlakoVraku/pUlakoVrYaku/pUvulakoVraku/pUvulakoVrYaku	n number bahu parsarg koVraku 
*pUlalonuMdi/pUlalonuMci/pUlaloniMci/pUvulalonuMdi/pUvulalonuMci/pUvulaloniMci	n number bahu parsarg lonuMdi 
*pUlamIxanuMdi/pUlamIxanuMci/pUvulamIxanuMdi/pUvulamIxanuMci	n number bahu parsarg mIxanuMdi 
*pUlaxAkA/pUvulaxAkA	n number bahu parsarg xAkA 
*pUlavaraku/pUvulavaraku	n number bahu parsarg varaku 
*pUlamIxaki/pUlamIxaku/pUvulamIxaki/pUvulamIxaku	n number bahu parsarg mIxaki 
*pUlaxaggara/pUlaxaggira/pUvulaxaggara/pUvulaxaggira	n number bahu parsarg xaggara 
*pUlavaxxa/pUloVxxa/pUvulavaxxa/pUvuloVxxa	n number bahu parsarg vaxxa 
*pUlakAda/pUvulakAda	n number bahu parsarg kAda 
*pUlakeVxurugA/pUleVxurugA/pUvulakeVxurugA/pUvuleVxurugA	n number bahu parsarg keVxurugA 
*pUlamuMxu/pUvulamuMxu	n number bahu parsarg muMxu 
*pUlaguriMci/pUlagUrci/pUlanuguriMci/pUlanigUrci/pUlanugUrci/pUvulaguriMci/pUvulagUrci/pUvulanuguriMci/pUvulanigUrci/pUvulanugUrci	n number bahu parsarg guriMci 
pUlapE/pUlapEni/*pUlapEna/pUvulapE/pUvulapEni/pUvulapEna	n number bahu parsarg pE 
*pUlapEki/pUvulapEki	n number bahu parsarg pEki 
*pUlaguMdA/pUvulaguMdA	n number bahu parsarg guMdA 
pUlalA/pUlallA/pUlalAga/pUlalAgA/*pUlallAga/pUlallAgA/pUvulalA/pUvulallA/pUvulalAga/pUvulalAgA/pUvulallAga/pUvulallAgA	n number bahu parsarg lA 
pUlavale/*pUlavaleV/pUlamAxiri/pUlanipolina/pUlanupolina/pUlanibolina/pUlanubolina/pUvulavale/pUvulavaleV/pUvulamAxiri/pUvulanipolina/pUvulanupolina/pUvulanibolina/pUvulanubolina	n number bahu parsarg vale 
pUlakumalle/*pUlakumalleV/pUvulakumalle/pUvulakumalleV	n number bahu parsarg kimalle 
pUlanukUdA/pUlakUdA/pUlanugUdA/pUlugUdA/*pUlukUdA/pUvulanukUdA/pUvulakUdA/pUvulanugUdA/pUvulugUdA/pUvulukUdA	n number bahu parsarg kUdA 
*pUlaxqRtilo/pUlaxruRtilo/pUvulaxqRtilo/pUvulaxruRtilo	n number bahu parsarg xqRtilo 
*pUlulekuMdA/pUlulekuMda/pUluleka/pUvululekuMdA/pUvululekuMda/pUvululeka	n number bahu parsarg lekuMdA 
*pUlukAkuMdA/pUlukAkuMda/pUlukAka/pUvulukAkuMdA/pUvulukAkuMda/pUvulukAka	n number bahu parsarg kAkuMdA 
*pUlumoVxalukoVni/pUvulumoVxalukoVni	n number bahu parsarg moVxalukoVni 
*pUlavEpu/pUlavepu/pUlakesi/pUvulavEpu/pUvulavepu/pUvulakesi	n number bahu parsarg vEpu 
pUlapakka/pUlapakkana/pUlaprakka/*pUlaprakkana/pUvulapakka/pUvulapakkana/pUvulaprakka/pUvulaprakkana	n number bahu parsarg pakka 
*pUlapakkalo/pUvulapakkalo	n number bahu parsarg pakkalo 
*pUlaloki/pUlaloniki/pUvulaloki/pUvulaloniki/pUlalopalaki/pUlalopaliki/pUlalopalaku/pUvulalopalaki/pUvulalopaliki/pUvulalopalaku	n number bahu parsarg lopalaki 
pUlakiMxa/*pUlakriMxa/pUvulakiMxa/pUvulakriMxa/pUlakriMxane/pUlakiMxane/pUvulakriMxane/pUvulakiMxane	n number bahu parsarg kiMxa 
pUladuguna/*pUlakaduguna/pUvuladuguna/pUvulakaduguna	n number bahu parsarg aduguna 
*pUlakeVlla/pUlakalla/pUvulakeVlla/pUvulakalla	n number bahu parsarg kalla 
pUlaveVnuka/pUlaveVnaka/*pUlaveVnakAla/pUlaveVnukAla/pUlaveVnakAwala/pUlaveVnukAwala/pUvulaveVnuka/pUvulaveVnaka/pUvulaveVnakAla/pUvulaveVnukAla/pUvulaveVnakAwala/pUvulaveVnukAwala	n number bahu parsarg veVnuka 
pUlawaravAwa/pUlawarvAwa/*pUlawaruvAwa/pUvulawaravAwa/pUvulawarvAwa/pUvulawaruvAwa	n number bahu parsarg waravAwa 
pUleVxuruguMdA/*pUlakeVxuruguMdA/pUvuleVxuruguMdA/pUvulakeVxuruguMdA	n number bahu parsarg eVxuruguMdA 
*pUlamaXya/pUlamaXyana/pUlamaXyalo/pUvulamaXya/pUvulamaXyana/pUvulamaXyalo	n number bahu parsarg maXya 
*pUlanaduma/pUlakinaduma/pUvulanaduma/pUvulakinaduma	n number bahu parsarg naduma 
pUlabaxulugA/pUlakibaxulugA/pUlabaxulu/*pUlakibaxulu/pUvulabaxulugA/pUvulakibaxulugA/pUvulabaxulu/pUvulakibaxulu	n number bahu parsarg baxulugA 
*pUlacotlo/pUlacotulo/pUvulacotlo/pUvulacotulo	n number bahu parsarg cotlo 
pUlasWAnaMlo/pUlaswAnaMlo/*pUlasWAnamulo/pUvulasWAnaMlo/pUvulaswAnaMlo/pUvulasWAnamulo	n number bahu parsarg sWAnaMlo 
pUlanerugA/pUlakunerugA/*pUlakinerugA/pUvulanerugA/pUvulakunerugA/pUvulakinerugA	n number bahu parsarg nerugA 
*pUlaprakAraM/pUlanubatti/pUlabatti/pUlanibatti/pUvulaprakAraM/pUvulanubatti/pUvulabatti/pUvulanibatti	n number bahu parsarg prakAraM 
*pUlaxaggaranuMdi/pUlaxaggiranuMdi/pUlaxaggaranuMci/pUlaxaggiranuMci/pUvulaxaggaranuMdi/pUvulaxaggiranuMdi/pUvulaxaggaranuMci/pUvulaxaggiranuMci	n number bahu parsarg xaggaranuMdi 
*pUlavaxxanuMdi/pUlavaxxanuMci/pUvulavaxxanuMdi/pUvulavaxxanuMci	n number bahu parsarg vaxxanuMdi 
*pUlapakkanuMdi/pUlapakkanuMci/pUvulapakkanuMdi/pUvulapakkanuMci/pUlapakkalonuMdi/pUlapakkalonuMci/pUvulapakkalonuMdi/pUvulapakkalonuMci	n number bahu parsarg pakkanuMdi 
*pUlalopalanuMdi/pUlalopalinuMdi/pUlalopalinuMci/pUlalopalanuMci/pUlalopalinuMdi/pUlalopalinuMci/pUvulalopalanuMdi/pUvulalopalanuMdi/pUvulalopalanuMci/pUvulalopalanuMci/pUvulalopalinuMdi/pUvulalopalinuMci	n number bahu parsarg lopalanuMdi 
*pUlabEtanuMdi/pUlabEtanuMci/pUlabEtaniMci/pUvulabEtanuMdi/pUvulabEtanuMci/pUvulabEtaniMci	n number bahu parsarg bEtanuMdi 
*pUlapEnuMdi/pUlapEnuMci/pUlapEniMci/pUvulapEnuMdi/pUvulapEnuMci/pUvulapEniMci	n number bahu parsarg pEnuMdi 
pUlakiMxanuMdi/pUlakiMxanuMci/pUlakiMxaniMci/pUvulakiMxanuMdi/pUvulakiMxanuMci/pUvulakiMxaniMci/*pUlakriMxanuMdi/pUlakriMxanuMci/pUlakriMxaniMci/pUvulakriMxanuMdi/pUvulakriMxanuMci/pUvulakriMxaniMci	n number bahu parsarg kriMxanuMdi 
*pUladugunuMdi/pUladugunuMci/pUladuguniMci/pUvuladugunuMdi/pUvuladugunuMci/pUvuladuguniMci	n number bahu parsarg adugunuMdi 
*pUlamuMxunuMdi/pUlamuMxunuMci/pUlamuMxuniMci/pUvulamuMxunuMdi/pUvulamuMxunuMci/pUvulamuMxuniMci	n number bahu parsarg muMxunuMdi 
pUlaveVnukanuMdi/pUlaveVnakanuMdi/*pUlaveVnakAlanuMdi/pUvulaveVnukanuMdi/pUvulaveVnakanuMdi/pUvulaveVnakAlanuMdi/pUlaveVnakAlanuMci/pUlaveVnukanuMci/pUlaveVnakanuMci/pUlaveVnakAwalanuMdi/pUlaveVnakAwalanuMci/pUvulaveVnakAlanuMci/pUvulaveVnukanuMci/pUvulaveVnakanuMci/pUvulaveVnakAwalanuMdi/pUvulaveVnakAwalanuMci	n number bahu parsarg veVnukanuMdi 
pUleVxutinuMdi/*pUlakeVxutinuMdi/pUleVxutinuMci/pUlakeVxutinuMci/pUvuleVxutinuMdi/pUvulakeVxutinuMdi/pUvuleVxutinuMci/pUvulakeVxutinuMci	n number bahu parsarg eVxutinuMdi 
*pUlamaXyanuMdi/pUlamaXyanuMci/pUlamaXyaniMci/pUvulamaXyanuMdi/pUvulamaXyanuMci/pUvulamaXyaniMci/pUlamaXyalonuMdi/pUlamaXyalonuMci/pUlamaXyaloniMci/pUvulamaXyalonuMdi/pUvulamaXyalonuMci/pUvulamaXyaloniMci	n number bahu parsarg maXyanuMdi 
*pUlanadumanuMdi/pUlanadamanuMdi/pUlanadumanuMci/pUlanadamanuMci/pUvulanadumanuMdi/pUvulanadamanuMdi/pUvulanadumanuMci/pUvulanadamanuMci	n number bahu parsarg nadumanuMdi 
*pUlawaravAwanuMdi/pUlawarvAwanuMdi/pUlawaravAwanuMci/pUlawarvAwanuMci/pUvulawaravAwanuMdi/pUvulawarvAwanuMdi/pUvulawaravAwanuMci/pUvulawarvAwanuMci	n number bahu parsarg waravAwanuMdi 
pUlacotunuMdi/pUlacotunuMci/pUlacotuniMci/*pUlacotlonuMdi/pUlacotlonuMci/pUlacotloniMci/pUvulacotunuMdi/pUvulacotunuMci/pUvulacotuniMci/pUvulacotlonuMdi/pUvulacotlonuMci/pUvulacotloniMci	n number bahu parsarg cotlonuMdi 
*pUlasWAnamunuMdi/pUlasWAnaMnuMdi/pUlasWAnamunuMci/pUlasWAnaMnuMci/pUvulasWAnamunuMdi/pUvulasWAnaMnuMdi/pUvulasWAnamunuMci/pUvulasWAnaMnuMci/pUlasWAnaMlonuMdi/*pUlasWAnamulonuMdi/pUvulasWAnaMlonuMdi/pUvulasWAnamulonuMdi/pUlasWAnaMlonuMci/*pUlasWAnamulonuMci/pUvulasWAnaMlonuMci/pUvulasWAnamulonuMci	n number bahu parsarg sWAnaMnuMdi 
*pUlayaMxu/pUlaMxu/pUvulayaMxu/pUvulaMxu	n number bahu parsarg aMxu 
pUlaMte/*pUlaMteV/pUvulaMte/pUvulaMteV	n number bahu parsarg aMte 
*pUlakaMteV/pUlakaMte/pUlakanna/pUlakannA/pUvulakaMteV/pUvulakaMte/pUvulakanna/pUvulakannA	n number bahu parsarg kaMteV 
*pUlEna/pUvulEna	n number bahu parsarg Ena 
*pUlapAti/pUvulapAti	n number bahu parsarg pAti 
*pUlalAMti/pUlalAti/pUvulalAMti/pUvulalAti	n number bahu parsarg lAMti 
*pUlugAnI/pUlukAnI/pUvulugAnI/pUvulukAnI	n number bahu parsarg gAni 
pUlugA/*pUvulugA	n number bahu parsarg gA 
