noun	
pani	
*pani	n number eka parsarg 0  case d
-	n number eka parsarg I 
-	n number eka parsarg gA 
*panigAdu	n number eka parsarg gAdu  case d
*panigawweV	n number eka parsarg gawweV  case d
*panivAdu	n number eka parsarg vAdu  case d
*panAyana	n number eka parsarg Ayana  case d
*panivAru	n number eka parsarg vAru  case d
*panixi	n number eka parsarg xi  case d
*panivi/paniy	n number eka parsarg vi  case d
*panigAru	n number eka parsarg gAru  case d
*panini/paninu	n number eka parsarg nu 
panivu/*panivi	n number eka parsarg vu  case d
*paniyoVkka	n number eka parsarg yoVkka 
*pani	n number eka parsarg obl 
*panini/paninu	n number eka parsarg ni 
*paniki/paniku	n number eka parsarg ki 
*paniwo/paniwoda/paniwoti	n number eka parsarg wo 
panilo/panilona/*panilopala	n number eka parsarg lo 
paniloni/*panilopali/paniyaMxali	n number eka parsarg loni 
*panimIxa	n number eka parsarg mIxa 
*panina	n number eka parsarg na 
paniniMci/paninuMci/*paninuMdi	n number eka parsarg niMci 
*panixvArA/panixvAra	n number eka parsarg xvArA 
*panivalana/panivalla	n number eka parsarg valana 
*paninibatti	n number eka parsarg batti 
panice/*panicewa	n number eka parsarg ce 
*paniwopAtu/paniwobAtu	n number eka parsarg wopAtu 
paniwokUdi/paniwokUda/*paniwokUdA/paniwogUdi/paniwogUda/paniwogUdA	n number eka parsarg wokUdi 
*panikosaM/panikE/panArWaM	n number eka parsarg kosaM 
*panikoVraku/panikoVrYaku	n number eka parsarg koVraku 
*panilonuMdi/panilonuMci/paniloniMci	n number eka parsarg lonuMdi 
*panimIxanuMdi/panimIxanuMci/panimIxaniMci	n number eka parsarg mIxanuMdi 
*panixAkA/panixAka	n number eka parsarg xAkA 
*panivaraku	n number eka parsarg varaku 
*panimIxaki/panimIxaku/panimIxiki	n number eka parsarg mIxaki 
*panixaggara/panixaggira	n number eka parsarg xaggara 
*panivaxxa/panoVxxa	n number eka parsarg vaxxa 
*panikAda	n number eka parsarg kAda 
*panikeVxurugA/paneVxurugA	n number eka parsarg keVxurugA 
*panimuMxu	n number eka parsarg muMxu 
*paniguriMci/paniniguriMci/paninigUrci	n number eka parsarg guriMci 
panipE/*panipEna/panipEni	n number eka parsarg pE 
*panipEki	n number eka parsarg pEki 
*paniguMdA	n number eka parsarg guMdA 
panilA/panilAga/*panilAgA	n number eka parsarg lA 
*panivale/panivaleV/panimAxiri/paninipolina/paninibolina	n number eka parsarg vale 
*panikimalle/panikumalle	n number eka parsarg kimalle 
*panikUdA/paninikUdA/paninukUdA/panigUdA/paninigUdA	n number eka parsarg kUdA 
*panixqRtilo/panixruRtilo	n number eka parsarg xqRtilo 
*panilekuMdA/paninilekuMdA/panilekuMda	n number eka parsarg lekuMdA 
*panikAkuMdA/paninikAkuMdA/panikAkuMda/panikAka/panigAka/panigAkuMdA	n number eka parsarg kAkuMdA 
*panimoVxalukoVni/paninimoVxalukoVni/paninumoVxalukoVni	n number eka parsarg moVxalukoVni 
*panivEpu/panivepu	n number eka parsarg vEpu 
panipakka/paniprakka/panipakkana/*paniprakkana/panipakkani	n number eka parsarg pakka 
panipakkalo/*paniprakkalo/panipakkalona/panipakkaloni	n number eka parsarg pakkalo 
paniloki/paniloniki/*panilopalaki/panilopalaku/panilopaliki	n number eka parsarg lopalaki 
panikiMxa/*panikriMxa/panikriMxane/panikiMxane	n number eka parsarg kiMxa 
panaduguna/*panikaduguna	n number eka parsarg aduguna 
panikeVlla/*panikalla	n number eka parsarg kalla 
paniveVnuka/paniveVnaka/paniveVnakAwala/*paniveVnakAla/paniveVnakana	n number eka parsarg veVnuka 
paniwaravAwa/paniwarvAwa/*paniwaruvAwa/paniwaravAwana/paniwarvAwana/paniwaruvAwana	n number eka parsarg waravAwa 
paneVxuruguMdA/*panikeVxuruguMdA	n number eka parsarg eVxuruguMdA 
*panimaXya/panimaXyalo/panimaXyana	n number eka parsarg maXya 
*paninaduma/paninadumana	n number eka parsarg naduma 
panibaxulugA/panibaxulu/*panikibaxulu/panikubaxulu	n number eka parsarg baxulugA 
*panicotlo/panicotulo/panicotuna/panicota	n number eka parsarg cotlo 
*panisWAnaMlo/paniswAnaMlo	n number eka parsarg sWAnaMlo 
paninerugA/panikunerugA/*panikinerugA	n number eka parsarg nerugA 
*paniprakAraM/paniprakAramu	n number eka parsarg prakAraM 
*panixaggaranuMdi/panixaggaranuMci/panixaggiranuMdi/panixaggiranuMci	n number eka parsarg xaggaranuMdi 
*panivaxxanuMdi/panivaxxanuMci/panivaxxaniMci	n number eka parsarg vaxxanuMdi 
*panipakkanuMdi/panipakkanuMci/panipakkaniMci/panipakkalonuMdi/panipakkalonuMci/panipakkaloniMci	n number eka parsarg pakkanuMdi 
*panilopalanuMdi/panilopalinuMdi/panilopalanuMci/panilopalinuMci/panilopalaniMci	n number eka parsarg lopalanuMdi 
*panibEtanuMdi/panibEtanuMci/panibEtaniMci	n number eka parsarg bEtanuMdi 
*panipEnuMdi/panipEnuMci/panipEniMci	n number eka parsarg pEnuMdi 
panikiMxanuMdi/panikiMxanuMci/panikiMxaniMci/*panikriMxanuMdi/panikriMxanuMci/panikriMxaniMci	n number eka parsarg kriMxanuMdi 
panadugunuMdi/panadugunuMci/*panikadugunuMdi/panikadugunuMci/panikaduguniMci	n number eka parsarg adugunuMdi 
*panimuMxunuMdi/panimuMxunuMci/panimuMxuniMci	n number eka parsarg muMxunuMdi 
paniveVnukanuMdi/*paniveVnakAlanuMdi/paniveVnakAwalanuMdi/paniveVnakanuMdi/paniveVnukanuMci/paniveVnakAlanuMci/paniveVnakAwalanuMci/paniveVnakanuMci	n number eka parsarg veVnukanuMdi 
paneVxutinuMdi/*panikeVxutinuMdi/panikeVxutinuMci/paneVxutinuMci/panikeVxutiniMci/paneVxutiniMci	n number eka parsarg eVxutinuMdi 
*panimaXyanuMdi/panimaXyanuMci/panimaXyalonuMdi/panimaXyalonuMci	n number eka parsarg maXyanuMdi 
*paninadumanuMdi/paninadumanuMci	n number eka parsarg nadumanuMdi 
*paniwaravAwanuMdi/paniwarvAwanuMdi/paniwaravAwanuMci/paniwarvAwanuMci	n number eka parsarg waravAwanuMdi 
*panicotlonuMdi/panicotunuMdi/panicotlonuMci/panicotunuMci	n number eka parsarg cotlonuMdi 
panisWAnaMnuMdi/*panisWAnamunuMdi/panisWAnaMnuMci/panisWAnamunuMci/panisWAnaMlonuMdi/panisWAnamulonuMdi/panisWAnaMlonuMci/panisWAnamulonuMci	n number eka parsarg sWAnaMnuMdi 
panaMxu/paninaMxu/*paniyaMxu	n number eka parsarg aMxu 
*panaMte/panaMteV	n number eka parsarg aMte 
*panikaMteV/panikaMte/panikanna/panikannA	n number eka parsarg kaMteV 
*panEna	n number eka parsarg Ena 
*panipAti	n number eka parsarg pAti 
*panilAMti/panilAti	n number eka parsarg lAMti 
*panigAnI/panikAnI	n number eka parsarg gAni 
*panigA	n number eka parsarg gA 
panlu/*panulu	n number bahu parsarg 0  case d
panlU/*panulArA/panlArA/panulU	n number bahu parsarg I  case d
-	n number bahu parsarg gA 
panlagAdu/*panulagAdu	n number bahu parsarg gAdu  case d
panlagawweV/*panulagawweV	n number bahu parsarg gawweV  case d
panlavAdu/*panulavadu	n number bahu parsarg vAdu  case d
panlAyana/*panulAyana	n number bahu parsarg Ayana  case d
panlavAru/*panulavAru	n number bahu parsarg vAru  case d
panlaxi/*panulaxi	n number bahu parsarg xi  case d
panlavi/*panulavi/panlay/panulay	n number bahu parsarg vi  case d
panlagAru/*panulagAru	n number bahu parsarg gAru  case d
panlaM/panlamu/*panulaM/panulamu	n number bahu parsarg nu  case d
panlu/*panulu	n number bahu parsarg vu 
*panulayoVkka/panlayoVkka	n number bahu parsarg yoVkka 
panla/*panula	n number bahu parsarg obl 
panlani/panlanu/*panulani/panulanu/panulni	n number bahu parsarg ni 
panlaki/panlaku/*panulaki/panulaku	n number bahu parsarg ki 
*panlawo/panlawoda/panlawoti/panlawoni/panulawo/panulawoda/panulawoti/panulawoni	n number bahu parsarg wo 
panulallo/panlalo/panulalo/panlalona/panulalona/panlalopala/*panulalopala	n number bahu parsarg lo 
panlaloni/panulaloni/*panlalopali/panulayaMxali/panulalopali	n number bahu parsarg loni 
panlamIxa/*panulamIxa	n number bahu parsarg mIxa 
*panulana/panlana	n number bahu parsarg na 
panlaniMci/panulaniMci/panlanuMci/panulanuMci/*panulanuMdi/panlanuMdi	n number bahu parsarg niMci 
panlaxvArA/panlaxvAra/*panulaxvArA/panulaxvAra	n number bahu parsarg xvArA 
panlavalana/panlavalla/*panulavalana/panulavalla	n number bahu parsarg valana 
*panulanubatti/panlanubatti/panulnibatti	n number bahu parsarg batti 
panlacewa/panlace/panulace/*panulacewa/panulace	n number bahu parsarg ce 
panlawopAtu/*panulawopAtu	n number bahu parsarg wopAtu 
*panlawokUdi/panulawokUdi/panlawokUda/panlawokUdA/panulawokUdA	n number bahu parsarg wokUdi 
panlakosaM/panlakE/*panulakosaM/panulakE/panulArWaM	n number bahu parsarg kosaM 
panlakoVraku/panlakoVrYaku/*panulakoVraku/panulakoVrYaku	n number bahu parsarg koVraku 
panlalonuMdi/panlalonuMci/*panulalonuMdi/panulalonuMci/panulaloniMci/panlaloniMci	n number bahu parsarg lonuMdi 
panlamIxanuMdi/panlamIxanuMci/panlamIxaniMci/*panulamIxanuMdi/panulamIxanuMci/panulamIxaniMci	n number bahu parsarg mIxanuMdi 
panlaxAkA/panlaxAka/*panulaxAkA/panulaxAka	n number bahu parsarg xAkA 
panlavaraku/*panulavaraku	n number bahu parsarg varaku 
panlamIxaki/panlamIxaku/panulamIxiki/*panulamIxaki/panulamIxaku/panlamIxiki	n number bahu parsarg mIxaki 
panlaxaggara/panlaxaggira/*panulaxaggara/panulaxaggira	n number bahu parsarg xaggara 
panlavaxxa/panloVxxa/*panulavaxxa/panuloVxxa	n number bahu parsarg vaxxa 
panlakAda/*panulakAda	n number bahu parsarg kAda 
panleVxurugA/panlakeVxurugA/panuleVxurugA/*panulakeVxurugA	n number bahu parsarg keVxurugA 
panlamuMxu/*panulamuMxu	n number bahu parsarg muMxu 
panlaguriMci/panlagUrci/panlanuguriMci/panulanigUrci/panulaniguriMci/*panulanuguriMci	n number bahu parsarg guriMci 
panlapE/panlapEni/panlapEna/panulapE/panulapEni/*panulapEna	n number bahu parsarg pE 
panlapEki/*panulapEki	n number bahu parsarg pEki 
panlaguMdA/*panulaguMdA	n number bahu parsarg guMdA 
panulalA/panulalAgA/panullA/panlalA/panlalAgA/*panullAgA	n number bahu parsarg lA 
panlavale/panlavaleV/panlamAxiri/panlanupolina/panlanubolina/*panulavale/panulavaleV/panulamAxiri/panulanupolina/panulanubolina	n number bahu parsarg vale 
panlakumalle/*panulakumalle/panlakumalleV/panulakumalleV	n number bahu parsarg kimalle 
panlukUdA/panlugUdA/panlugUda/panlakUda/*panulukUdA/panulugUdA/panulugUda/panulakUda	n number bahu parsarg kUdA 
panlaxqRtilo/panlaxruRtilo/*panulaxqRtilo/panulaxruRtilo	n number bahu parsarg xqRtilo 
panlulekuMdA/panlanulekuMdA/panluleka/*panululekuMdA/panulanulekuMdA/panululeka	n number bahu parsarg lekuMdA 
panlukAkuMdA/panlanukAkuMda/panlukAka/panlugAka/*panulukAkuMdA/panulanukAkuMda/panulukAka/panulugAka	n number bahu parsarg kAkuMdA 
panlumoVxalukoVni/panlanumoVxalukoVni/*panulumoVxalukoVni/panulanumoVxalukoVni	n number bahu parsarg moVxalukoVni 
panlavEpu/panlavepu/*panulavEpu/panulavepu	n number bahu parsarg vEpu 
panlapakka/panlapakkana/panulaprakka/*panulaprakkana	n number bahu parsarg pakka 
panlapakkalo/panlaprakkalo/panulapakkalo/*panulaprakkalo	n number bahu parsarg pakkalo 
panlaloki/panlaloniki/panulaloki/panulaloniki/panlalopalaki/panlalopaliki/*panulalopaliki/panulalopalaku	n number bahu parsarg lopalaki 
panlakiMxa/panlakriMxa/panulakiMxa/*panulakriMxa/panlakriMxana/panlakiMxana/panulakriMxana/panulakiMxana	n number bahu parsarg kiMxa 
panladuguna/panlakaduguna/panuladuguna/*panulakaduguna	n number bahu parsarg aduguna 
panlakeVlla/panlakalla/panulakeVlla/*panulakalla	n number bahu parsarg kalla 
panlaveVnuka/panlaveVnaka/panlaveVnakAla/panulaveVnukAla/panulaveVnuka/panulaveVnaka/*panulaveVnakAla/panulaveVnukAla/panlaveVnakAwala/panulaveVnukAwala/panulaveVnakAwala/panulaveVnukAwala	n number bahu parsarg veVnuka 
panlawaravAwa/panlawarvAwa/*panulawaruvAwa/panulawaravAwa/panulawarvAwa/panlawaravAwa	n number bahu parsarg waravAwa 
panleVxuruguMdA/panlakeVxuruguMdA/panuleVxuruguMdA/*panulakeVxuruguMdA	n number bahu parsarg eVxuruguMdA 
panlamaXya/panlamaXyana/panlamaXyalo/*panulamaXya/panulamaXyana/panulamaXyalo	n number bahu parsarg maXya 
panlanaduma/panlakinaduma/*panulanaduma/panulakinaduma	n number bahu parsarg naduma 
panlabaxulugA/panlakibaxulugA/panlabaxulu/panlakibaxulu/panulabaxulu/panulakubaxulu/*panulakibaxulu	n number bahu parsarg baxulugA 
panlacotlo/panlacotulo/*panulacotlo/panulacotulo	n number bahu parsarg cotlo 
panlasWAnaMlo/panlaswAnaMlo/*panulasWAnamulo/panulasWAnaMlo/panulaswAnaMlo/panlasWAnamulo	n number bahu parsarg sWAnaMlo 
panlanerugA/panlakunerugA/panlakinerugA/panulanerugA/panulakunerugA/*panulakinerugA	n number bahu parsarg nerugA 
panlaprakAraM/panlanubatti/panlabatti/panlanibatti/*panulaprakAraM/panulanubatti/panulabatti/panulanibatti	n number bahu parsarg prakAraM 
panlaxaggaranuMdi/panlaxaggiranuMdi/panlaxaggaranuMci/panlaxaggiranuMci/*panulaxaggaranuMdi/panulaxaggiranuMdi/panulaxaggaranuMci/panulaxaggiranuMci	n number bahu parsarg xaggaranuMdi 
panlavaxxanuMdi/panlavaxxanuMci/*panulavaxxanuMdi/panulavaxxanuMci	n number bahu parsarg vaxxanuMdi 
panlapakkanuMdi/panlapakkanuMci/*panulapakkanuMdi/panulapakkanuMci/panlapakkalonuMdi/panlapakkalonuMci/panulapakkalonuMdi/panulapakkalonuMci	n number bahu parsarg pakkanuMdi 
panlalopalanuMdi/panlalopalanuMci/panlalopalinuMdi/panulalopalinuMci/*panulalopalanuMdi/panulalopalanuMci/panulalopalinuMdi/panulalopalinuMci	n number bahu parsarg lopalanuMdi 
panlabEtanuMdi/panlabEtanuMci/panlabEtaniMci/*panulabEtanuMdi/panulabEtanuMci/panulabEtaniMci	n number bahu parsarg bEtanuMdi 
panlapEnuMdi/panlapEnuMci/panlapEniMci/*panulapEnuMdi/panulapEnuMci/panulapEniMci	n number bahu parsarg pEnuMdi 
panlakiMxanuMdi/panlakiMxanuMci/panlakiMxaniMci/panulakiMxanuMdi/panulakiMxanuMci/panulakiMxaniMci/panlakriMxanuMdi/panlakriMxanuMci/panlakriMxaniMci/*panulakriMxanuMdi/panulakriMxanuMci/panulakriMxaniMci	n number bahu parsarg kriMxanuMdi 
panladugunuMdi/panladugunuMci/panladuguniMci/*panuladugunuMdi/panuladugunuMci/panuladuguniMci	n number bahu parsarg adugunuMdi 
panlamuMxunuMdi/panlamuMxunuMci/panlamuMxuniMci/*panulamuMxunuMdi/panulamuMxunuMci/panulamuMxuniMci	n number bahu parsarg muMxunuMdi 
panlaveVnukanuMdi/panlaveVnakanuMdi/panlaveVnakAlanuMdi/panulaveVnukanuMdi/panulaveVnakanuMdi/*panulaveVnakAlanuMdi/panlaveVnakAlanuMci/panlaveVnukanuMci/panlaveVnakanuMci/panulaveVnakAlanuMci/panulaveVnukanuMci/panulaveVnakanuMci/panlaveVnakAwalanuMdi/panlaveVnakAwalanuMci/panulaveVnakAwalanuMdi/panulaveVnakAwalanuMci	n number bahu parsarg veVnukanuMdi 
panleVxutinuMdi/panlakeVxutinuMdi/panuleVxutinuMci/panulakeVxutinuMci/panuleVxutinuMdi/*panlakeVxutinuMdi/panleVxutinuMci/panlakeVxutinuMci	n number bahu parsarg eVxutinuMdi 
panlamaXyanuMdi/panlamaXyanuMci/panlamaXyaniMci/*panulamaXyanuMdi/panulamaXyanuMci/panulamaXyaniMci/panlamaXyalonuMdi/panlamaXyalonuMci/panlamaXyaloniMci/panulamaXyalonuMdi/panulamaXyalonuMci/panulamaXyaloniMci	n number bahu parsarg maXyanuMdi 
panlanadumanuMdi/panlanadamanuMdi/*panulanadumanuMdi/panulanadamanuMdi/panlanadumanuMci/panlanadamanuMci/panulanadumanuMci/panulanadamanuMci	n number bahu parsarg nadumanuMdi 
panlawaravAwanuMdi/panlawarvAwanuMdi/*panulawaravAwanuMdi/panulawarvAwanuMdi/panlawaravAwanuMci/panlawarvAwanuMci/panulawaravAwanuMci/panulawarvAwanuMci	n number bahu parsarg waravAwanuMdi 
panlacotunuMdi/panlacotunuMci/panlacotuniMci/panulacotunuMdi/panulacotunuMci/panulacotuniMci/panlacotlonuMci/panlacotloniMci/panlacotulonuMci/panlacotulonuMdi/*panulacotlonuMci/panulacotloniMci/panulacotulonuMci/panulacotulonuMdi	n number bahu parsarg cotlonuMdi 
panlasWAnamunuMdi/panlasWAnaMnuMdi/*panulasWAnamunuMdi/panulasWAnaMnuMdi/panlasWAnamunuMci/panlasWAnaMnuMci/panulasWAnamunuMci/panulasWAnaMnuMci/panlasWAnaMlonuMdi/panlasWAnamulonuMdi/panulasWAnaMlonuMdi/panulasWAnamulonuMdi/panlasWAnaMlonuMci/panlasWAnamulonuMci/panulasWAnaMlonuMci/panulasWAnamulonuMci	n number bahu parsarg sWAnaMnuMdi 
panlayaMxu/panlaMxu/*panulayaMxu/panulaMxu	n number bahu parsarg aMxu 
panlaMte/panlaMteV/*panulaMte/panulaMteV	n number bahu parsarg aMte 
panlakaMteV/panlakaMte/panulakaMteV/*panulakaMte/panlakanna/panlakannA/panulakanna/panulakannA	n number bahu parsarg kaMteV 
panlEna/*panulEna	n number bahu parsarg Ena 
panlapAti/*panulapAti	n number bahu parsarg pAti 
panlulAMti/panululAti/*panululAMti/panlulAti	n number bahu parsarg lAMti 
panlugAnI/panlukAnI/*panulugAnI/panulukAnI	n number bahu parsarg gAni 
panlugA/*panulugA	n number bahu parsarg gA 
