noun	
puli	
puli	n number eka parsarg 0 
-	n number eka parsarg I 
-	n number eka parsarg gA 
*puligAdu	n number eka parsarg gAdu 
*puligawweV	n number eka parsarg gawweV 
*pulivAdu	n number eka parsarg vAdu 
*pulAyana	n number eka parsarg Ayana 
*pulivAru	n number eka parsarg vAru 
*pulixi	n number eka parsarg xi 
*pulivi/puliy	n number eka parsarg vi 
*puligAru	n number eka parsarg gAru 
pulinu/*pulini	n number eka parsarg nu 
pulivu/*pulivi	n number eka parsarg vu 
*puliyoVkka	n number eka parsarg yoVkka 
*puli	n number eka parsarg obl 
*pulini	n number eka parsarg ni 
*puliki	n number eka parsarg ki 
*puliwo/puliwoda/puliwoti/puliwoni	n number eka parsarg wo 
*pulilo/pulilona/pulilopala	n number eka parsarg lo 
*puliloni/pulilopali/puliyaMxali	n number eka parsarg loni 
*pulimIxa	n number eka parsarg mIxa 
*pulina	n number eka parsarg na 
puliniMci/pulinuMci/*pulinuMdi	n number eka parsarg niMci 
*pulixvArA/pulixvAra	n number eka parsarg xvArA 
*pulivalana/pulivalla	n number eka parsarg valana 
*pulinibatti	n number eka parsarg batti 
pulice/*pulicewa	n number eka parsarg ce 
*puliwopAtu	n number eka parsarg wopAtu 
*puliwokUdi/puliwokUda/puliwokUdA/puliwogUdA	n number eka parsarg wokUdi 
*pulikosaM/pulikE/pulArWaM	n number eka parsarg kosaM 
*pulikoVraku/pulikoVrYaku	n number eka parsarg koVraku 
*pulilonuMdi/pulilonuMci/puliloniMci	n number eka parsarg lonuMdi 
*pulimIxanuMdi/pulimIxanuMci/pulimIxaniMci	n number eka parsarg mIxanuMdi 
*pulixAkA/pulixAka	n number eka parsarg xAkA 
*pulivaraku	n number eka parsarg varaku 
*pulimIxaki/pulimIxaku/pulimIxiki	n number eka parsarg mIxaki 
*pulixaggara/pulixaggira	n number eka parsarg xaggara 
*pulivaxxa/puloVxxa/puliyoVxxa	n number eka parsarg vaxxa 
*pulikAda	n number eka parsarg kAda 
*pulikeVxurugA/puleVxurugA	n number eka parsarg keVxurugA 
*pulimuMxu	n number eka parsarg muMxu 
*puliguriMci/puliniguriMci/pulinugUrci	n number eka parsarg guriMci 
pulipE/*pulipEna/pulipEni	n number eka parsarg pE 
*pulipEki	n number eka parsarg pEki 
*puliguMdA	n number eka parsarg guMdA 
pulilA/pulilAga/*pulilAgA	n number eka parsarg lA 
pulivale/*pulivaleV/pulimAxiri/pulinipolina/pulinibolina	n number eka parsarg vale 
pulikimalle/*pulikimalleV	n number eka parsarg kimalle 
*pulikUdA/pulinikUdA/pulinigUdA	n number eka parsarg kUdA 
*pulixqRtilo/pulixruRtilo	n number eka parsarg xqRtilo 
*pulilekuMdA/pulinilekuMdA/pulileka/pulinilekuMda	n number eka parsarg lekuMdA 
*pulikAkuMdA/pulinikAkuMdA/pulikAka/puligAka	n number eka parsarg kAkuMdA 
*pulimoVxalukoVni/pulinimoVxalukoVni/pulinumoVxalukoVni	n number eka parsarg moVxalukoVni 
*pulivEpu/pulivepu	n number eka parsarg vEpu 
pulipakka/puliprakka/pulipakkana/*puliprakkana/pulipakkani	n number eka parsarg pakka 
pulipakkalo/*puliprakkalo/pulipakkalona/pulipakkaloni	n number eka parsarg pakkalo 
puliloki/puliloniki/*pulilopalaki/pulilopalaku/pulilopaliki	n number eka parsarg lopalaki 
pulikiMxa/*pulikriMxa/pulikriMxane/pulikiMxane	n number eka parsarg kiMxa 
puladuguna/*pulikaduguna	n number eka parsarg aduguna 
*pulikeVlla/pulikalla	n number eka parsarg kalla 
puliveVnuka/*puliveVnakAla/puliveVnakAwala/puliveVnakana	n number eka parsarg veVnuka 
puliwaravAwa/puliwarvAwa/*puliwaruvAwa/puliwaravAwana/puliwarvAwana/puliwaruvAwana	n number eka parsarg waravAwa 
puleVxuruguMdA/*pulikeVxuruguMdA	n number eka parsarg eVxuruguMdA 
pulimaXya/*pulimaXyalo/pulimaXyana	n number eka parsarg maXya 
*pulinaduma/pulinadumana	n number eka parsarg naduma 
pulibaxulugA/pulibaxulu/*pulikibaxulu/pulikubaxulu	n number eka parsarg baxulugA 
*pulicotlo/pulicotulo/pulicotuna/pulicota	n number eka parsarg cotlo 
*pulisWAnaMlo/puliswAnaMlo	n number eka parsarg sWAnaMlo 
pulinerugA/pulikunerugA/*pulikinerugA	n number eka parsarg nerugA 
*puliprakAraM/puliprakAramu	n number eka parsarg prakAraM 
*pulixaggaranuMdi/pulixaggaranuMci/pulixaggiranuMdi/pulixaggiranuMci	n number eka parsarg xaggaranuMdi 
*pulivaxxanuMdi/pulivaxxanuMci/pulivaxxaniMci	n number eka parsarg vaxxanuMdi 
*pulipakkanuMdi/pulipakkanuMci/pulipakkaniMci/pulipakkalonuMdi/pulipakkalonuMci/pulipakkaloniMci	n number eka parsarg pakkanuMdi 
*pulilopalanuMdi/pulilopalanuMci/pulilopalaniMci	n number eka parsarg lopalanuMdi 
*pulibEtanuMdi/pulibEtanuMci/pulibEtaniMci	n number eka parsarg bEtanuMdi 
*pulipEnuMdi/pulipEnuMci/pulipEniMci	n number eka parsarg pEnuMdi 
*pulikiMxanuMdi/pulikiMxanuMci/pulikiMxaniMci/pulikriMxanuMdi/pulikriMxanuMci/pulikriMxaniMci	n number eka parsarg kriMxanuMdi 
puladugunuMdi/puladugunuMci/*pulikadugunuMdi/pulikadugunuMci/pulikaduguniMci	n number eka parsarg adugunuMdi 
*pulimuMxunuMdi/pulimuMxunuMci/pulimuMxuniMci	n number eka parsarg muMxunuMdi 
puliveVnukanuMdi/*puliveVnakAlanuMdi/puliveVnakAwalanuMdi/puliveVnakanuMdi/puliveVnukanuMci/puliveVnakAlanuMci/puliveVnakAwalanuMci/puliveVnakanuMci	n number eka parsarg veVnukanuMdi 
puleVxutinuMdi/*pulikeVxutinuMdi/pulikeVxutinuMci/puleVxutinuMci	n number eka parsarg eVxutinuMdi 
*pulimaXyanuMdi/pulimaXyanuMci/pulimaXyalonuMdi/pulimaXyalonuMci	n number eka parsarg maXyanuMdi 
*pulinadumanuMdi/pulinadumanuMci	n number eka parsarg nadumanuMdi 
*puliwaravAwanuMdi/puliwarvAwanuMdi/puliwaravAwanuMci/puliwarvAwanuMci	n number eka parsarg waravAwanuMdi 
*pulicotlonuMdi/pulicotunuMdi/pulicotlonuMci/pulicotunuMci	n number eka parsarg cotlonuMdi 
pulisWAnaMnuMdi/*pulisWAnamunuMdi/pulisWAnaMnuMci/pulisWAnamunuMci/pulisWAnaMlonuMdi/pulisWAnamulonuMdi/pulisWAnaMlonuMci/puliswAnamulonuMci	n number eka parsarg sWAnaMnuMdi 
pulaMxu/pulinaMxu/*puliyaMxu	n number eka parsarg aMxu 
pulaMte/*pulaMteV	n number eka parsarg aMte 
*pulikaMteV/pulikaMte/pulikannA/pulikanna	n number eka parsarg kaMteV 
*pulEna	n number eka parsarg Ena 
*pulipAti	n number eka parsarg pAti 
*pulilAMti/pulilAti	n number eka parsarg lAMti 
*puligAnI/pulikAnI	n number eka parsarg gAni 
*puligA	n number eka parsarg gA 
*pululu	n number bahu parsarg 0 
*pululU/pululArA	n number bahu parsarg I 
-	n number bahu parsarg gA 
*pululagAdu	n number bahu parsarg gAdu 
*pululagawweV	n number bahu parsarg gawweV 
*pululavAdu/pululodu	n number bahu parsarg vAdu 
*pululAyana	n number bahu parsarg Ayana 
*pululavAru/pululoru	n number bahu parsarg vAru 
*pululaxi/pululxi	n number bahu parsarg xi 
*pululavi/puliliy	n number bahu parsarg vi 
*pululagAru	n number bahu parsarg gAru 
*pululaM/pululamu	n number bahu parsarg nu 
*pululu	n number bahu parsarg vu 
*pululayoVkka	n number bahu parsarg yoVkka 
*pulula	n number bahu parsarg obl 
pululani/*pululni/pululanu/pululnu	n number bahu parsarg ni 
*pululaki/pululaku	n number bahu parsarg ki 
*pululawo/pululwo/pululawoda/pululawoti/pululwoti/pululwoda	n number bahu parsarg wo 
pululalo/*pulullo/pululalona/pulullona/pululalopala/pulullopala	n number bahu parsarg lo 
*pululaloni/pululayaMxali/pululloni/pululalopali/pulullopali	n number bahu parsarg loni 
*pululamIxa	n number bahu parsarg mIxa 
*pululana	n number bahu parsarg na 
pululaniMci/pululniMci/pululanuMci/pululnuMci/*pululanuMdi/pululnuMdi	n number bahu parsarg niMci 
*pululaxvArA/pululaxvAra	n number bahu parsarg xvArA 
*pululavalana/pululavalla	n number bahu parsarg valana 
*pululanubatti/pululanibatti/pululnibatti	n number bahu parsarg batti 
*pululacewa/pululcewa/pululace/pululce	n number bahu parsarg ce 
*pululawopAtu/pululwopAtu	n number bahu parsarg wopAtu 
*pululawokUdi/pululwokUdi/pululawokUda/pululawokUdA/pululwokUdA	n number bahu parsarg wokUdi 
*pululakosaM/pululakE/pululArWaM	n number bahu parsarg kosaM 
*pululakoVraku/pululakoVrYaku	n number bahu parsarg koVraku 
*pululalonuMdi/pululalonuMci/pulullonuMdi/pulullonuMci/pululloniMci/pululaloniMci	n number bahu parsarg lonuMdi 
*pululamIxanuMdi/pululamIxanuMci/pululamIxaniMci	n number bahu parsarg mIxanuMdi 
*pululaxAkA/pululaxAka	n number bahu parsarg xAkA 
*pululavaraku	n number bahu parsarg varaku 
*pululamIxaki/pululamIxaku/pululamIxiki	n number bahu parsarg mIxaki 
*pululaxaggara/pululaxaggira	n number bahu parsarg xaggara 
*pululavaxxa/pululoVxxa	n number bahu parsarg vaxxa 
*pululakAda	n number bahu parsarg kAda 
pululeVxurugA/*pululakeVxurugA	n number bahu parsarg keVxurugA 
*pululamuMxu	n number bahu parsarg muMxu 
*pululaguriMci/pululagUrci/pululanuguriMci/pululanigUrci	n number bahu parsarg guriMci 
pululapE/pululapEni/*pululapEna	n number bahu parsarg pE 
*pululapEki	n number bahu parsarg pEki 
*pululaguMdA	n number bahu parsarg guMdA 
pululalA/pulullA/pululalAga/pulullAga/*pulullAgA	n number bahu parsarg lA 
pululavale/*pululavaleV/pululamAxiri/pululanupolina/pululnibolina/pululanubolina	n number bahu parsarg vale 
pululakumalle/*pululakumalleV	n number bahu parsarg kimalle 
*pululukUdA/pululugUdA	n number bahu parsarg kUdA 
*pululaxqRtilo/pululaxruRtilo	n number bahu parsarg xqRtilo 
*pulululekuMdA/pulullekuMdA/pulululeka	n number bahu parsarg lekuMdA 
*pululukAkuMdA/pululukAkuMda/pululukAka/pululugAka	n number bahu parsarg kAkuMdA 
*pululumoVxalukoVni/pululanumoVxalukoVni	n number bahu parsarg moVxalukoVni 
*pululavEpu/pululavepu	n number bahu parsarg vEpu 
pululapakka/pululapakkana/pululaprakka/*pululaprakkana	n number bahu parsarg pakka 
pululapakkalo/*pululaprakkalo	n number bahu parsarg pakkalo 
pululaloki/pululalaloniki/pululalopalaki/*pululalopaliki/pulullopaliki/pululalopalaku	n number bahu parsarg lopalaki 
pululakiMxa/*pululakriMxa/pululakriMxane/pululakiMxane	n number bahu parsarg kiMxa 
pululaduguna/*pululakaduguna	n number bahu parsarg aduguna 
*pululakeVlla/pululakalla	n number bahu parsarg kalla 
pululaveVnuka/pululaveVnaka/*pululaveVnakAla/pululaveVnukAla/pululaveVnakAwala/pululaveVnukAwala	n number bahu parsarg veVnuka 
*pululawaravAwa/pululawarvAwa/pululwaravAwa	n number bahu parsarg waravAwa 
pululeVxuruguMdA/*pululakeVxuruguMdA	n number bahu parsarg eVxuruguMdA 
*pululamaXya/pululamaXyana/pululamaXyalo	n number bahu parsarg maXya 
*pululanaduma/pululakinaduma	n number bahu parsarg naduma 
pululabaxulugA/pululakibaxulugA/pululabaxulu/*pululakibaxulu	n number bahu parsarg baxulugA 
*pululacotlo/pululacotulo	n number bahu parsarg cotlo 
pululasWAnaMlo/pululaswAnaMlo/*pululasWAnamulo	n number bahu parsarg sWAnaMlo 
pululanerugA/pululakunerugA/*pululakinerugA	n number bahu parsarg nerugA 
*pululaprakAraM/pululanubatti/pululabatti/pululanibatti	n number bahu parsarg prakAraM 
*pululaxaggaranuMdi/pululaxaggiranuMdi/pululaxaggaranuMci/pululaxaggiranuMci	n number bahu parsarg xaggaranuMdi 
*pululavaxxanuMdi/pululavaxxanuMci	n number bahu parsarg vaxxanuMdi 
*pululapakkanuMdi/pululapakkanuMci/pululapakkalonuMdi/pululapakkalonuMci	n number bahu parsarg pakkanuMdi 
pululalopalanuMdi/*pulullopalanuMdi/pululalopalanuMci/pulullopalanuMci/pulullopalinuMdi/pululalopalinuMci	n number bahu parsarg lopalanuMdi 
*pululabEtanuMdi/pululabEtanuMci/pululabEtaniMci	n number bahu parsarg bEtanuMdi 
*pululapEnuMdi/pululapEnuMci/pululapEniMci	n number bahu parsarg pEnuMdi 
pululakiMxanuMdi/pululakiMxanuMci/pululakiMxaniMci/*pululakriMxanuMdi/pululakriMxanuMci/pululakriMxaniMci	n number bahu parsarg kriMxanuMdi 
*pululadugunuMdi/pululadugunuMci/pululaduguniMci	n number bahu parsarg adugunuMdi 
*pululamuMxunuMdi/pululamuMxunuMci/pululamuMxuniMci	n number bahu parsarg muMxunuMdi 
pululaveVnukanuMdi/pululaveVnakanuMdi/*pululaveVnakAlanuMdi/pululaveVnakAlanuMci/pululaveVnukanuMci/pululaveVnakanuMci/pululaveVnakAwalanuMdi/pululaveVnakAwalanuMci	n number bahu parsarg veVnukanuMdi 
pululeVxutinuMdi/*pululakeVxutinuMdi/pululeVxutinuMci/pululakeVxutinuMci	n number bahu parsarg eVxutinuMdi 
*pululamaXyanuMdi/pululamaXyanuMci/pululamaXyaniMci/pululamaXyalonuMdi/pululamaXyalonuMci/pululamaXyaloniMci	n number bahu parsarg maXyanuMdi 
*pululanadumanuMdi/pululanadamanuMdi/pululanadumanuMci/pululanadamanuMci	n number bahu parsarg nadumanuMdi 
*pululawaruvAwanuMdi/pululawaravAwanuMdi/pululawarvAwanuMdi/pululawaravAwanuMci/pululawarvAwanuMci	n number bahu parsarg waravAwanuMdi 
pululacotunuMci/pululacotunuMdi/pululacotlonuMci/*pululacotlonuMdi/pululacotulonuMci/pululacotulonuMdi	n number bahu parsarg cotlonuMdi 
*pululasWAnamunuMdi/pululasWAnaMnuMdi/pululasWAnamunuMci/pululasWAnaMnuMci/pululasWAnaMlonuMdi/pululasWAnamulonuMdi/pululasWAnaMlonuMci/pululasWAnamulonuMci	n number bahu parsarg sWAnaMnuMdi 
*pululayaMxu/pululaMxu	n number bahu parsarg aMxu 
pululaMte/*pululaMteV	n number bahu parsarg aMte 
*pululakaMteV/pululakaMte/pululakanna/pululakannA	n number bahu parsarg kaMteV 
*pululEna	n number bahu parsarg Ena 
*pululapAti	n number bahu parsarg pAti 
*pululalAMti/pululalAti	n number bahu parsarg lAMti 
*pululugAnI/pululukAnI	n number bahu parsarg gAni 
*pululugA	n number bahu parsarg gA 
