noun	
paMxiri	
*paMxiri	n number eka parsarg 0  case d
-	n number eka parsarg I 
-	n number eka parsarg gA 
*paMxirigAdu	n number eka parsarg gAdu  case d
*paMxirigawweV	n number eka parsarg gawweV  case d
*paMxirivAdu	n number eka parsarg vAdu  case d
*paMxirAyana	n number eka parsarg Ayana  case d
*paMxirivAru	n number eka parsarg vAru  case d
*paMxirixi	n number eka parsarg xi  case d
*paMxirivi/paMxiriy	n number eka parsarg vi  case d
*paMxirigAru	n number eka parsarg gAru  case d
*paMxirinu	n number eka parsarg nu 
*paMxirivu	n number eka parsarg vu  case d
*paMxiriyoVkka	n number eka parsarg yoVkka 
*paMxiri/paMxiti	n number eka parsarg obl 
*paMxirini	n number eka parsarg ni 
*paMxiriki	n number eka parsarg ki 
*paMxiriwo/paMxiriwoda/paMxiriwoti	n number eka parsarg wo 
paMxirilo/paMxitlo/paMxirilona/*paMxirilopala	n number eka parsarg lo 
paMxiriloni/*paMxirilopali/paMxiriyaMxali	n number eka parsarg loni 
*paMxirimIxa	n number eka parsarg mIxa 
*paMxirina	n number eka parsarg na 
paMxiriniMci/paMxirinuMci/*paMxirinuMdi	n number eka parsarg niMci 
*paMxirixvArA/paMxirixvAra	n number eka parsarg xvArA 
*paMxirivalana/paMxirivalla	n number eka parsarg valana 
*paMxirinibatti/paMxirnibatti	n number eka parsarg batti 
paMxirice/*paMxiricewa	n number eka parsarg ce 
*paMxiriwopAtu	n number eka parsarg wopAtu 
*paMxiriwokUdi/paMxiriwokUdA/paMxiriwogUdA	n number eka parsarg wokUdi 
*paMxirikosaM/paMxirikE/paMxirArWaM	n number eka parsarg kosaM 
*paMxirikoVraku/paMxirikoVrYaku	n number eka parsarg koVraku 
paMxirilonuMci/paMxiriloniMci/paMxirloniMci/paMxirlonuMci/paMxirlonuMdi/*paMxirilonuMdi	n number eka parsarg lonuMdi 
*paMxirimIxanuMdi/paMxirimIxanuMci	n number eka parsarg mIxanuMdi 
*paMxirixAkA/paMxirixAka	n number eka parsarg xAkA 
*paMxirivaraku	n number eka parsarg varaku 
*paMxirimIxaki/paMxirimIxaku	n number eka parsarg mIxaki 
*paMxirixaggara/paMxirixaggira	n number eka parsarg xaggara 
*paMxirivaxxa/paMxiroVxxa	n number eka parsarg vaxxa 
*paMxirikAda	n number eka parsarg kAda 
*paMxirikeVxurugA/paMxireVxurugA	n number eka parsarg keVxurugA 
*paMxirimuMxu	n number eka parsarg muMxu 
*paMxiriguriMci/paMxiriniguriMci	n number eka parsarg guriMci 
paMxiripE/*paMxiripEna/paMxiripEni	n number eka parsarg pE 
*paMxiripEki	n number eka parsarg pEki 
*paMxiriguMdA	n number eka parsarg guMdA 
paMxirilA/paMxirilAga/*paMxirilAgA	n number eka parsarg lA 
*paMxirivale/paMxirimAxiri/paMxirinipolina/paMxirivaleV/paMxirinibolina	n number eka parsarg vale 
*paMxirikimalle/paMxirikimalleV	n number eka parsarg kimalle 
*paMxirigUdA/paMxirinikUdA/paMxirinigUdA	n number eka parsarg kUdA 
*paMxirixqRtilo/paMxirixruRtilo	n number eka parsarg xqRtilo 
*paMxirilekuMdA/paMxirileka	n number eka parsarg lekuMdA 
*paMxirikAkuMdA/paMxirikAka/paMxirigAka/paMxirigAkuMdA	n number eka parsarg kAkuMdA 
*paMxirimoVxalukoVni/paMxirinimoVxalukoVni	n number eka parsarg moVxalukoVni 
*paMxirivEpu/paMxirivepu/paMxirikesi	n number eka parsarg vEpu 
paMxiripakka/*paMxiriprakka/paMxiripakkana	n number eka parsarg pakka 
paMxiripakkalo/*paMxiriprakkalo	n number eka parsarg pakkalo 
paMxiriloki/paMxiriloniki/*paMxirilopalaki/paMxirilopalaku/paMxirilopaliki	n number eka parsarg lopalaki 
paMxirikiMxa/*paMxirikriMxa/paMxirikriMxane/paMxirikiMxane	n number eka parsarg kiMxa 
paMxiraduguna/*paMxirikaduguna	n number eka parsarg aduguna 
paMxirikeVlla/*paMxirikalla	n number eka parsarg kalla 
paMxiriveVnuka/*paMxiriveVnakAla/paMxiriveVnakAwala	n number eka parsarg veVnuka 
paMxiriwaravAwa/paMxiriwarvAwa/*paMxiriwaruvAwa	n number eka parsarg waravAwa 
paMxireVxuruguMdA/*paMxirikeVxuruguMdA	n number eka parsarg eVxuruguMdA 
paMxirimaXya/*paMxirimaXyalo/paMxirimaXyana	n number eka parsarg maXya 
*paMxirinaduma/paMxirinadama	n number eka parsarg naduma 
paMxiribaxulugA/paMxiribaxulu/*paMxirikibaxulu/paMxirinibaxulu	n number eka parsarg baxulugA 
*paMxiricotlo/paMxiricotulo/paMxiricotuna	n number eka parsarg cotlo 
paMxirisWAnaMlo/*paMxirisWAnamulo	n number eka parsarg sWAnaMlo 
paMxirinerugA/paMxirikunerugA/*paMxirikinerugA	n number eka parsarg nerugA 
*paMxiriprakAraM/paMxiriprakAramu	n number eka parsarg prakAraM 
paMxirixaggaranuMdi/paMxirixaggaranuMci/*paMxirixaggiranuMdi/paMxirixaggiranuMci	n number eka parsarg xaggaranuMdi 
*paMxirivaxxanuMdi/paMxirivaxxanuMci	n number eka parsarg vaxxanuMdi 
*paMxiripakkanuMdi/paMxiripakkanuMci/paMxiripakkalonuMdi/paMxiripakkalonuMci	n number eka parsarg pakkanuMdi 
*paMxirilopalanuMdi/paMxirilopalanuMci/paMxirilopalinuMci/paMxirilopalinuMdi	n number eka parsarg lopalanuMdi 
*paMxiribEtanuMdi/paMxiribEtanuMci	n number eka parsarg bEtanuMdi 
*paMxiripEnuMdi/paMxiripEnuMci	n number eka parsarg pEnuMdi 
paMxirikiMxanuMdi/paMxirikiMxanuMci/*paMxirikriMxanuMdi/paMxirikriMxanuMci	n number eka parsarg kriMxanuMdi 
paMxiradugunuMdi/paMxiradugunuMci/*paMxirikadugunuMdi/paMxirikadugunuMci	n number eka parsarg adugunuMdi 
*paMxirimuMxunuMdi/paMxirimuMxunuMci	n number eka parsarg muMxunuMdi 
paMxiriveVnukanuMdi/*paMxiriveVnakAlanuMdi/paMxiriveVnakAwalanuMdi/paMxiriveVnakanuMdi/paMxiriveVnukanuMci/paMxiriveVnakAlanuMci/paMxiriveVnakAwalanuMci/paMxiriveVnakanuMci	n number eka parsarg veVnukanuMdi 
paMxireVxutinuMdi/paMxireVxutanuMdi/*paMxirikeVxutinuMdi	n number eka parsarg eVxutinuMdi 
*paMxirimaXyanuMdi/paMxirimaXyanuMci/paMxirimaXyalonuMdi/paMxirimaXyalonuMci	n number eka parsarg maXyanuMdi 
*paMxirinadumanuMdi/paMxirinadumanuMci	n number eka parsarg nadumanuMdi 
*paMxiriwaravAwanuMdi/paMxiriwarvAwanuMdi/paMxiriwaravAwanuMci/paMxiriwarvAwanuMci	n number eka parsarg waravAwanuMdi 
paMxiricotunuMci/paMxiricotunuMdi/*paMxiricotlonuMci/paMxiricotanuMci	n number eka parsarg cotlonuMdi 
*paMxirisWAnaMnuMdi/paMxirisWAnaMnuMci/paMxirisWAnamunuMci/paMxirisWAnaMniMci/paMxirisWAnamuniMci/paMxirisWAnaMlonuMdi/paMxirisWAnamulonuMdi/paMxirisWAnaMlonuMci/paMxiriswAnamulonuMci/paMxirisWAnaMloniMci/paMxirisWAnamuloniMci	n number eka parsarg sWAnaMnuMdi 
paMxiraMxu/paMxirinaMxu/*paMxiriyaMxu	n number eka parsarg aMxu 
*paMxiraMte/paMxiraMteV	n number eka parsarg aMte 
*paMxirikaMteV/paMxirikaMte/paMxirikanna/paMxirikannA	n number eka parsarg kaMteV 
*paMxirEna	n number eka parsarg Ena 
*paMxiripAti	n number eka parsarg pAti 
*paMxirilAMti/paMxirilAti	n number eka parsarg lAMti 
*paMxirigAnI/paMxirikAnI	n number eka parsarg gAni 
*paMxirigA	n number eka parsarg gA 
*paMxilYlYu/paMxilYlu/paMxirlu	n number bahu parsarg 0  case d
*paMxilYlYU/paMxilYlU/paMxirlulArA/paMxirlU/paMxilYulArA	n number bahu parsarg I  case d
-	n number bahu parsarg gA 
*paMxilYlYagAdu/paMxilYlagAdu/paMxirlagAdu	n number bahu parsarg gAdu  case d
*paMxilYlYagawweV/paMxilYlagawweV/paMxirlagawweV	n number bahu parsarg gawweV  case d
*paMxilYlYavAdu/paMxilYlavAdu/paMxirlavAdu	n number bahu parsarg vAdu  case d
*paMxilYlYAyana/paMxilYlAyana/paMxirlAyana	n number bahu parsarg Ayana  case d
*paMxilYlYavAru/paMxilYlavAru/paMxirlavAru	n number bahu parsarg vAru  case d
*paMxilYlYaxi/paMxilYlaxi/paMxirlaxi	n number bahu parsarg xi  case d
*paMxilYlYavi/paMxilYlavi/paMxilYlay	n number bahu parsarg vi  case d
*paMxilYlYagAru/paMxilYlagAru/paMxirlagAru	n number bahu parsarg gAru  case d
*paMxilYlYaM/paMxilYlaM/paMxilYlamu	n number bahu parsarg nu  case d
*paMxilYlYu/paMxilYlu/paMxirlu	n number bahu parsarg vu 
*paMxilYlYayoVkka/paMxilYlayoVkka/paMxirlayoVkka	n number bahu parsarg yoVkka 
*paMxilYlYa/paMxilYla/paMxirla	n number bahu parsarg obl 
*paMxilYlYani/paMxilYlani/paMxilYlanu/paMxirlanu/paMxirlani	n number bahu parsarg ni 
*paMxilYlYaki/paMxilYlaki/paMxirlaki/paMxilYlaku/paMxirlaku	n number bahu parsarg ki 
*paMxilYlYawo/paMxilYlawo/paMxirlawo/paMxilYlawoda/paMxirlawoda	n number bahu parsarg wo 
*paMxilYlYalo/paMxirlalo/paMxilYlalona/paMxirlalona/paMxilYlalopala/paMxirlalopala	n number bahu parsarg lo 
paMxilYlaloni/paMxirlaloni/*paMxilYlalopali/paMxilYlalopali/paMxirlayaMxali/paMxirlalopali	n number bahu parsarg loni 
*paMxilYlYamIxa/paMxilYlamIxa/paMxirlamIxa	n number bahu parsarg mIxa 
*paMxirlana	n number bahu parsarg na 
paMxilYlaniMci/paMxirlaniMci/paMxilYlanuMci/paMxirlanuMci/*paMxilYlYanuMdi/paMxilYlanuMdi/paMxirlanuMdi	n number bahu parsarg niMci 
*paMxilYlYaxvArA/paMxilYlaxvArA/paMxirlaxvArA	n number bahu parsarg xvArA 
*paMxilYlYavalana/paMxilYlavalana/paMxilYlavalla/paMxirlavalla/	n number bahu parsarg valana 
*paMxilYlYanubatti/paMxilYlYanubatti/paMxilYlanibatti/paMxirlanubatti	n number bahu parsarg batti 
*paMxilYlYacewa/paMxilYlacewa/paMxirlacewa/paMxilYlace/paMxirlace	n number bahu parsarg ce 
*paMxilYlYawopAtu/paMxilYlawopAtu/paMxirlawopAtu	n number bahu parsarg wopAtu 
*paMxilYlYawokUdi/paMxilYlawokUdi/paMxirlawokUdi/paMxilYlawokUda/paMxirlawokUda/paMxilYlawokUdA/paMxirlawokUdA	n number bahu parsarg wokUdi 
*paMxilYlYakosaM/paMxilYlakosaM/paMxirlakosaM/paMxilYlakE/paMxirlakE/paMxilYlArWaM	n number bahu parsarg kosaM 
*paMxilYlYakoVraku/paMxilYlakoVraku/paMxirlakoVraku/paMxilYlakoVrYaku/paMxirlakoVrYaku	n number bahu parsarg koVraku 
*paMxilYlYalonuMdi/paMxilYlalonuMdi/paMxilYlalonuMci/paMxirlalonuMdi/paMxirlalonuMci/paMxilYlaloniMci/paMxirlaloniMci	n number bahu parsarg lonuMdi 
*paMxilYlYamIxanuMdi/paMxilYlamIxanuMdi/paMxirlamIxanuMdi/paMxilYlamIxanuMci/paMxirlamIxanuMci	n number bahu parsarg mIxanuMdi 
*paMxilYlYaxAkA/paMxilYlaxAkA/paMxirlaxAkA	n number bahu parsarg xAkA 
*paMxilYlYavaraku/paMxilYlavaraku/paMxirlavaraku	n number bahu parsarg varaku 
*paMxilYlYamIxaki/paMxilYlamIxaki/paMxirlamIxaki/paMxilYlamIxaku/paMxirlamIxaku	n number bahu parsarg mIxaki 
*paMxilYlYaxaggara/paMxilYlaxaggara/paMxirlaxaggara	n number bahu parsarg xaggara 
*paMxilYlYavaxxa/paMxilYlavaxxa/paMxirlavaxxa	n number bahu parsarg vaxxa 
*paMxilYlYakAda/paMxilYlakAda/paMxirlakAda	n number bahu parsarg kAda 
*paMxilYlYeVxurugA/paMxilYleVxurugA/paMxirlakeVxurugA	n number bahu parsarg keVxurugA 
*paMxilYlYamuMxu/paMxilYlamuMxu	n number bahu parsarg muMxu 
*paMxilYlYaguriMci/paMxilYlaguriMci/paMxilYlanuguriMci/paMxilYlaniguriMci	n number bahu parsarg guriMci 
paMxilYlapE/paMxilYlapEni/paMxilYlapEna/*paMxilYlYapEna	n number bahu parsarg pE 
*paMxilYlYapEki/paMxilYlapEki/paMxirlapEki	n number bahu parsarg pEki 
*paMxilYlYaguMdA/paMxilYlaguMdA	n number bahu parsarg guMdA 
paMxilYlalA/paMxirlalA/*paMxilYlYalAgA/paMxilYlalAgA/paMxilYlalAga/paMxirlalAga/paMxirlalAgA	n number bahu parsarg lA 
*paMxilYlYavale/paMxilYlavale/paMxilYlavaleV/paMxilYlamAxiri/paMxilYlapoli/paMxilYlabolina	n number bahu parsarg vale 
*paMxilYlYakumalle/paMxilYlakumalle/paMxirlakumalle/paMxilYlakumalleV/paMxirlakumalleV	n number bahu parsarg kimalle 
paMxirlukUdA/*paMxilYlYugUdA/paMxilYlugUdA/paMxilYlanugUdA/paMxirlanugUdA	n number bahu parsarg kUdA 
*paMxilYlYaxqRtilo/paMxilYlaxqRtilo/paMxilYlaxruRtilo/paMxirlaxqRtilo/paMxirlaxruRtilo	n number bahu parsarg xqRtilo 
paMxilYlanulekuMdA/*paMxilYlYulekuMdA/paMxilYlulekuMdA/paMxirlanulekuMdA/paMxirlulekuMdA/paMxilYluleka/paMxirluleka	n number bahu parsarg lekuMdA 
paMxilYlanukAkuMdA/*paMxilYlYukAkuMdA/paMxilYlukAkuMdA/paMxirlanukAkuMdA/paMxirlukAkuMdA/paMxilYlukAka/paMxirlukAka/paMxilYlugAka/paMxirlugAka	n number bahu parsarg kAkuMdA 
*paMxilYlYumoVxalukoVni/paMxilYlumoVxalukoVni/paMxilYlanumoVxalukoVni/paMxirlanumoVxalukoVni	n number bahu parsarg moVxalukoVni 
*paMxilYlYavEpu/paMxilYlavEpu/paMxilYlavepu/paMxilYlakesi/paMxirlavEpu/paMxirlavepu/paMxirlakesi	n number bahu parsarg vEpu 
paMxilYlapakka/paMxilYlapakkana/paMxilYlaprakka/*paMxilYlYaprakkana/paMxilYlaprakkana/paMxirlapakka/paMxirlapakkana/paMxirlaprakka/paMxirlaprakkana	n number bahu parsarg pakka 
paMxilYlapakkalo/*paMxilYlYaprakkalo/paMxilYlaprakkalo/paMxirlaprakkalo	n number bahu parsarg pakkalo 
paMxilYlaloki/paMxilYlaloniki/paMxirlaloki/paMxirlaloniki/*paMxilYlYalopalaki/paMxilYlalopalaki/paMxilYlalopaliki/paMxirlalopaliki/paMxirlalopalaku	n number bahu parsarg lopalaki 
paMxilYlakiMxa/*paMxilYlYakriMxa/paMxilYlakriMxa/paMxirlakriMxa/paMxilYlakriMxane/paMxilYlakiMxane/paMxirlakiMxane	n number bahu parsarg kiMxa 
paMxilYladuguna/*paMxilYlYakaduguna/paMxilYlakaduguna/paMxirlakaduguna	n number bahu parsarg aduguna 
paMxilYlakeVlla/*paMxilYlYakalla/paMxilYlakalla/paMxirlakalla	n number bahu parsarg kalla 
paMxilYlaveVnuka/paMxilYlaveVnaka/*paMxilYlYaveVnakAla/paMxilYlaveVnakAla/paMxilYlaveVnukAla/paMxilYlaveVnakAwala/paMxilYlaveVnukAwala/paMxirlaveVnuka/paMxirlaveVnaka/paMxirlaveVnakAla/paMxirlaveVnukAla/paMxirlaveVnakAwala/paMxirlaveVnukAwala	n number bahu parsarg veVnuka 
*paMxilYlYawaravAwa/paMxilYlawaravAwa/paMxilYlawarvAwa/paMxirlawaravAwa	n number bahu parsarg waravAwa 
paMxilYleVxuruguMdA/*paMxilYlYakeVxuruguMdA/paMxilYlakeVxuruguMdA/paMxirleVxuruguMdA/paMxirlakeVxuruguMdA	n number bahu parsarg eVxuruguMdA 
*paMxilYlYamaXya/paMxilYlamaXya/paMxilYlamaXyana/paMxilYlamaXyalo/paMxirlamaXyana/paMxirlamaXyalo	n number bahu parsarg maXya 
*paMxilYlYanaduma/paMxilYlanaduma/paMxilYlakinaduma/paMxirlakinaduma	n number bahu parsarg naduma 
paMxilYlabaxulugA/*paMxilYlYakibaxulu/paMxilYlakibaxulu/paMxilYlabaxulu/paMxilYlakubaxulu/paMxirlabaxulu/paMxirlakibaxulu/paMxirlabaxulu/paMxirlakubaxulu	n number bahu parsarg baxulugA 
*paMxilYlYacotlo/paMxilYlacotlo/paMxilYlacotulo/paMxirlacotulo	n number bahu parsarg cotlo 
paMxilYlasWAnaMlo/paMxilYlaswAnaMlo/*paMxilYlYasWAnamulo/paMxilYlasWAnamulo/paMxirlasWAnaMlo	n number bahu parsarg sWAnaMlo 
paMxilYlanerugA/paMxilYlakunerugA/*paMxilYlYakinerugA/paMxilYlakinerugA/paMxirlakinerugA/paMxirlakunerugA	n number bahu parsarg nerugA 
*paMxilYlYaprakAraM/paMxilYlaprakAraM/paMxilYlanubatti/paMxilYlabatti/paMxilYlanibatti/paMxirlanibatti/paMxirlanubatti	n number bahu parsarg prakAraM 
*paMxilYlYaxaggaranuMdi/paMxilYlaxaggaranuMdi/paMxilYlaxaggiranuMdi/paMxilYlaxaggaranuMci/paMxilYlaxaggiranuMci	n number bahu parsarg xaggaranuMdi 
*paMxilYlYavaxxanuMdi/paMxilYlavaxxanuMdi/paMxilYlavaxxanuMci/paMxirlavaxxanuMdi/paMxirlavaxxanuMci	n number bahu parsarg vaxxanuMdi 
*paMxilYlYapakkanuMdi/paMxilYlapakkanuMdi/paMxilYlapakkanuMci/paMxirlapakkanuMdi/paMxirlapakkanuMci/paMxilYlapakkalonuMdi/paMxilYlapakkalonuMci/paMxirlapakkalonuMdi/paMxirlapakkalonuMci	n number bahu parsarg pakkanuMdi 
*paMxilYlYalopalanuMdi/paMxilYlalopalanuMdi/paMxirlalopalanuMdi/paMxilYlalopalanuMci/paMxirlalopalanuMci/paMxirlalopalinuMdi/paMxilYlalopalinuMci	n number bahu parsarg lopalanuMdi 
*paMxilYlYabEtanuMdi/paMxilYlabEtanuMdi/paMxilYlabEtanuMci/paMxilYlabEtaniMci/paMxirlabEtanuMdi/paMxirlabEtanuMci/paMxirlabEtaniMci	n number bahu parsarg bEtanuMdi 
*paMxilYlYapEnuMdi/paMxilYlapEnuMdi/paMxilYlapEnuMci/paMxilYlapEniMci/paMxirlapEnuMdi/paMxirlapEnuMci/paMxirlapEniMci	n number bahu parsarg pEnuMdi 
paMxilYlakiMxanuMdi/paMxilYlakiMxanuMci/paMxilYlakiMxaniMci/paMxirlakiMxanuMdi/paMxirlakiMxanuMci/paMxirlakiMxaniMci/*paMxilYlYakriMxanuMdi/paMxilYlakriMxanuMdi/paMxilYlakriMxanuMci/paMxilYlakriMxaniMci/paMxirlakriMxanuMdi/paMxirlakriMxanuMci/paMxirlakriMxaniMci	n number bahu parsarg kriMxanuMdi 
*paMxilYlYadugunuMdi/paMxilYladugunuMdi/paMxilYladugunuMci/paMxilYladuguniMci/paMxirladugunuMdi/paMxirladugunuMci/paMxirladuguniMci	n number bahu parsarg adugunuMdi 
*paMxilYlYamuMxunuMdi/paMxilYlamuMxunuMdi/paMxilYlamuMxunuMci/paMxilYlamuMxuniMci/paMxirlamuMxunuMdi/paMxirlamuMxunuMci/paMxirlamuMxuniMci	n number bahu parsarg muMxunuMdi 
paMxilYlaveVnukanuMdi/paMxilYlaveVnakanuMdi/paMxilYlaveVnakAlanuMdi/paMxirlaveVnukanuMdi/paMxirlaveVnakanuMdi/paMxirlaveVnakAlanuMdi/*paMxilYlYaveVnakAlanuMci/paMxilYlaveVnakAlanuMci/paMxilYlaveVnukanuMci/paMxilYlaveVnakanuMci/paMxilYlaveVnakAwalanuMci/paMxilYlaveVnakAwalanuMci/paMxirlaveVnakAlanuMci/paMxirlaveVnukanuMci/paMxirlaveVnakanuMci/paMxirlaveVnakAwalanuMci/paMxirlaveVnakAwalanuMci	n number bahu parsarg veVnukanuMdi 
paMxilYleVxutinuMdi/*paMxilYlYakeVxutinuMdi/paMxilYlakeVxutinuMdi/paMxilYleVxutinuMci/paMxilYlakeVxutinuMci/paMxilYleVxutiniMci/paMxilYlakeVxutiniMci/paMxilYleVxutanuMdi/paMxilYlakeVxutanuMdi/paMxirleVxutinuMdi/paMxirleVxutinuMci/paMxirleVxutiniMci/paMxirlakeVxutanuMdi/paMxirlakeVxutanuMci/paMxirlakeVxutaniMci	n number bahu parsarg eVxutinuMdi 
*paMxilYlYamaXyanuMdi/paMxilYlamaXyanuMdi/paMxilYlamaXyanuMci/paMxilYlamaXyaniMcia/paMxirlamaXyanuMdi/paMxirlamaXyanuMci/paMxirlamaXyaniMci/paMxilYlamaXyalonuMdi/paMxilYlamaXyalonuMci/paMxilYlamaXyaloniMci/paMxirlamaXyalonuMdi/paMxirlamaXyalonuMci/paMxirlamaXyaloniMci	n number bahu parsarg maXyanuMdi 
*paMxilYlYanadumanuMdi/paMxilYlanadumanuMdi/paMxilYlanadamanuMdi/paMxilYlanadumanuMci/paMxilYlanadamanuMci/paMxilYlanadumaniMci/paMxilYlanadamaniMci/paMxirlanadumanuMdi/paMxirlanadumanuMci/paMxirlanadumaniMci	n number bahu parsarg nadumanuMdi 
*paMxilYlYawaravAwanuMci/paMxilYlawaravAwanuMci/paMxilYlawarvAwanuMci	n number bahu parsarg waravAwanuMdi 
*paMxilYlYacotlonuMdi/paMxilYlacotlonuMdi/paMxilYlacotlonuMci/paMxilYlacotloniMci/paMxirlacotlonuMdi/paMxirlacotlonuMci/paMxilYlacotunuMdi/paMxilYlacotunuMci/paMxilYlacotuniMci/paMxirlacotunuMdi/paMxirlacotunuMci/paMxirlacotuniMci	n number bahu parsarg cotlonuMdi 
*paMxilYlYasWAnamunuMdi/paMxilYlasWAnamunuMdi/paMxilYlasWAnaMnuMdi/paMxilYlasWAnamunuMci/paMxilYlasWAnaMniMci/paMxilYlasWAnamuloniMci/paMxirlasWAnaMnuMdi/paMxirlasWAnaMnuMci/paMxirlasWAnaMniMci/paMxilYlasWAnaMlonuMdi/paMxirlasWAnaMlonuMdi/paMxirlasWAnamulonuMdi/paMxilYlasWAnaMlonuMci/paMxilYlasWAnamuloniMci/paMxirlasWAnaMlonuMci/paMxirlasWAnaMloniMci	n number bahu parsarg sWAnaMnuMdi 
*paMxilYlYayaMxu/paMxilYlayaMxu/paMxilYlaMxu/paMxirlaMxu/paMxirlayaMxu	n number bahu parsarg aMxu 
*paMxilYlYaMte/paMxilYlaMte/paMxilYlaMteV/paMxirlaMte/paMxirlaMteV	n number bahu parsarg aMte 
*paMxilYlYakaMteV/paMxilYlakaMteV/paMxilYlakaMte/paMxirlakaMte/paMxilYlakanna/paMxilYlakannA/paMxirlakanna/paMxirlakannA	n number bahu parsarg kaMteV 
paMxirlEna/paMxilYlEna/*paMxilYlYEna	n number bahu parsarg Ena 
paMxirlapAti/paMxilYlapAti/*paMxilYlYapAti	n number bahu parsarg pAti 
paMxilYlalAti/*paMxilYlYalAMti/paMxilYlalAMti/paMxirlalAMti/paMxirlalAti	n number bahu parsarg lAMti 
paMxirlugAnI/paMxirlukAnI/*paMxilYlYugAnI/paMxilYlugAnI/paMxilYlukAnI	n number bahu parsarg gAni 
paMxirlugA/paMxilYlugA/*paMxilYlYugA	n number bahu parsarg gA 
