noun	
pillavAdu	
*pillavAdu	n number eka parsarg 0 
pillavAdU/*pillavAdA	n number eka parsarg I 
-	n number eka parsarg gA 
pillavAdigAdu/*pillavAdugAdu/pillavAnigAdu	n number eka parsarg gAdu 
pillavAdigawweV/*pillavAdugawweV/pillavAnigawweV	n number eka parsarg gawweV 
*pillavAdivAdu/pillavAnivAdu	n number eka parsarg vAdu 
*pillavAdAyana	n number eka parsarg Ayana 
*pillavAdivAru/pillavAnivAru	n number eka parsarg vAru 
*pillavAdixi/pillavAnixi	n number eka parsarg xi 
*pillavAdivi/pillavAdiy/pillavAdiyyi/pillavAnivi/pillavAniy/pillavAniyyi	n number eka parsarg vi 
*pillavAdugAru/pillavAdigAru/pillavAnigAru	n number eka parsarg gAru 
*pillavAdini/pillavAnini	n number eka parsarg nu 
*pillavAdivi/pillavAnivi	n number eka parsarg vu 
pillavAniyoVkka/*pillavAdiyoVkka	n number eka parsarg yoVkka 
*pillavAdi/pillavAni	n number eka parsarg obl 
*pillavAdini/pillavANNi/pillavAnini/pillavANNi	n number eka parsarg ni 
*pillavAdiki/pillavAdiku/pillavAniki/pillavAniku	n number eka parsarg ki 
*pillavAdiwo/pillavAdiwoda/pillavAdiwoti/pillavAniwo/pillavAniwoda/pillavAniwoti	n number eka parsarg wo 
*pillavAdilo/pillavAdilona/pillavAdilopala/pillavAnilo/pillavAnilona/pillavAnilopala	n number eka parsarg lo 
*pillavAdiloni/pillavAdilopali/pillavAdiyaMxali/pillavAlYloni/pillavAniloni/pillavAnilopali/pillavAniyaMxali/pillavAlYloni	n number eka parsarg loni 
*pillavAdimIxa/pillavAnimIxa	n number eka parsarg mIxa 
*pillavAdina/pillavAnina	n number eka parsarg na 
pillavAdiniMci/pillavAdinuMci/*pillavAdinuMdi/pillavANNiMci/pillavANNuMci/pillavANNuMdi/pillavAniniMci/pillavAninuMci/pillavAninuMdi/pillavANNiMci/pillavANNuMci/pillavANNuMdi	n number eka parsarg niMci 
*pillavAdixvArA/pillavAnixvArA/pillavAdixvAra/pillavAnixvAra	n number eka parsarg xvArA 
*pillavAdivalana/pillavAdivalla	n number eka parsarg valana 
*pillavAdinibatti/pillavANNibatti/pillavAnivalana/pillavAnivalla/pillavAninibatti/pillavANNibatti/pillavAninibatti	n number eka parsarg batti 
pillavAdice/*pillavAdicewa/pillavAnice/pillavAnicewa	n number eka parsarg ce 
*pillavAdiwopAtu/pillavAdiwobAtu/pillavAniwopAtu/pillavAniwobAtu/pillavAniwopAtu/pillavAniwobAtu	n number eka parsarg wopAtu 
pillavAdiwokUdi/pillavAdiwokUda/*pillavAdiwokUdA/pillavAdiwogUdi/pillavAdiwogUda/pillavAdiwogUda/pillavAniwokUdi/pillavAniwokUda/pillavAniwokUdA/pillavAniwogUdi/pillavAniwogUda/pillavAniwogUdA	n number eka parsarg wokUdi 
*pillavAdikosaM/pillavAdikE/pillavAnikosaM/pillavAnikE/pillavAdArWaM	n number eka parsarg kosaM 
*pillavAdikoVraku/pillavAdikoVrYaku/pillavAnikoVraku/pillavAnikoVrYaku	n number eka parsarg koVraku 
*pillavAdilonuMdi/pillavAdilonuMci/pillavAdiloniMci/pillavAnilonuMdi/pillavAnilonuMci/pillavAniloniMci/pillavAnilonuMdi/pillavAnilonuMci/pillavAniloniMci	n number eka parsarg lonuMdi 
*pillavAdimIxanuMdi/pillavAdimIxanuMci/pillavAdimIxaniMci/pillavAnimIxanuMdi/pillavAnimIxanuMci/pillavAnimIxaniMci	n number eka parsarg mIxanuMdi 
*pillavAdixAkA/pillavAdixAka/pillavAnixAkA/pillavAnixAka	n number eka parsarg xAkA 
*pillavAdivaraku/pillavAnivaraku	n number eka parsarg varaku 
*pillavAdimIxaki/pillavAdimIxaku/pillavAdimIxiki/pillavAnimIxaki/pillavAnimIxaku/pillavAnimIxiki	n number eka parsarg mIxaki 
*pillavAdixaggara/pillavAdixaggira/pillavAnixaggara/pillavAnixaggira	n number eka parsarg xaggara 
*pillavAdivaxxa/pillavAdoVxxa/pillavAdiyoVxxa/pillavAnivaxxa/pillavAniyoVxxa	n number eka parsarg vaxxa 
*pillavAdikAda/pillavAnikAda	n number eka parsarg kAda 
*pillavAdikeVxurugA/pillavAdeVxurugA/pillavAnikeVxurugA	n number eka parsarg keVxurugA 
*pillavAdimuMxu/pillavAnimuMxu	n number eka parsarg muMxu 
*pillavAdiguriMci/pillavAdiniguriMci/pillavANNiguriMci/pillavANNigUrci/pillavAniguriMci/pillavAniniguriMci/pillavANNiguriMci/pillavANNigUrci	n number eka parsarg guriMci 
pillavAdipE/*pillavAdipEna/pillavAdipEni/pillavAnipE/pillavAnipEna/pillavAnipEni	n number eka parsarg pE 
*pillavAdipEki/pillavAnipEki	n number eka parsarg pEki 
*pillavAdiguMdA/pillavAniguMdA	n number eka parsarg guMdA 
pillavAdilA/pillavAdilAga/*pillavAdilAgA/pillavAnilA/pillavAnilAga/pillavAnilAgA	n number eka parsarg lA 
*pillavAdivaleV/pillavAdimAxiri/pillavAdinipoli/pillavANNipolina/pillavAdinibolina/pillavAnivale/pillavAnimAxiri/pillavAninipoli/pillavANNipolina/pillavAninibolina	n number eka parsarg vale 
pillavAdikimalle/*pillavAdikimalleV/pillavAnikimalle	n number eka parsarg kimalle 
*pillavAdukUdA/pillavAdinikUdA/pillavAdugUdA/pillavAdinigUdA/pillavAninikUdA/pillavAninigUdA	n number eka parsarg kUdA 
*pillavAdixqRtilo/pillavAdixruRtilo/pillavAnixqRtilo/pillavAnixruRtilo	n number eka parsarg xqRtilo 
*pillavAdulekuMdA/pillavAdinilekuMdA/pillavAdulekuMda/pillavAdinilekuMda/pillavAninilekuMdA/pillavAninilekuMda	n number eka parsarg lekuMdA 
*pillavAdukAkuMdA/pillavAdinikAkuMdA/pillavAdukAkuMda/pillavAdinukAkuMdA/pillavAninikAkuMdA/pillavAninukAkuMdA	n number eka parsarg kAkuMdA 
*pillavAdumoVxalukoVni/pillavAdimoVxalukoVni/pillavAdinimoVxalukoVni/pillavAdinumoVxalukoVni/pillavAnimoVxalukoVni/pillavAninimoVxalukoVni/pillavAninumoVxalukoVni  -- added this option	n number eka parsarg moVxalukoVni 
*pillavAdivEpu/pillavAdivepu/pillavAnivEpu/pillavAnivepu/pillavAdikesi/pillavAnikesi	n number eka parsarg vEpu 
pillavAdipakka/pillavAdiprakka/pillavAdipakkana/*pillavAdiprakkana/pillavAdipakkani/pillavAnipakka/pillavAniprakka/pillavAnipakkana/pillavAniprakkana/pillavAnipakkani	n number eka parsarg pakka 
pillavAdipakkalo/*pillavAdiprakkalo/pillavAdipakkalona/pillavAdipakkaloni/pillavAnipakkalo/pillavAniprakkalo/pillavAnipakkalona/pillavAnipakkaloni	n number eka parsarg pakkalo 
*pillavAdiloki/pillavAdiloniki/pillavAdilopalaki/pillavAdilopalaku/pillavAdilopaliki/pillavAniloki/pillavAniloniki/pillavAnilopalaki/pillavAnilopalaku/pillavAnilopaliki	n number eka parsarg lopalaki 
pillavAdikiMxa/*pillavAdikriMxa/pillavAnikiMxa/pillavAnikriMxa/pillavAdikriMxane/pillavAdikiMxane/pillavAnikriMxane/pillavAnikiMxane	n number eka parsarg kiMxa 
pillavAdaduguna/*pillavAdikaduguna/pillavAnikaduguna	n number eka parsarg aduguna 
*pillavAdikeVlla/pillavAdikalla/pillavAnikeVlla/pillavAnikalla	n number eka parsarg kalla 
pillavAdiveVnuka/*pillavAdiveVnakAla/pillavAdiveVnakAwala/pillavAdiveVnakana/pillavAniveVnuka/pillavAniveVnakAla/pillavAniveVnakAwala/pillavAniveVnakana	n number eka parsarg veVnuka 
pillavAdiwaravAwa/pillavAdiwarvAwa/*pillavAdiwaruvAwa/pillavAdiwaravAwana/pillavAdiwarvAwana/pillavAdiwaruvAwana/pillavAniwaravAwa/pillavAniwarvAwa/pillavAniwaruvAwa/pillavAniwaravAwana/pillavAniwarvAwana/pillavAniwaruvAwana	n number eka parsarg waravAwa 
pillavAdeVxuruguMdA/*pillavAdikeVxuruguMdA/pillavAnikeVxuruguMdA	n number eka parsarg eVxuruguMdA 
*pillavAdimaXya/pillavAdimaXyalo/pillavAdimaXyana/pillavAnimaXya/pillavAnimaXyalo/pillavAnimaXyana	n number eka parsarg maXya 
*pillavAdinaduma/pillavAdinadumana/pillavAninaduma/pillavAninadumana	n number eka parsarg naduma 
pillavAdibaxulugA/pillavAdibaxulu/*pillavAdikibaxulu/pillavAdikubaxulu/pillavAnibaxulugA/pillavAnibaxulu/pillavAnikibaxulu/pillavAnikubaxulu	n number eka parsarg baxulugA 
*pillavAdicotlo/pillavAdicotulo/pillavAdicotuna/pillavAdicota/pillavAnicotlo/pillavAnicotulo/pillavAnicotuna/pillavAnicotu	n number eka parsarg cotlo 
*pillavAdisWAnaMlo/pillavAdiswAnaMlo/pillavAnisWAnaMlo/pillavAniswAnaMlo	n number eka parsarg sWAnaMlo 
pillavAdinerugA/pillavAdikunerugA/*pillavAdikinerugA/pillavAninerugA/pillavAnikunerugA/pillavAnikinerugA	n number eka parsarg nerugA 
*pillavAdiprakAraM/pillavAdiprakAramu/pillavAniprakAraM/pillavAniprakAramu	n number eka parsarg prakAraM 
*pillavAdixaggaranuMdi/pillavAdixaggaranuMci/pillavAdixaggiranuMdi/pillavAdixaggiranuMci/pillavAnixaggaranuMdi/pillavAnixaggaranuMci/pillavAnixaggiranuMdi/pillavAnixaggiranuMci	n number eka parsarg xaggaranuMdi 
*pillavAdivaxxanuMdi/pillavAdivaxxanuMci/pillavAdivaxxaniMci/pillavAnivaxxanuMdi/pillavAnivaxxanuMci/pillavAnivaxxaniMci	n number eka parsarg vaxxanuMdi 
*pillavAdipakkanuMdi/pillavAdipakkanuMci/pillavAdipakkaniMci/pillavAnipakkanuMdi/pillavAnipakkanuMci/pillavAnipakkaniMci/pillavAdipakkalonuMdi/pillavAdipakkalonuMci/pillavAdipakkaloniMci/pillavAnipakkalonuMdi/pillavAnipakkalonuMci/pillavAnipakkaloniMci	n number eka parsarg pakkanuMdi 
*pillavAdilopalanuMdi/pillavAdilopalinuMdi/pillavAdilopalanuMci/pillavAdilopalanuMci/pillavAdilopalaniMci/pillavAnilopalanuMdi/pillavAnilopalanuMdi/pillavAnilopalanuMci/pillavAnilopalanuMci/pillavAnilopalaniMci	n number eka parsarg lopalanuMdi 
*pillavAdibEtanuMdi/pillavAdibEtanuMci/pillavAdibEtaniMci/pillavAnibEtanuMdi/pillavAnibEtanuMci/pillavAnibEtaniMci	n number eka parsarg bEtanuMdi 
*pillavAdipEnuMdi/pillavAdipEnuMci/pillavAdipEniMci/pillavAnipEnuMdi/pillavAnipEnuMci/pillavAnipEniMci	n number eka parsarg pEnuMdi 
pillavAdikiMxanuMdi/pillavAdikiMxanuMci/pillavAdikiMxaniMci/pillavAnikiMxanuMdi/pillavAnikiMxanuMci/pillavAnikimIxaniMci/*pillavAdikriMxanuMdi/pillavAdikriMxanuMci/pillavAdikriMxaniMci/pillavAnikriMxanuMdi/pillavAnikriMxanuMci/pillavAnikriMxaniMci	n number eka parsarg kriMxanuMdi 
pillavAdadugunuMdi/pillavAdadugunuMci/*pillavAdikadugunuMdi/pillavAdikadugunuMci/pillavAdikaduguniMci/pillavAnikadugunuMdi/pillavAnikadugunuMci/pillavAnikaduguniMci	n number eka parsarg adugunuMdi 
*pillavAdimuMxunuMdi/pillavAdimuMxunuMci/pillavAdimuMxuniMci/pillavAnimuMxunuMdi/pillavAnimuMxunuMci/pillavAnimuMxuniMci	n number eka parsarg muMxunuMdi 
pillavAdiveVnukanuMdi/*pillavAdiveVnakAlanuMdi/pillavAdiveVnakAwalanuMdi/pillavAdiveVnakanuMdi/pillavAniveVnukanuMdi/pillavAniveVnakAlanuMdi/pillavAniveVnakAwalanuMdi/pillavAniveVnakanuMdi/pillavAdiveVnukanuMci/pillavAdiveVnakAlanuMci/pillavAdiveVnakAwalanuMci/pillavAdiveVnakanuMci/pillavAniveVnukanuMci/pillavAniveVnakAlanuMci/pillavAniveVnakAwalanuMci/pillavAniveVnakanuMci	n number eka parsarg veVnukanuMdi 
pillavAdeVxutinuMdi/*pillavAdikeVxutinuMdi/pillavAdikeVxutinuMci/pillavAdeVxutinuMci/pillavAnikeVxutinuMdi/pillavAnikeVxutinuMci	n number eka parsarg eVxutinuMdi 
*pillavAdimaXyanuMdi/pillavAdimaXyanuMci/pillavAnimaXyanuMdi/pillavAnimaXyanuMci/pillavAdimaXyalonuMdi/pillavAdimaXyalonuMci/pillavAnimaXyalonuMdi/pillavAnimaXyalonuMci	n number eka parsarg maXyanuMdi 
*pillavAdinadumanuMdi/pillavAdinadumanuMci/pillavAninadumanuMdi/pillavAninadumanuMci	n number eka parsarg nadumanuMdi 
*pillavAdiwaravAwanuMdi/pillavAdiwarvAwanuMdi/pillavAdiwaravAwanuMci/pillavAdiwarvAwanuMci/pillavAniwaravAwanuMdi/pillavAniwarvAwanuMdi/pillavAniwaravAwanuMci/pillavAniwarvAwanuMci	n number eka parsarg waravAwanuMdi 
*pillavAdicotlonuMdi/pillavAdicotunuMdi/pillavAdicotlonuMci/pillavAdicotunuMci/pillavAnicotlonuMdi/pillavAnicotunuMdi/pillavAnicotlonuMci/pillavAnicotunuMci	n number eka parsarg cotlonuMdi 
pillavAdisWAnaMnuMdi/*pillavAdisWAnamunuMdi/pillavAdisWAnaMnuMci/pillavAdisWAnamunuMci/pillavAnisWAnaMnuMdi/pillavAnisWAnamunuMdi/pillavAnisWAnaMnuMci/pillavAnisWAnamunuMci/pillavAdisWAnaMlonuMdi/pillavAdisWAnamulonuMdi/pillavAnisWAnaMlonuMdi/pillavAnisWAnamulonuMdi/pillavAdisWAnaMlonuMci/pillavAdiswAnamulonuMci/pillavAnisWAnaMlonuMci/pillavAniswAnamulonuMci	n number eka parsarg sWAnaMnuMdi 
pillavAdaMxu/pillavAdinaMxu/*pillavAdiyaMxu/pillavAninaMxu/pillavAniyaMxu	n number eka parsarg aMxu 
pillavAdaMte/*pillavAdaMteV	n number eka parsarg aMte 
*pillavAdikaMteV/pillavAdikaMte/pillavAdikanna/pillavAdikannA/pillavAnikaMteV/pillavAnikaMte/pillavAnikanna/pillavAnikannA	n number eka parsarg kaMteV 
*pillavAdEna/pillavAdayina	n number eka parsarg Ena 
pillavAdupAti/*pillavAdipAti/pillavAnipAti	n number eka parsarg pAti 
*pillavAdilAMti/pillavAdilAti/pillavAnilAMti/pillavAnilAti	n number eka parsarg lAMti 
*pillavAdugAnI/pillavAdukAnI	n number eka parsarg gAni 
pillavAdugA/*pillavAdigA	n number eka parsarg gA 
pillavAlYlu/*pillavAlYlYu	n number bahu parsarg 0 
pillavAlYlU/pillavAlYlalArA/*pillavAlYlYArA	n number bahu parsarg I 
-	n number bahu parsarg gA 
pillavAlYlagAdu/*pillavAlYlYagAdu	n number bahu parsarg gAdu 
pillavAlYlagawweV/*pillavAlYlYagawweV	n number bahu parsarg gawweV 
*pillavAlYlYavAdu/pillavAlYlavAdu/pillavAlYlodu	n number bahu parsarg vAdu 
pillavAlYlAyana/*pillavAlYlYAyana	n number bahu parsarg Ayana 
*pillavAlYlYvAru/pillavAlYlavAru/pillavAlYloru	n number bahu parsarg vAru 
*pillavAlYlYaxi/pillavAlYlaxi/pillavAlxi	n number bahu parsarg xi 
*pillavAlYlYavi/pillavAlYlavi/pillavAlYlayyi/pillavAlYlay	n number bahu parsarg vi 
pillavAlYlagAru/*pillavAlYlYagAru	n number bahu parsarg gAru 
pillavAlYlamu/*pillavAlYlYaM/pillavAlYlaM	n number bahu parsarg nu 
-	n number bahu parsarg vu 
pillavAlYlayoVkka/*pillavAlYlYayoVkka	n number bahu parsarg yoVkka 
pillavAlYla/*pillavAlYlYa	n number bahu parsarg obl 
*pillavAlYlYani/pillavAlYlani/pillavAlYlani/pillavAlYlanu/pillavAlYlanu	n number bahu parsarg ni 
*pillavAlYlYaki/pillavAlYlaki/pillavAlYlaku	n number bahu parsarg ki 
*pillavAlYlYawo/pillavAlYlawo/pillavAlYlawoti/pillavAlYlawoda	n number bahu parsarg wo 
*pillavAlYlYallo/pillavAlYlallo/pillavAlYlalo/pillavAlYlalopala/pillavAlYlalona	n number bahu parsarg lo 
*pillavAlYlYaloni/pillavAlYlaloni/pillavAlYlalopali/pillavAlYlayaMxali	n number bahu parsarg loni 
pillavAlYlamIxa/*pillavAlYlYamIxa	n number bahu parsarg mIxa 
pillavAlYlana/*pillavAlYlYana	n number bahu parsarg na 
pillavAlYlaniMci/pillavAlYlanuMci/pillavAlYlanuMdi/*pillavAlYlYanuMdi	n number bahu parsarg niMci 
*pillavAlYlYaxvArA/pillavAlYlaxvArA/pillavAlYlaxvAra	n number bahu parsarg xvArA 
*pillavAlYlYavalana/pillavAlYlavalana/pillavAlYlavalla	n number bahu parsarg valana 
*pillavAlYlYanubatti/pillavAlYlanubatti/pillavAlYlanibatti	n number bahu parsarg batti 
*pillavAlYlYacewa/pillavAlYlacewa/pillavAlYlace	n number bahu parsarg ce 
*pillavAlYlYawopAtu/pillavAlYlawopAtu/pillavAlYlawobAtu	n number bahu parsarg wopAtu 
*pillavAlYlYawokUdi/pillavAlYlawokUdi/pillavAlYlawogUdi/pillavAlYlawokUdA/pillavAlYlawogUdA	n number bahu parsarg wokUdi 
*pillavAlYlYakosaM/pillavAlYlakosaM/pillavAlYlakE/pillavAlYlArWaM	n number bahu parsarg kosaM 
*pillavAlYlYakoVraku/pillavAlYlakoVraku/pillavAlYlakoVrYaku	n number bahu parsarg koVraku 
*pillavAlYlYalonuMdi/pillavAlYlalonuMdi/pillavAlYlalonuMci/pillavAlYlaloniMci	n number bahu parsarg lonuMdi 
*pillavAlYlYamIxanuMdi/pillavAlYlamIxanuMdi/pillavAlYlamIxanuMci/pillavAlYlamIxaniMci	n number bahu parsarg mIxanuMdi 
*pillavAlYlYaxAkA/pillavAlYlaxAkA/pillavAlYlaxAka	n number bahu parsarg xAkA 
pillavAlYlavaraku/*pillavAlYlYavaraku	n number bahu parsarg varaku 
*pillavAlYlYamIxaki/pillavAlYlamIxaki/pillavAlYlamIxaku/pillavAlYlamIxiki	n number bahu parsarg mIxaki 
*pillavAlYlYaxaggara/pillavAlYlaxaggara/pillavAlYlaxaggira	n number bahu parsarg xaggara 
*pillavAlYlYavaxxa/pillavAlYlavaxxa/pillavAlYloVxxa	n number bahu parsarg vaxxa 
pillavAlYlakAda/*pillavAlYlYakAda	n number bahu parsarg kAda 
pillavAlYleVxurugA/pillavAlYlakeVxurugA/*pillavAlYlYakeVxurugA	n number bahu parsarg keVxurugA 
pillavAlYlamuMxu/*pillavAlYlYamuMxu	n number bahu parsarg muMxu 
*pillavAlYlYaguriMci/pillavAlYlaguriMci/pillavAlYlagUrci/pillavAlYlanuguriMci/pillavAlYlanigUrci	n number bahu parsarg guriMci 
pillavAlYlapE/pillavAlYlapEni/pillavAlYlapEna/*pillavAlYlYapEna	n number bahu parsarg pE 
pillavAlYlapEki/*pillavAlYlYapEki	n number bahu parsarg pEki 
pillavAlYlaguMdA/*pillavAlYlYaguMdA	n number bahu parsarg guMdA 
pillavAlYlalA/pillavAlYlalAga/pillavAlYlalAgA/*pillavAlYlYalAgA	n number bahu parsarg lA 
pillavAlYlavale/pillavAlYlavaleV/*pillavAlYlYavaleV/pillavAlYlamAxiri/pillavAlYlanupolina/pillavAlYlanubolina	n number bahu parsarg vale 
pillavAlYlakumalle/pillavAlYlakumalleV/*pillavAlYlYakumalleV	n number bahu parsarg kimalle 
*pillavAlYlYukUdA/pillavAlYlukUdA/pillavAlYlanukUdA/pillavAlYlugUdA/pillavAlYlanugUdA	n number bahu parsarg kUdA 
*pillavAlYlYaxqRtilo/pillavAlYlaxqRtilo/pillavAlYlaxruRtilo	n number bahu parsarg xqRtilo 
*pillavAlYlYulekuMdA/pillavAlYlulekuMdA/pillavAlYlulekuMda/pillavAlYluleka	n number bahu parsarg lekuMdA 
*pillavAlYlYukAkuMdA/pillavAlYlukAkuMdA/pillavAlYlukAkuMda/pillavAlYlukAka	n number bahu parsarg kAkuMdA 
*pillavAlYlYumoVxalukoVni/pillavAlYlumoVxalukoVni/pillavAlYlanumoVxalukoVni	n number bahu parsarg moVxalukoVni 
*pillavAlYlYavEpu/pillavAlYlavEpu/pillavAlYlavepu/pillavAlYlakesi	n number bahu parsarg vEpu 
pillavAlYlapakka/pillavAlYlapakkana/pillavAlYlaprakka/pillavAlYlaprakkana/*pillavAlYlYaprakkana	n number bahu parsarg pakka 
pillavAlYlapakkalo/pillavAlYlaprakkalo/*pillavAlYlYaprakkalo	n number bahu parsarg pakkalo 
*pillavAlYlYaloki/pillavAlYlaloki/pillavAlYlaloniki/pillavAlYlalopalaki/pillavAlYlalopaliki/pillavAlYlalopaliki/pillavAlYlalopalaku	n number bahu parsarg lopalaki 
pillavAlYlakiMxa/pillavAlYlakriMxa/*pillavAlYlYakriMxa/pillavAlYlakriMxane/pillavAlYlakiMxane	n number bahu parsarg kiMxa 
pillavAlYladuguna/pillavAlYlakaduguna/*pillavAlYlYakaduguna	n number bahu parsarg aduguna 
*pillavAlYlYakeVlla/pillavAlYlakeVlla/pillavAlYlakalla	n number bahu parsarg kalla 
pillavAlYlaveVnuka/pillavAlYlaveVnaka/pillavAlYlaveVnakAla/*pillavAlYlYaveVnakAla/pillavAlYlaveVnukAla/pillavAlYlaveVnakAwala/pillavAlYlaveVnukAwala	n number bahu parsarg veVnuka 
pillavAlYlawaravAwa/pillavAlYlawarvAwa/pillavAlYlawaruvAwa/*pillavAlYlYawaruvAwa	n number bahu parsarg waravAwa 
pillavAlYleVxuruguMdA/pillavAlYlakeVxuruguMdA/*pillavAlYlYakeVxuruguMdA	n number bahu parsarg eVxuruguMdA 
*pillavAlYlYamaXya/pillavAlYlamaXya/pillavAlYlamaXyana/pillavAlYlamaXyalo	n number bahu parsarg maXya 
*pillavAlYlYanaduma/pillavAlYlanaduma/pillavAlYlakinaduma	n number bahu parsarg naduma 
pillavAlYlabaxulugA/pillavAlYlakibaxulugA/pillavAlYlabaxulu/pillavAlYlakibaxulu/*pillavAlYlYakibaxulu	n number bahu parsarg baxulugA 
*pillavAlYlYacotlo/pillavAlYlacotlo/pillavAlYlacotulo	n number bahu parsarg cotlo 
pillavAlYlasWAnaMlo/pillavAlYlaswAnaMlo/pillavAlYlasWAnamulo/*pillavAlYlYasWAnamulo	n number bahu parsarg sWAnaMlo 
pillavAlYlanerugA/pillavAlYlakunerugA/pillavAlYlakinerugA/*pillavAlYlYakinerugA	n number bahu parsarg nerugA 
*pillavAlYlYaprakAraM/pillavAlYlaprakAraM/pillavAlYlanubatti/pillavAlYlabatti/pillavAlYlanibatti	n number bahu parsarg prakAraM 
*pillavAlYlYaxaggaranuMdi/pillavAlYlaxaggaranuMdi/pillavAlYlaxaggiranuMdi/pillavAlYlaxaggaranuMci/pillavAlYlaxaggiranuMci	n number bahu parsarg xaggaranuMdi 
*pillavAlYlYavaxxanuMdi/pillavAlYlavaxxanuMdi/pillavAlYlavaxxanuMci	n number bahu parsarg vaxxanuMdi 
*pillavAlYlYapakkanuMdi/pillavAlYlapakkanuMdi/pillavAlYlapakkanuMci/pillavAlYlYapakkalonuMdi/pillavAlYlapakkalonuMdi/pillavAlYlapakkalonuMci	n number bahu parsarg pakkanuMdi 
*pillavAlYlYalopalanuMdi/pillavAlYlalopalanuMdi/pillavAlYlalopalinuMdi/pillavAlYlalopalanuMci/pillavAlYlalopalanuMci/pillavAlYlalopalinuMdi/pillavAlYlalopalinuMci	n number bahu parsarg lopalanuMdi 
*pillavAlYlYabEtanuMdi/pillavAlYlabEtanuMdi/pillavAlYlabEtanuMci/pillavAlYlabEtaniMci	n number bahu parsarg bEtanuMdi 
*pillavAlYlYapEnuMdi/pillavAlYlapEnuMdi/pillavAlYlapEnuMci/pillavAlYlapEniMci	n number bahu parsarg pEnuMdi 
pillavAlYlYakiMxanuMdi/pillavAlYlakiMxanuMdi/pillavAlYlakiMxanuMci/pillavAlYlakiMxaniMci/*pillavAlYlYakriMxanuMdi/pillavAlYlakriMxanuMdi/pillavAlYlakriMxanuMci/pillavAlYlakriMxaniMci	n number bahu parsarg kriMxanuMdi 
*pillavAlYlYadugunuMdi/pillavAlYladugunuMdi/pillavAlYladugunuMci/pillavAlYladuguniMci	n number bahu parsarg adugunuMdi 
*pillavAlYlYamuMxunuMdi/pillavAlYlamuMxunuMdi/pillavAlYlamuMxunuMci/pillavAlYlamuMxuniMci	n number bahu parsarg muMxunuMdi 
pillavAlYlaveVnukanuMdi/pillavAlYlaveVnakanuMdi/pillavAlYlaveVnakAlanuMdi/*pillavAlYlYaveVnakAlanuMdi/pillavAlYlYaveVnakAlanuMci/pillavAlYlaveVnakAlanuMci/pillavAlYlaveVnukanuMci/pillavAlYlaveVnakanuMci/pillavAlYlaveVnakAwalanuMdi/pillavAlYlaveVnakAwalanuMci	n number bahu parsarg veVnukanuMdi 
pillavAlYleVxutinuMdi/pillavAlYlakeVxutinuMdi/*pillavAlYlYakeVxutinuMdi/pillavAlYleVxutinuMci/pillavAlYlakeVxutinuMci	n number bahu parsarg eVxutinuMdi 
*pillavAlYlYamaXyanuMdi/pillavAlYlamaXyanuMdi/pillavAlYlamaXyanuMci/pillavAlYlamaXyaniMci/pillavAlYlYamaXyalonuMdi/pillavAlYlamaXyalonuMdi/pillavAlYlamaXyalonuMci/pillavAlYlamaXyaloniMci	n number bahu parsarg maXyanuMdi 
*pillavAlYlYanadumanuMdi/pillavAlYlanadumanuMdi/pillavAlYlanadamanuMdi/pillavAlYlanadumanuMci/pillavAlYlanadamanuMci	n number bahu parsarg nadumanuMdi 
*pillavAlYlYawaravAwanuMdi/pillavAlYlawaravAwanuMdi/pillavAlYlawarvAwanuMdi/pillavAlYlawaravAwanuMci/pillavAlYlawarvAwanuMci	n number bahu parsarg waravAwanuMdi 
pillavAlYlacotunuMci/pillavAlYlacotunuMdi/pillavAlYlacotlonuMci/*pillavAlYlYacotlonuMdi/pillavAlYlacotlonuMdi/pillavAlYlacotulonuMci/pillavAlYlacotulonuMdi	n number bahu parsarg cotlonuMdi 
*pillavAlYlYasWAnamunuMdi/pillavAlYlasWAnamunuMdi/pillavAlYlasWAnaMnuMdi/pillavAlYlasWAnamunuMci/pillavAlYlasWAnaMnuMci/pillavAlYlasWAnaMlonuMdi/pillavAlYlasWAnamulonuMdi/pillavAlYlYasWAnamulonuMdi/pillavAlYlasWAnaMlonuMci/pillavAlYlYasWAnamulonuMci/pillavAlYlasWAnamulonuMci/pillavAlYlasWAnaMloniMci/pillavAlYlasWAnamuloniMci	n number bahu parsarg sWAnaMnuMdi 
*pillavAlYlYayaMxu/pillavAlYlayaMxu/pillavAlYlaMxu	n number bahu parsarg aMxu 
pillavAlYlaMte/pillavAlYlaMteV/*pillavAlYlYaMteV	n number bahu parsarg aMte 
*pillavAlYlYakaMteV/pillavAlYlakaMteV/pillavAlYlakaMte/pillavAlYlakanna/pillavAlYlakannA	n number bahu parsarg kaMteV 
*pillavAlYlYEna/pillavAlYlEna/pillavAlYlayina	n number bahu parsarg Ena 
pillavAlYlapAti/*pillavAlYlYapAti	n number bahu parsarg pAti 
*pillavAlYlYalAMti/pillavAlYlalAMti/pillavAlYlalAti/pillavAlYlavaMti	n number bahu parsarg lAMti 
*pillavAlYlYugAnI/pillavAlYlugAnI/pillavAlYlukAnI	n number bahu parsarg gAni 
pillavAlYlugA/*pillavAlYlYugA	n number bahu parsarg gA 
