noun	
putti	
*putti	n number eka parsarg 0 
-	n number eka parsarg I 
-	n number eka parsarg gA 
*puttigAdu	n number eka parsarg gAdu 
*puttigawweV	n number eka parsarg gawweV 
*puttivAdu	n number eka parsarg vAdu 
*puttAyana	n number eka parsarg Ayana 
*puttivAru	n number eka parsarg vAru 
*puttixi	n number eka parsarg xi 
*puttivi/puttiy	n number eka parsarg vi 
*puttigAru	n number eka parsarg gAru 
*puttini	n number eka parsarg nu 
*puttivi	n number eka parsarg vu 
*puttiyoVkka	n number eka parsarg yoVkka 
*putti	n number eka parsarg obl 
*puttini/puttinu	n number eka parsarg ni 
*puttiki/puttiku	n number eka parsarg ki 
*puttiwo/puttiwoda/puttiwoti	n number eka parsarg wo 
*puttilo/puttilona/puttilopala	n number eka parsarg lo 
*puttiloni/puttilopali/puttiyaMxali	n number eka parsarg loni 
*puttimIxa	n number eka parsarg mIxa 
*puttina	n number eka parsarg na 
puttiniMci/puttinuMci/*puttinuMdi	n number eka parsarg niMci 
*puttixvArA/puttuxvAra	n number eka parsarg xvArA 
*puttivalana/puttivalla	n number eka parsarg valana 
*puttinibatti	n number eka parsarg batti 
puttice/*putticewa	n number eka parsarg ce 
*puttiwopAtu/puttiwobAtu	n number eka parsarg wopAtu 
*puttiwokUdi/puttiwokUda/puttiwokUdA/puttiwogUdi/puttiwogUda/puttiwogUdA	n number eka parsarg wokUdi 
*puttikosaM/puttikE/puttArWaM	n number eka parsarg kosaM 
*puttikoVraku/puttikoVrYaku	n number eka parsarg koVraku 
*puttilonuMdi/puttilonuMci/puttiloniMci	n number eka parsarg lonuMdi 
*puttimIxanuMdi/puttimIxanuMci/puttimIxaniMci	n number eka parsarg mIxanuMdi 
*puttixAkA/puttixAka	n number eka parsarg xAkA 
*puttivaraku	n number eka parsarg varaku 
*puttimIxaki/puttimIxaku/puttimIxiki	n number eka parsarg mIxaki 
*puttixaggara/puttixaggira	n number eka parsarg xaggara 
*puttivaxxa/puttoVxxa	n number eka parsarg vaxxa 
*puttikAda	n number eka parsarg kAda 
*puttikeVxurugA/putteVxurugA	n number eka parsarg keVxurugA 
*puttimuMxu	n number eka parsarg muMxu 
*puttiguriMci/puttiniguriMci/puttinugUrci	n number eka parsarg guriMci 
puttipE/*puttipEna/puttipEni	n number eka parsarg pE 
*puttipEki	n number eka parsarg pEki 
*puttiguMdA	n number eka parsarg guMdA 
puttilA/puttilAga/*puttilAgA	n number eka parsarg lA 
*puttivale/puttimAxiri/puttinipoli/puttinuboli	n number eka parsarg vale 
*puttikimalle/puttikimalleV	n number eka parsarg kimalle 
*puttikUdA/puttinikUdA/puttikUda/puttigUdA/puttinigUdA/puttigUda	n number eka parsarg kUdA 
*puttixqRtilo/puttixruRtilo	n number eka parsarg xqRtilo 
*puttilekuMdA/puttinilekuMdA/puttilekuMda/puttinulekuMdA	n number eka parsarg lekuMdA 
*puttikAkuMdA/puttinikAkuMdA/puttikAka/puttinikAkuMda/puttigAkuMda/puttinigAkuMdA/puttigAka/puttigAkuMdA	n number eka parsarg kAkuMdA 
*puttimoVxalukoVni/puttinimoVxalukoVni/puttinumoVxalukoVni	n number eka parsarg moVxalukoVni 
*puttivEpu/*puttivepu/puttikesi	n number eka parsarg vEpu 
puttipakka/*puttiprakka/puttipakkana/puttiprakkana/puttipakkani	n number eka parsarg pakka 
puttipakkalo/*puttiprakkalo/puttipakkalona/puttipakkaloni	n number eka parsarg pakkalo 
*puttiloki/puttiloniki/puttilopalaki/puttilopalaku/puttilopaliki	n number eka parsarg lopalaki 
puttikiMxa/*puttikriMxa/puttikriMxana/puttikiMxana	n number eka parsarg kiMxa 
puttaduguna/*puttikaduguna	n number eka parsarg aduguna 
puttikeVlla/*puttikalla	n number eka parsarg kalla 
puttiveVnuka/*puttiveVnakAla/puttiveVnakAwala/puttiveVnakana	n number eka parsarg veVnuka 
puttiwaravAwa/puttiwarvAwa/*puttiwaruvAwa/puttiwaravAwana/puttiwarvAwana/puttiwaruvAwana	n number eka parsarg waravAwa 
putteVxuruguMdA/*puttikeVxuruguMdA	n number eka parsarg eVxuruguMdA 
*puttimaXya/puttimaXyalo/puttimaXyana	n number eka parsarg maXya 
*puttinaduma/puttinadumana	n number eka parsarg naduma 
puttibaxulugA/puttibaxulu/*puttikibaxulu/puttikubaxulu	n number eka parsarg baxulugA 
*putticotlo/putticotulo/putticotuna/putticota	n number eka parsarg cotlo 
*puttisWAnaMlo/puttiswAnaMlo	n number eka parsarg sWAnaMlo 
puttinerugA/puttikunerugA/*puttikinerugA	n number eka parsarg nerugA 
*puttiprakAraM/puttprakAramu	n number eka parsarg prakAraM 
*puttixaggaranuMdi/puttixaggaranuMci/puttixaggiranuMdi/puttixaggiranuMci	n number eka parsarg xaggaranuMdi 
*puttivaxxanuMdi/puttivaxxanuMci/puttivaxxaniMci	n number eka parsarg vaxxanuMdi 
*puttipakkanuMdi/puttipakkanuMci/puttipakkaniMci/puttipakkalonuMdi/puttipakkalonuMci/puttipakkaloniMci	n number eka parsarg pakkanuMdi 
*puttilopalanuMdi/puttilopalanuMci/puttilopalaniMci	n number eka parsarg lopalanuMdi 
*puttibEtanuMdi/puttibEtanuMci/puttibEtaniMci	n number eka parsarg bEtanuMdi 
*puttipEnuMdi/puttipEnuMci/puttipEniMci	n number eka parsarg pEnuMdi 
puttikiMxanuMdi/puttikiMxanuMci/puttikiMxaniMci/*puttikriMxanuMdi/puttikriMxanuMci/puttikriMxaniMci	n number eka parsarg kriMxanuMdi 
puttadugunuMdi/puttadugunuMci/*puttikadugunuMdi/puttikadugunuMci/puttikaduguniMci	n number eka parsarg adugunuMdi 
*puttimuMxunuMdi/puttimuMxunuMci/puttimuMxuniMci	n number eka parsarg muMxunuMdi 
puttiveVnukanuMdi/*puttiveVnakAlanuMdi/puttiveVnakAwalanuMdi/puttiveVnakanuMdi/puttiveVnukanuMci/puttiveVnakAlanuMci/puttiveVnakAwalanuMci/puttiveVnakanuMci	n number eka parsarg veVnukanuMdi 
putteVxutinuMdi/puttikeVxutinuMdi/puttikeVxutinuMci/putteVxutinuMci/putteVxutanuMdi/*puttikeVxutanuMdi/puttikeVxutanuMci/putteVxutanuMci	n number eka parsarg eVxutinuMdi 
*puttimaXyanuMdi/puttimaXyanuMci/puttimaXyalonuMdi/puttimaXyalonuMci	n number eka parsarg maXyanuMdi 
*puttinadumanuMdi/puttinadumanuMci	n number eka parsarg nadumanuMdi 
*puttiwaravAwanuMdi/puttiwarvAwanuMdi/puttiwaravAwanuMci/puttiwarvAwanuMci	n number eka parsarg waravAwanuMdi 
*putticotlonuMdi/putticotunuMdi/putticotlonuMci/putticotunuMci	n number eka parsarg cotlonuMdi 
puttisWAnaMnuMdi/*puttisWAnamunuMdi/puttisWAnaMnuMci/puttisWAnamunuMci/puttisWAnaMlonuMdi/puttisWAnamulonuMdi/puttisWAnaMlonuMci/puttiswAnamulonuMci	n number eka parsarg sWAnaMnuMdi 
puttaMxu/puttinaMxu/*puttiyaMxu	n number eka parsarg aMxu 
*puttaMte/puttaMteV	n number eka parsarg aMte 
*puttikaMteV/puttikaMte/puttikanna/puttikannA	n number eka parsarg kaMteV 
*puttEna	n number eka parsarg Ena 
*puttipAti	n number eka parsarg pAti 
*puttilAMti/puttilAti	n number eka parsarg lAMti 
*puttigAnI/puttikAnI	n number eka parsarg gAni 
*puttigA	n number eka parsarg gA 
*putlu	n number bahu parsarg 0 
-	n number bahu parsarg I 
*putlU/putlulArA	n number bahu parsarg gA 
*putlagAdu	n number bahu parsarg gAdu 
*putlagawweV	n number bahu parsarg gawweV 
*putlavAdu/putlodu	n number bahu parsarg vAdu 
*putlAyana	n number bahu parsarg Ayana 
*putlavAru/putloru	n number bahu parsarg vAru 
*putlaxi/puttulxi	n number bahu parsarg xi 
*putlavi/puttuliy/putliy	n number bahu parsarg vi 
*putlugAru	n number bahu parsarg gAru 
putlamu/*putlaM	n number bahu parsarg nu 
*putlu	n number bahu parsarg vu 
*putlayoVkka	n number bahu parsarg yoVkka 
*putla	n number bahu parsarg obl 
*putlani/puttulni/putlanu/puttulnu	n number bahu parsarg ni 
*putlaki/putlaku	n number bahu parsarg ki 
*putlawo/puttulwo/putlawoda/putlawoti/puttulwoti/puttulwoda	n number bahu parsarg wo 
*putlalo/puttullo/putlalona/puttullona	n number bahu parsarg lo 
*putlaloni/putlayaMxali/puttulloni	n number bahu parsarg loni 
*putlamIxa	n number bahu parsarg mIxa 
*putlana	n number bahu parsarg na 
putlaniMci/puttulniMci/putlanuMci/puttulnuMci/*putlanuMdi/puttulnuMdi	n number bahu parsarg niMci 
*putlaxvArA/putlaxvAra	n number bahu parsarg xvArA 
*putlavalana/putlavalla	n number bahu parsarg valana 
*putlanubatti	n number bahu parsarg batti 
*putlacewa/puttulcewa/putlace/puttulce	n number bahu parsarg ce 
*putlawopAtu/puttulwopAtu	n number bahu parsarg wopAtu 
*putlawokUdi/puttulwokUdi/putlawokUda/putlawokUdA/puttulwokUdA/putlawogUdi/puttulwogUdi/putlawogUda/putlawogUdA/puttulwogUdA	n number bahu parsarg wokUdi 
*putlakosaM/putlakE/putlArWaM	n number bahu parsarg kosaM 
*putlakoVraku/putlakoVrYaku	n number bahu parsarg koVraku 
*putlalonuMdi/putlalonuMci/puttullonuMdi/puttullonuMci/puttulloniMci/putlaloniMci	n number bahu parsarg lonuMdi 
*putlamIxanuMdi/putlamIxanuMci/putlamIxaniMci	n number bahu parsarg mIxanuMdi 
*putlaxAkA/putlaxAka	n number bahu parsarg xAkA 
*putlavaraku	n number bahu parsarg varaku 
*putlamIxaki/putlamIxaku/putlamIxiki	n number bahu parsarg mIxaki 
*putlaxaggara/putlaxaggira	n number bahu parsarg xaggara 
*putlavaxxa/puttuloVxxa	n number bahu parsarg vaxxa 
*putlakAda	n number bahu parsarg kAda 
putleVxurugA/*putlakeVxurugA	n number bahu parsarg keVxurugA 
*putlamuMxu	n number bahu parsarg muMxu 
*putlaguriMci/putlagUrci/putlanuguriMci/putlanugUrci	n number bahu parsarg guriMci 
putlapE/putlapEni/*putlapEna	n number bahu parsarg pE 
*putlapEki	n number bahu parsarg pEki 
*putlaguMdA	n number bahu parsarg guMdA 
putlalA/puttullA/*putlulAgA/puttullAgA/putlalAgA	n number bahu parsarg lA 
putlavale/*putlavaleV/putlamAxiri/putlanupolina/putlanubolina	n number bahu parsarg vale 
putlakumalle/*putlakumalleV	n number bahu parsarg kimalle 
*putlukUdA/putlanukUdA/putlugUdA/putlanugUdA	n number bahu parsarg kUdA 
*putlaxqRtilo/putlaxruRtilo	n number bahu parsarg xqRtilo 
*putlulekuMdA/puttullekuMdA	n number bahu parsarg lekuMdA 
*putlukAkuMdA/putlukAkuMda/putlukAka/putlugAkuMda/putlugAkuMdA/putlugAka	n number bahu parsarg kAkuMdA 
*putlumoVxalukoVni/putlanumoVxalukoVni	n number bahu parsarg moVxalukoVni 
*putlavEpu/putlavepu/putlakesi	n number bahu parsarg vEpu 
putlapakka/putlapakkana/*putlaprakka/putlaprakkana	n number bahu parsarg pakka 
putlapakkalo/*putlaprakkalo	n number bahu parsarg pakkalo 
*putlaloki/puttulloki/putlaloniki/puttulloniki/putlalopalaki/putlalopaliki/puttullopaliki/puttullopalaku	n number bahu parsarg lopalaki 
putlakiMxa/*putlakriMxa/putlakriMxana/putlakiMxana	n number bahu parsarg kiMxa 
putladuguna/*putlakaduguna	n number bahu parsarg aduguna 
putlakeVlla/*putlakalla	n number bahu parsarg kalla 
putlaveVnuka/putlaveVnaka/*putlaveVnakAla/putlaveVnukAla/putlaveVnakAwala/putlaveVnukAwala	n number bahu parsarg veVnuka 
*putlawaravAwa/putlawarvAwa/puttulwaravAwa	n number bahu parsarg waravAwa 
putleVxuruguMdA/*putlakeVxuruguMdA	n number bahu parsarg eVxuruguMdA 
*putlamaXya/putlamaXyana/putlamaXyalo	n number bahu parsarg maXya 
*putlanaduma/putlakinaduma	n number bahu parsarg naduma 
putlabaxulugA/putlakibaxulugA/putlabaxulu/*putlakibaxulu	n number bahu parsarg baxulugA 
*putlacotlo/putlacotulo	n number bahu parsarg cotlo 
putlasWAnaMlo/putlaswAnaMlo/*putlasWAnamulo	n number bahu parsarg sWAnaMlo 
putlanerugA/putlakunerugA/*putlakinerugA	n number bahu parsarg nerugA 
*putlaprakAraM/putlanubatti/putlabatti/putlanibatti	n number bahu parsarg prakAraM 
*putlaxaggaranuMdi/putlaxaggiranuMdi/putlaxaggaranuMci/putlaxaggiranuMci	n number bahu parsarg xaggaranuMdi 
*putlavaxxanuMdi/putlavaxxanuMci	n number bahu parsarg vaxxanuMdi 
*putlapakkanuMdi/putlapakkanuMci/putlapakkalonuMdi/putlapakkalonuMci	n number bahu parsarg pakkanuMdi 
*putlalopalanuMdi/puttullopalanuMdi/putlalopalanuMci/puttullopalanuMci/puttullopalinuMdi/putlalopalinuMci	n number bahu parsarg lopalanuMdi 
*putlabEtanuMdi/putlabEtanuMci/putlabEtaniMci	n number bahu parsarg bEtanuMdi 
*putlapEnuMdi/putlapEnuMci/putlapEniMci	n number bahu parsarg pEnuMdi 
putlakiMxanuMdi/putlakiMxanuMci/putlakiMxaniMci/*putlakriMxanuMdi/putlakriMxanuMci/putlakriMxaniMci	n number bahu parsarg kriMxanuMdi 
*putladugunuMdi/putladugunuMci/putladuguniMci	n number bahu parsarg adugunuMdi 
*putlamuMxunuMdi/putlamuMxunuMci/putlamuMxuniMci	n number bahu parsarg muMxunuMdi 
putlaveVnukanuMdi/putlaveVnakanuMdi/*putlaveVnakAlanuMdi/putlaveVnakAlanuMci/putlaveVnukanuMci/putlaveVnakanuMci/putlaveVnakAwalanuMdi/putlaveVnakAwalanuMci	n number bahu parsarg veVnukanuMdi 
putleVxutinuMdi/putlakeVxutinuMdi/putleVxutanuMdi/*putlakeVxutanuMdi/putleVxutinuMci/putlakeVxutinuMci/putleVxutanuMci/putlakeVxutanuMci	n number bahu parsarg eVxutinuMdi 
*putlamaXyanuMdi/putlamaXyanuMci/putlamaXyaniMci/putlamaXyalonuMdi/putlamaXyalonuMci/putlamaXyaloniMci	n number bahu parsarg maXyanuMdi 
*putlanadumanuMdi/putlanadamanuMdi/putlanadumanuMci/putlanadamanuMci	n number bahu parsarg nadumanuMdi 
*putlawaravAwanuMdi/putlawarvAwanuMdi/putlawaravAwanuMci/putlawarvAwanuMci	n number bahu parsarg waravAwanuMdi 
*putlacotlonuMdi/putlacotunuMdi/putlacotlonuMci/putlacotloniMci/putlacotunuMci/putlacotuniMci	n number bahu parsarg cotlonuMdi 
*putlasWAnamunuMdi/putlasWAnaMnuMdi/putlasWAnamunuMci/putlasWAnaMnuMci/putlasWAnaMlonuMdi/putlasWAnamulonuMdi/putlasWAnaMlonuMci/putlasWAnamulonuMci	n number bahu parsarg sWAnaMnuMdi 
*putlayaMxu/putlaMxu	n number bahu parsarg aMxu 
*putlaMte/putlaMteV	n number bahu parsarg aMte 
*putlakaMteV/putlakaMte/putlakanna/putlakannA	n number bahu parsarg kaMteV 
*putlEna	n number bahu parsarg Ena 
*putlapAti/putlupAti	n number bahu parsarg pAti 
*putlulAMti/putlulAti	n number bahu parsarg lAMti 
*putlugAnI/putlukAnI	n number bahu parsarg gAni 
*putlugA	n number bahu parsarg gA 
