noun	
peVtteV	
*peVtteV	n number eka parsarg 0  case d
-	n number eka parsarg I 
-	n number eka parsarg gA 
*peVtteVgAdu	n number eka parsarg gAdu  case d
*peVtteVgawweV	n number eka parsarg gawweV  case d
*peVtteVvAdu	n number eka parsarg vAdu  case d
*peVttAyana	n number eka parsarg Ayana  case d
*peVtteVvAru	n number eka parsarg vAru  case d
*peVtteVxi	n number eka parsarg xi  case d
*peVtteVvi	n number eka parsarg vi  case d
*peVtteVgAru	n number eka parsarg gAru  case d
*peVtteVni/peVtteVnu	n number eka parsarg nu 
*peVtteVvi/peVtteVvu	n number eka parsarg vu  case d
*peVtteVyoVkka	n number eka parsarg yoVkka 
*peVtteV	n number eka parsarg obl 
*peVtteVni/peVtteVnu	n number eka parsarg ni 
*peVtteVki/peVtteVku	n number eka parsarg ki 
*peVtteVwo/peVtteVwoda/peVtteVwoti	n number eka parsarg wo 
*peVtteVlo/peVtteVlona/peVtteVlopala	n number eka parsarg lo 
*peVtteVloni/peVtteVlopali/peVtteVyaMxali	n number eka parsarg loni 
*peVtteVmIxa	n number eka parsarg mIxa 
*peVtteVna	n number eka parsarg na 
peVtteVniMci/peVtteVnuMci/*peVtteVnuMdi	n number eka parsarg niMci 
*peVtteVxvArA	n number eka parsarg xvArA 
*peVtteVvalana/peVtteVvalla	n number eka parsarg valana 
*peVtteVnubatti/peVtteVnibatti	n number eka parsarg batti 
peVtteVce/*peVtteVcewa	n number eka parsarg ce 
*peVtteVwopAtu	n number eka parsarg wopAtu 
*peVtteVwokUdi/peVtteVwokUda/peVtteVwokUdA	n number eka parsarg wokUdi 
*peVtteVkosaM/peVtteVkE/peVttArWaM	n number eka parsarg kosaM 
*peVtteVkoVraku/peVtteVkoVrYaku	n number eka parsarg koVraku 
*peVtteVlonuMdi/peVtteVlonuMci/peVtteVloniMci	n number eka parsarg lonuMdi 
*peVtteVmIxanuMdi/peVtteVmIxanuMci/peVtteVmIxaniMci	n number eka parsarg mIxanuMdi 
*peVtteVxAkA/peVtteVxAka	n number eka parsarg xAkA 
*peVtteVvaraku	n number eka parsarg varaku 
*peVtteVmIxaki/peVtteVmIxaku/peVtteVmIxiki	n number eka parsarg mIxaki 
*peVtteVxaggara/peVtteVxaggira	n number eka parsarg xaggara 
*peVtteVvaxxa/peVttoVxxa	n number eka parsarg vaxxa 
*peVtteVkAda	n number eka parsarg kAda 
*peVtteVkeVxurugA/peVtteVxurugA	n number eka parsarg keVxurugA 
*peVtteVmuMxu	n number eka parsarg muMxu 
*peVtteVguriMci/peVtteVniguriMci/peVtteVnugUrci	n number eka parsarg guriMci 
peVtteVpE/*peVtteVpEna/peVtteVpEni	n number eka parsarg pE 
*peVtteVpEki	n number eka parsarg pEki 
*peVtteVguMdA	n number eka parsarg guMdA 
peVtteVlA/peVtteVlAga/*peVtteVlAgA	n number eka parsarg lA 
*peVtteVvale/peVtteVmAxiri/peVtteVnipoli/peVtteVnuboli	n number eka parsarg vale 
peVtteVkimalle/*peVtteVkumalle	n number eka parsarg kimalle 
*peVtteVkUdA/peVtteVnikUdA/peVtteVnukUdA	n number eka parsarg kUdA 
*peVtteVxqRtilo/peVtteVxruRtilo	n number eka parsarg xqRtilo 
*peVtteVlekuMdA/peVtteVleka/peVtteVlekuMda/peVtteVnulekuMdA	n number eka parsarg lekuMdA 
*peVtteVkAkuMdA/peVtteVkAka/peVtteVgAka/peVtteVnukAkuMdA	n number eka parsarg kAkuMdA 
*peVtteVmoVxalukoVni/peVtteVnimoVxalukoVni/peVtteVnumoVxalukoVni	n number eka parsarg moVxalukoVni 
*peVtteVvEpu/peVtteVvepu/peVtteVkesi	n number eka parsarg vEpu 
peVtteVpakka/peVtteVprakka/peVtteVpakkana/*peVtteVprakkana/peVtteVpakkani	n number eka parsarg pakka 
peVtteVpakkalo/*peVtteVprakkalo/peVtteVpakkalona/peVtteVpakkaloni	n number eka parsarg pakkalo 
*peVtteVloki/peVtteVloniki/peVtteVlopalaki/peVtteVlopalaku/peVtteVlopaliki	n number eka parsarg lopalaki 
peVtteVkiMxa/*peVtteVkriMxa/peVtteVkriMxane/peVtteVkiMxane	n number eka parsarg kiMxa 
peVttaduguna/*peVtteVkaduguna	n number eka parsarg aduguna 
*peVtteVkeVlla/peVtteVkalla	n number eka parsarg kalla 
peVtteVveVnuka/*peVtteVveVnakAla/peVtteVveVnakAwala/peVtteVveVnakana	n number eka parsarg veVnuka 
peVtteVwaravAwa/peVtteVwarvAwa/*peVtteVwaruvAwa/peVtteVwaravAwana/peVtteVwarvAwana/peVtteVwaruvAwana	n number eka parsarg waravAwa 
peVtteVxuruguMdA/*peVtteVkeVxuruguMdA	n number eka parsarg eVxuruguMdA 
peVtteVmaXya/*peVtteVmaXyalo/peVtteVmaXyana	n number eka parsarg maXya 
*peVtteVnaduma/peVtteVnadumuna	n number eka parsarg naduma 
peVtteVbaxulugA/peVtteVbaxulu/*peVtteVkibaxulu/peVtteVkubaxulu	n number eka parsarg baxulugA 
*peVtteVcotlo/peVtteVcotulo/peVtteVcotuna/peVtteVcotu	n number eka parsarg cotlo 
*peVtteVsWAnaMlo/peVtteVswAnaMlo	n number eka parsarg sWAnaMlo 
peVtteVnerugA/peVtteVkunerugA/*peVtteVkinerugA	n number eka parsarg nerugA 
*peVtteVprakAraM/peVtteVprakAramu	n number eka parsarg prakAraM 
*peVtteVxaggaranuMdi/peVtteVxaggaranuMci/peVtteVxaggiranuMdi/peVtteVxaggiranuMci	n number eka parsarg xaggaranuMdi 
*peVtteVvaxxanuMdi/peVtteVvaxxanuMci/peVtteVvaxxaniMci	n number eka parsarg vaxxanuMdi 
*peVtteVpakkanuMdi/peVtteVpakkanuMci/peVtteVpakkaniMci/peVtteVpakkalonuMdi/peVtteVpakkalonuMci/peVtteVpakkaloniMci	n number eka parsarg pakkanuMdi 
*peVtteVlopalanuMdi/peVtteVlopalanuMci/peVtteVlopalaniMci	n number eka parsarg lopalanuMdi 
*peVtteVbEtanuMdi/peVtteVbEtanuMci/peVtteVbEtaniMci	n number eka parsarg bEtanuMdi 
*peVtteVpEnuMdi/peVtteVpEnuMci/peVtteVpEniMci	n number eka parsarg pEnuMdi 
peVtteVkiMxanuMdi/peVtteVkiMxanuMci/peVtteVkimIxaniMci/*peVtteVkriMxanuMdi/peVtteVkriMxanuMci/peVtteVkriMxaniMci	n number eka parsarg kriMxanuMdi 
peVttadugunuMdi/peVttadugunuMci/*peVtteVkadugunuMdi/peVtteVkadugunuMci/peVtteVkaduguniMci	n number eka parsarg adugunuMdi 
*peVtteVmuMxunuMdi/peVtteVmuMxunuMci/peVtteVmuMxuniMci	n number eka parsarg muMxunuMdi 
peVtteVveVnukanuMdi/*peVtteVveVnakAlanuMdi/peVtteVveVnakAwalanuMdi/peVtteVveVnakanuMdi/peVtteVveVnukanuMci/peVtteVveVnakAlanuMci/peVtteVveVnakAwalanuMci/peVtteVveVnakanuMci	n number eka parsarg veVnukanuMdi 
peVtteVxutinuMdi/*peVtteVkeVxutinuMdi/peVtteVkeVxutinuMci/peVtteVxutinuMci	n number eka parsarg eVxutinuMdi 
*peVtteVmaXyanuMdi/peVtteVmaXyanuMci/peVtteVmaXyalonuMdi/peVtteVmaXyalonuMci	n number eka parsarg maXyanuMdi 
*peVtteVnadumanuMdi/peVtteVnadumanuMci	n number eka parsarg nadumanuMdi 
*peVtteVwaravAwanuMdi/peVtteVwarvAwanuMdi/peVtteVwaravAwanuMci/peVtteVwarvAwanuMci	n number eka parsarg waravAwanuMdi 
*peVtteVcotlonuMdi/peVtteVcotunuMdi/peVtteVcotlonuMci/peVtteVcotunuMci	n number eka parsarg cotlonuMdi 
peVtteVsWAnaMnuMdi/*peVtteVsWAnamunuMdi/peVtteVsWAnaMnuMci/peVtteVsWAnamunuMci/peVtteVsWAnaMlonuMdi/peVtteVsWAnamulonuMdi/peVtteVsWAnaMlonuMci/peVtteVswAnamulonuMci	n number eka parsarg sWAnaMnuMdi 
peVttaMxu/peVtteVnaMxu/*peVtteVyaMxu	n number eka parsarg aMxu 
peVttaMte/*peVttaMteV	n number eka parsarg aMte 
*peVtteVkaMteV/peVtteVkaMte/peVtteVkanna/peVtteVkannA	n number eka parsarg kaMteV 
*peVttEna	n number eka parsarg Ena 
*peVtteVpAti	n number eka parsarg pAti 
*peVtteVlAMti/peVtteVlAti	n number eka parsarg lAMti 
*peVtteVgAnI/peVttekAnI	n number eka parsarg gAni 
*peVtteVgA	n number eka parsarg gA 
*peVtteVlu	n number bahu parsarg 0  case d
*peVtteVlU/peVtteVlArA	n number bahu parsarg I  case d
-	n number bahu parsarg gA 
*peVtteVlagAdu	n number bahu parsarg gAdu  case d
*peVtteVlagawweV	n number bahu parsarg gawweV  case d
*peVtteVlavAdu/peVtteVlodu	n number bahu parsarg vAdu  case d
*peVtteVlAyana	n number bahu parsarg Ayana  case d
*peVtteVlavAru/peVtteVloru	n number bahu parsarg vAru  case d
*peVtteVlaxi/peVtteVlxi	n number bahu parsarg xi  case d
*peVtteVlavi/peVtteVliy	n number bahu parsarg vi  case d
*peVtteVlagAru	n number bahu parsarg gAru  case d
*peVtteVlaM/peVtteVlamu	n number bahu parsarg nu  case d
*peVtteVlu	n number bahu parsarg vu 
*peVtteVlayoVkka	n number bahu parsarg yoVkka 
*peVtteVla	n number bahu parsarg obl 
peVtteVlani/*peVtteVlni/peVtteVlanu/peVtteVlnu	n number bahu parsarg ni 
*peVtteVlaki/peVtteVlaku	n number bahu parsarg ki 
*peVtteVlawo/peVtteVlwo/peVtteVlawoda/peVtteVlawoti/peVtteVlwoti/peVtteVlwoda	n number bahu parsarg wo 
peVtteVlalo/*peVtteVllo/peVtteVlalona/peVtteVllona/peVtteVlalopala/peVtteVllopala	n number bahu parsarg lo 
peVtteVlaloni/peVtteVlayaMxali/*peVtteVlloni/peVtteVlalopali/peVtteVllopali	n number bahu parsarg loni 
*peVtteVlamIxa	n number bahu parsarg mIxa 
*peVtteVlana	n number bahu parsarg na 
peVtteVlaniMci/peVtteVlniMci/peVtteVlanuMci/peVtteVlnuMci/peVtteVlanuMdi/*peVtteVlnuMdi	n number bahu parsarg niMci 
*peVtteVlaxvArA/peVtteVlaxvAra	n number bahu parsarg xvArA 
*peVtteVlavalana/peVtteVlavalla	n number bahu parsarg valana 
*peVtteVlanubatti/peVtteVlanibatti/peVtteVlnibatti	n number bahu parsarg batti 
*peVtteVlacewa/peVtteVlcewa/peVtteVlace/peVtteVlce	n number bahu parsarg ce 
*peVtteVlawopAtu/peVtteVlwopAtu	n number bahu parsarg wopAtu 
*peVtteVlawokUdi/peVtteVlwokUdi/peVtteVlawokUda/peVtteVlawokUdA/peVtteVlwokUdA	n number bahu parsarg wokUdi 
*peVtteVlakosaM/peVtteVlakE/peVtteVlArWaM	n number bahu parsarg kosaM 
*peVtteVlakoVraku/peVtteVlakoVrYaku	n number bahu parsarg koVraku 
peVtteVlalonuMdi/peVtteVlalonuMci/*peVtteVllonuMdi/peVtteVllonuMci/peVtteVlloniMci/peVtteVlaloniMci	n number bahu parsarg lonuMdi 
*peVtteVlamIxanuMdi/peVtteVlamIxanuMci/peVtteVlamIxaniMci	n number bahu parsarg mIxanuMdi 
*peVtteVlaxAkA/peVtteVlaxAka	n number bahu parsarg xAkA 
*peVtteVlavaraku	n number bahu parsarg varaku 
*peVtteVlamIxaki/peVtteVlamIxaku/peVtteVlamIxiki	n number bahu parsarg mIxaki 
*peVtteVlaxaggara/peVtteVlaxaggira	n number bahu parsarg xaggara 
*peVtteVlavaxxa/peVtteVloVxxa	n number bahu parsarg vaxxa 
*peVtteVlakAda	n number bahu parsarg kAda 
peVtteVleVxurugA/*peVtteVlakeVxurugA	n number bahu parsarg keVxurugA 
*peVtteVlamuMxu	n number bahu parsarg muMxu 
*peVtteVlaguriMci/peVtteVlagUrci/peVtteVlanuguriMci/peVtteVlanigUrci	n number bahu parsarg guriMci 
peVtteVlapE/peVtteVlapEni/*peVtteVlapEna	n number bahu parsarg pE 
*peVtteVlapEki	n number bahu parsarg pEki 
*peVtteVlaguMdA	n number bahu parsarg guMdA 
peVtteVlalA/peVtteVllA/peVtteVlalAga/peVtteVllAga/*peVtteVllAgA	n number bahu parsarg lA 
*peVtteVlavale/peVtteVlavaleV/peVtteVlamAxiri/peVtteVlapoli/peVtteVlabolina	n number bahu parsarg vale 
peVtteVlakumalle/*peVtteVlakumalleV	n number bahu parsarg kimalle 
*peVtteVlukUdA/peVtteVlugUdA	n number bahu parsarg kUdA 
*peVtteVlaxqRtilo/peVtteVlaxruRtilo	n number bahu parsarg xqRtilo 
*peVtteVlulekuMdA/peVtteVllekuMdA/peVtteVluleka	n number bahu parsarg lekuMdA 
*peVtteVlukAkuMdA/peVtteVlukAkuMda/peVtteVlukAka/peVtteVlugAka	n number bahu parsarg kAkuMdA 
*peVtteVlumoVxalukoVni/peVtteVlanumoVxalukoVni	n number bahu parsarg moVxalukoVni 
*peVtteVlavEpu/peVtteVlavepu/peVtteVlakesi	n number bahu parsarg vEpu 
peVtteVlapakka/peVtteVlapakkana/peVtteVlaprakka/*peVtteVlaprakkana	n number bahu parsarg pakka 
peVtteVlapakkalo/*peVtteVlaprakkalo	n number bahu parsarg pakkalo 
*peVtteVlaloki/peVtteVlaloniki/peVtteVlalopalaki/peVtteVlalopaliki/peVtteVllopaliki/peVtteVllopalaku	n number bahu parsarg lopalaki 
peVtteVlakiMxa/*peVtteVlakriMxa/peVtteVlakriMxane/peVtteVlakiMxane	n number bahu parsarg kiMxa 
peVtteVladuguna/*peVtteVlakaduguna	n number bahu parsarg aduguna 
*peVtteVlakeVlla/peVtteVlakalla	n number bahu parsarg kalla 
peVtteVlaveVnuka/peVtteVlaveVnaka/*peVtteVlaveVnakAla/peVtteVlaveVnukAla/peVtteVlaveVnakAwala/peVtteVlaveVnukAwala	n number bahu parsarg veVnuka 
*peVtteVlawaravAwa/peVtteVlawarvAwa/peVtteVlwaravAwa	n number bahu parsarg waravAwa 
peVtteVleVxuruguMdA/*peVtteVlakeVxuruguMdA	n number bahu parsarg eVxuruguMdA 
*peVtteVlamaXya/peVtteVlamaXyana/peVtteVlamaXyalo	n number bahu parsarg maXya 
*peVtteVlanaduma/peVtteVlakinaduma	n number bahu parsarg naduma 
peVtteVlabaxulugA/peVtteVlakibaxulugA/peVtteVlabaxulu/*peVtteVlakibaxulu	n number bahu parsarg baxulugA 
*peVtteVlacotlo/peVtteVlacotulo	n number bahu parsarg cotlo 
peVtteVlasWAnaMlo/peVtteVlaswAnaMlo/*peVtteVlasWAnamulo	n number bahu parsarg sWAnaMlo 
peVtteVlanerugA/peVtteVlakunerugA/*peVtteVlakinerugA	n number bahu parsarg nerugA 
*peVtteVlaprakAraM/peVtteVlanubatti/peVtteVlabatti/peVtteVlanibatti	n number bahu parsarg prakAraM 
*peVtteVlaxaggaranuMdi/peVtteVlaxaggiranuMdi/peVtteVlaxaggaranuMci/peVtteVlaxaggiranuMci	n number bahu parsarg xaggaranuMdi 
*peVtteVlavaxxanuMdi/peVtteVlavaxxanuMci	n number bahu parsarg vaxxanuMdi 
*peVtteVlapakkanuMdi/peVtteVlapakkanuMci/peVtteVlapakkalonuMdi/peVtteVlapakkalonuMci	n number bahu parsarg pakkanuMdi 
*peVtteVlalopalanuMdi/peVtteVllopalanuMdi/peVtteVlalopalanuMci/peVtteVllopalanuMci/peVtteVllopalinuMdi/peVtteVlalopalinuMci	n number bahu parsarg lopalanuMdi 
*peVtteVlabEtanuMdi/peVtteVlabEtanuMci/peVtteVlabEtaniMci	n number bahu parsarg bEtanuMdi 
*peVtteVlapEnuMdi/peVtteVlapEnuMci/peVtteVlapEniMci	n number bahu parsarg pEnuMdi 
peVtteVlakiMxanuMdi/peVtteVlakiMxanuMci/peVtteVlakiMxaniMci/*peVtteVlakriMxanuMdi/peVtteVlakriMxanuMci/peVtteVlakriMxaniMci	n number bahu parsarg kriMxanuMdi 
*peVtteVladugunuMdi/peVtteVladugunuMci/peVtteVladuguniMci	n number bahu parsarg adugunuMdi 
*peVtteVlamuMxunuMdi/peVtteVlamuMxunuMci/peVtteVlamuMxuniMci	n number bahu parsarg muMxunuMdi 
peVtteVlaveVnukanuMdi/peVtteVlaveVnakanuMdi/*peVtteVlaveVnakAlanuMdi/peVtteVlaveVnakAlanuMci/peVtteVlaveVnukanuMci/peVtteVlaveVnakanuMci/peVtteVlaveVnakAwalanuMdi/peVtteVlaveVnakAwalanuMci	n number bahu parsarg veVnukanuMdi 
peVtteVleVxutinuMdi/*peVtteVlakeVxutinuMdi/peVtteVleVxutinuMci/peVtteVlakeVxutinuMci	n number bahu parsarg eVxutinuMdi 
*peVtteVlamaXyanuMdi/peVtteVlamaXyanuMci/peVtteVlamaXyaniMci/peVtteVlamaXyalonuMdi/peVtteVlamaXyalonuMci/peVtteVlamaXyaloniMci	n number bahu parsarg maXyanuMdi 
*peVtteVlanadumanuMdi/peVtteVlanadamanuMdi/peVtteVlanadumanuMci/peVtteVlanadamanuMci	n number bahu parsarg nadumanuMdi 
*peVtteVlawaravAwanuMdi/peVtteVlawarvAwanuMdi/peVtteVlawaravAwanuMci/peVtteVlawarvAwanuMci	n number bahu parsarg waravAwanuMdi 
peVtteVlacotunuMci/peVtteVlacotunuMdi/peVtteVlacotlonuMci/*peVtteVlacotlonuMdi/peVtteVlacotulonuMdi/peVtteVlacotulonuMci	n number bahu parsarg cotlonuMdi 
*peVtteVlasWAnamunuMdi/peVtteVlasWAnaMnuMdi/peVtteVlasWAnamunuMci/peVtteVlasWAnaMnuMci/peVtteVlasWAnaMlonuMdi/peVtteVlasWAnamulonuMdi/peVtteVlasWAnaMlonuMci/peVtteVlasWAnamulonuMci/peVtteVlasWAnaMloniMci/peVtteVlasWAnamuloniMci	n number bahu parsarg sWAnaMnuMdi 
*peVtteVlayaMxu/peVtteVlaMxu	n number bahu parsarg aMxu 
peVtteVlaMte/*peVtteVlaMteV	n number bahu parsarg aMte 
*peVtteVlakaMteV/peVtteVlakaMte/peVtteVlakanna/peVtteVlakannA	n number bahu parsarg kaMteV 
*peVtteVlEna	n number bahu parsarg Ena 
*peVtteVlapAti	n number bahu parsarg pAti 
*peVtteVlalAMti/peVtteVlalAti	n number bahu parsarg lAMti 
*peVtteVlugAnI/peVtteVlukAnI	n number bahu parsarg gAni 
*peVtteVlugA	n number bahu parsarg gA 
