noun	
paMxeVM	
*paMxeVM/paMxeVmu	n number eka parsarg 0 
-	n number eka parsarg I 
-	n number eka parsarg gA 
*paMxeVMgAdu/paMxeVgAdu	n number eka parsarg gAdu 
*paMxeVMgawweV/paMxeVgawweV	n number eka parsarg gawweV 
*paMxeVMvAdu	n number eka parsarg vAdu 
*paMxeVmAyana	n number eka parsarg Ayana 
*paMxeVMvAru	n number eka parsarg vAru 
*paMxeVMxi/paMxAnixi/paMxenixi	n number eka parsarg xi 
*paMxeVMvi/paMxAnivi/paMxenivi	n number eka parsarg vi 
*paMxeVMgAru	n number eka parsarg gAru 
*paMxeVMnu/paMxAnni/paMxenni/paMxeVmunu	n number eka parsarg nu 
*paMxeVMvu/paMxAnivi/paMxeVmuvu	n number eka parsarg vu 
*paMxeVMyoVkka	n number eka parsarg yoVkka 
*paMxeVM/paMxAni/paMxeVpu	n number eka parsarg obl 
*paMxAnni/paMxenni/paMxeVMnu/paMxeVmunu	n number eka parsarg ni 
*paMxAniki/paMxeniki/paMxeVMku/paMxeVmunaku	n number eka parsarg ki 
paMxAniwo/*paMxeVMwo/paMxAniwoti/paMxeVMwoti	n number eka parsarg wo 
paMxeVMlo/paMxeVMlona/*paMxeVMlopala	n number eka parsarg lo 
paMxeVMloni/*paMxeVMlopali/paMxeVmaMxali	n number eka parsarg loni 
*paMxeVMmIxa/paMxeVmmIxa	n number eka parsarg mIxa 
paMxAna/*paMxeVmuna	n number eka parsarg na 
paMxeVMniMci/paMxeVMnuMci/*paMxeVMnuMdi	n number eka parsarg niMci 
*paMxeVMxvArA/paMxeVMxvAra	n number eka parsarg xvArA 
*paMxeVMvalana/paMxeVMvalla/paMxeVmuvalana/paMxeVmuvalla	n number eka parsarg valana 
paMxeVMnubatti/paMxAnnibatti/*paMxeVmunubatti	n number eka parsarg batti 
paMxeVMce/*paMxeVMcewa	n number eka parsarg ce 
*paMxeVMwopAtu/paMxeVmuwopAtu/paMxeVMwobAtu/paMxeVmuwobAtu	n number eka parsarg wopAtu 
*paMxeVMwokUdi/paMxeVMwokUda/paMxeVMwokUdA/paMxeVMwogUdi/paMxeVMwogUda/paMxeVMwogUdA	n number eka parsarg wokUdi 
*paMxeVMkosaM/paMxeVMkE/paMxAnikE/paMxAnikosaM/paMxeVmArWaM	n number eka parsarg kosaM 
*paMxeVMkoVraku/paMxeVMkoVrYaku/paMxeVnikoVraku	n number eka parsarg koVraku 
*paMxeVMlonuMdi/paMxeVMlonuMci/paMxeVMloniMci	n number eka parsarg lonuMdi 
*paMxeVMmIxanuMdi/paMxeVMmIxanuMci/paMxeVMmIxaniMci/paMxeVmmIxanuMdi/paMxeVmmIxanuMci/paMxeVmmIxaniMci	n number eka parsarg mIxanuMdi 
*paMxeVMxAkA/paMxeVMxAka	n number eka parsarg xAkA 
*paMxeVMvaraku	n number eka parsarg varaku 
*paMxeVMmIxaki/paMxeVMmIxaku/paMxeVMmIxiki/paMxeVmmIxaki/paMxeVmmIxaku/paMxeVmmIxiki	n number eka parsarg mIxaki 
*paMxeVMxaggara/paMxeVMxaggira	n number eka parsarg xaggara 
*paMxeVMvaxxa/paMxeVmoVxxa	n number eka parsarg vaxxa 
*paMxeVMkAda	n number eka parsarg kAda 
*paMxeVMkeVxurugA/paMxeVmeVxurugA/paMxAnikeVxurugA	n number eka parsarg keVxurugA 
*paMxeVMmuMxu/paMxeVmmuMxu	n number eka parsarg muMxu 
*paMxeVMguriMci/paMxAnniguriMci/paMxAnnigUrci	n number eka parsarg guriMci 
paMxeVMpE/*paMxeVMpEna/paMxeVMpEni	n number eka parsarg pE 
*paMxeVMpEki	n number eka parsarg pEki 
*paMxeVMguMdA	n number eka parsarg guMdA 
paMxeVMlA/paMxeVMlAga/*paMxeVMlAgA	n number eka parsarg lA 
*paMxeVMvaleV/paMxeVMvale/paMxeVMmAxiri/paMxAnnipolina/paMxAnnibolina/paMxeVmmAxiri	n number eka parsarg vale 
paMxAnikimalle/*paMxAnikimalleV	n number eka parsarg kimalle 
*paMxeVMkUdA/paMxAnnikUdA/paMxeVmunukUdA	n number eka parsarg kUdA 
*paMxeVMxqRtilo/paMxeVMxruRtilo/paMxeVmuxqRtilo	n number eka parsarg xqRtilo 
*paMxeVMlekuMdA/paMxAnnilekuMdA/paMxeVMlekuMda/paMxeVmunulekuMdA/paMxeVMleka	n number eka parsarg lekuMdA 
*paMxeVMkAkuMdA/paMxAnnikAkuMdA/paMxeVmukAkuMda/paMxeVmunukAkuMdA/paMxeVMkAka	n number eka parsarg kAkuMdA 
*paMxeVMmoVxalukoVni/paMxAnnimoVxalukoVni/paMxeVmunumoVxalukoVni/paMxeVmmoVxalukoVni	n number eka parsarg moVxalukoVni 
*paMxeVMvEpu/paMxeVMvepu/paMxeVMkesi	n number eka parsarg vEpu 
paMxeVMpakka/paMxeVMprakka/paMxeVMpakkana/*paMxeVMprakkana/paMxeVMpakkani	n number eka parsarg pakka 
paMxeVMpakkalo/*paMxeVMprakkalo/paMxeVMpakkalona/paMxeVMpakkaloni	n number eka parsarg pakkalo 
paMxeVMloki/paMxeVMloniki/*paMxeVMlopala/paMxeVMlopalaki/paMxeVMlopalaku/paMxeVMlopali/paMxeVMlopaliki	n number eka parsarg lopalaki 
paMxeVMkiMxa/*paMxeVMkriMxa/paMxeVMkriMxana/paMxeVMkiMxana	n number eka parsarg kiMxa 
paMxeVmaduguna/*paMxAnikaduguna	n number eka parsarg aduguna 
paMxeVMkeVlla/*paMxeVMkalla	n number eka parsarg kalla 
paMxeVMveVnuka/*paMxeVMveVnakAla/paMxeVMveVnakAwala/paMxeVMveVnakana	n number eka parsarg veVnuka 
paMxeVMwaravAwa/paMxeVMwarvAwa/*paMxeVMwaruvAwa/paMxeVMwaravAwana/paMxeVMwarvAwana/paMxeVMwaruvAwana	n number eka parsarg waravAwa 
paMxeVmeVxuruguMdA/*paMxAnikeVxuruguMdA/paMxeVMkeVxuruguMdA	n number eka parsarg eVxuruguMdA 
paMxeVMmaXya/*paMxeVMmaXyalo/paMxeVMmaXyana/paMxeVmmaXya/paMxeVmmaXyalo/paMxeVmmaXyana	n number eka parsarg maXya 
*paMxeVMnaduma/paMxAnikinadumana	n number eka parsarg naduma 
paMxeVMbaxulugA/paMxeVMbaxulu/paMxAnikibaxulu/*paMxeVmunakubaxulu	n number eka parsarg baxulugA 
*paMxeVMcotlo/paMxeVMcotulo/paMxeVMcotuna/paMxeVMcota	n number eka parsarg cotlo 
*paMxeVMsWAnaMlo/paMxeVMswAnaMlo	n number eka parsarg sWAnaMlo 
paMxeVMnerugA/paMxeVmunakunerugA/*paMxAnikinerugA	n number eka parsarg nerugA 
*paMxeVMprakAraM/paMxAniprakAramu/paMxeVmuprakAramu	n number eka parsarg prakAraM 
*paMxeVMxaggaranuMdi/paMxeVMxaggaranuMci/paMxeVMxaggiranuMdi/paMxeVMxaggiranuMci	n number eka parsarg xaggaranuMdi 
*paMxeVMvaxxanuMdi/paMxeVMvaxxanuMci/paMxeVMvaxxaniMci	n number eka parsarg vaxxanuMdi 
*paMxeVMpakkanuMdi/paMxeVMpakkanuMci/paMxeVMpakkaniMci/paMxeVMpakkalonuMdi/paMxeVMpakkalonuMci/paMxeVMpakkaloniMci	n number eka parsarg pakkanuMdi 
*paMxeVMlopalanuMdi/paMxeVMlopalanuMci/paMxeVMlopalaniMci	n number eka parsarg lopalanuMdi 
*paMxeVMbEtanuMdi/paMxeVMbEtanuMci/paMxeVMbEtaniMci	n number eka parsarg bEtanuMdi 
*paMxeVMpEnuMdi/paMxeVMpEnuMci/paMxeVMpEniMci	n number eka parsarg pEnuMdi 
paMxeVMkiMxanuMdi/paMxeVMkiMxanuMci/paMxAnikiMxaniMci/*paMxeVMkriMxanuMdi/paMxeVMkriMxanuMci/paMxeVMkriMxaniMci	n number eka parsarg kriMxanuMdi 
paMxeVmadugunuMdi/paMxeVmadugunuMci/*paMxAnikadugunuMdi/paMxAnikadugunuMci/paMxAnikaduguniMci	n number eka parsarg adugunuMdi 
*paMxeVMmuMxunuMdi/paMxeVMmuMxunuMci/paMxeVMmuMxuniMci/paMxeVmmuMxunuMdi/paMxeVmmuMxunuMci/paMxeVmmuMxuniMci	n number eka parsarg muMxunuMdi 
paMxeVMveVnukanuMdi/*paMxeVMveVnakAlanuMdi/paMxeVMveVnakAwalanuMdi/paMxeVMveVnakanuMdi/paMxeVMveVnukanuMci/paMxeVMveVnakAlanuMci/paMxeVMveVnakAwalanuMci/paMxeVMveVnakanuMci	n number eka parsarg veVnukanuMdi 
paMxeVmeVxutinuMdi/*paMxAnikeVxutinuMdi/paMxAnikeVxutinuMci/paMxeVMeVxutinuMci/paMxeVmeVxutanuMdi/paMxAnikeVxutanuMdi/paMxAnikeVxutanuMci/paMxeVMeVxutanuMci	n number eka parsarg eVxutinuMdi 
*paMxeVMmaXyanuMdi/paMxeVMmaXyanuMci/paMxeVmmaXyanuMdi/paMxeVmmaXyanuMci/paMxeVMmaXyalonuMdi/paMxeVMmaXyalonuMci/paMxeVmmaXyalonuMdi/paMxeVmmaXyalonuMci	n number eka parsarg maXyanuMdi 
*paMxeVMnadumanuMdi/paMxeVMnadumanuMci	n number eka parsarg nadumanuMdi 
*paMxeVMwaravAwanuMdi/paMxeVMwarvAwanuMdi/paMxeVMwaravAwanuMci/paMxeVMwarvAwanuMci	n number eka parsarg waravAwanuMdi 
*paMxeVMcotlonuMdi/paMxeVMcotunuMdi/paMxeVMcotlonuMci/paMxeVMcotunuMci	n number eka parsarg cotlonuMdi 
paMxeVMsWAnaMnuMdi/*paMxeVMsWAnamunuMdi/paMxeVMsWAnaMnuMci/paMxeVMsWAnamunuMci/paMxeVMsWAnaMlonuMdi/paMxeVMsWAnamulonuMdi/paMxeVMsWAnaMlonuMci/paMxeVMswAnamulonuMci	n number eka parsarg sWAnaMnuMdi 
paMxeVmaMxu/*paMxeVmunaMxu/paMxeVmaMxu	n number eka parsarg aMxu 
*paMxeVmaMte/paMxeVMaMteV/paMxAnnaMte	n number eka parsarg aMte 
*paMxeVMkaMteV/paMxAnikaMte/paMxAnikanna/paMxAnikannA/paMxeVMkannA	n number eka parsarg kaMteV 
*paMxeVMEna	n number eka parsarg Ena 
*paMxeVMpAti	n number eka parsarg pAti 
*paMxeVMlAMti/paMxeVMlAti	n number eka parsarg lAMti 
*paMxeVMgAnI/paMxeVMkAnI	n number eka parsarg gAni 
*paMxeVMgA	n number eka parsarg gA 
*paMxAlu/paMxeVmulu/paMxelu	n number bahu parsarg 0 
*paMxAlU/paMxeVmulU/paMxeVmulArA/paMxAllArA	n number bahu parsarg I 
-	n number bahu parsarg gA 
*paMxAlagAdu/paMxeVmulagAdu/paMxelagAdu	n number bahu parsarg gAdu 
*paMxAlagawweV/paMxeVmulagawweV/paMxelagawweV	n number bahu parsarg gawweV 
*paMxAlavAdu/paMxAlodu/paMxeVmulavAdu	n number bahu parsarg vAdu 
*paMxAlAyana/paMxeVmulAyana/paMxelAyana	n number bahu parsarg Ayana 
*paMxAlavAru/paMxAloru/paMxeVmulavAru	n number bahu parsarg vAru 
*paMxAlaxi/paMxAlxi/paMxeVmulaxi	n number bahu parsarg xi 
*paMxAlavi/paMxAlay/paMxeVmulavi	n number bahu parsarg vi 
*paMxAlagAru/paMxeVmulagAru/paMxelagAru	n number bahu parsarg gAru 
paMxAlamu/*paMxAlaM/paMxeVmulamu/paMxelaM	n number bahu parsarg nu 
*paMxAlu/paMxeVmulu/paMxelu	n number bahu parsarg vu 
*paMxeVmulayoVkka/paMxAlayoVkka/paMxelayoVkka	n number bahu parsarg yoVkka 
*paMxAla/paMxeVmula/paMxela	n number bahu parsarg obl 
*paMxAlani/paMxAlni/paMxAlanu/paMxAlnu/paMxeVmulanu/paMxeVmulni/paMxelni	n number bahu parsarg ni 
*paMxAlaki/paMxAlaku/paMxeVmulaku	n number bahu parsarg ki 
*paMxAlawo/paMxAlwo/paMxeVmulawo/paMxAlawoti/paMxAlwoti/paMxeVmulawoda	n number bahu parsarg wo 
paMxAlalo/paMxAllo/paMxAlalona/paMxAllona/*paMxAlalopala/paMxAllopala	n number bahu parsarg lo 
*paMxAlaloni/paMxAlayaMxali/paMxAlloni/paMxAlalopali/paMxAllopali	n number bahu parsarg loni 
*paMxAlamIxa/paMxeVmulamIxa	n number bahu parsarg mIxa 
paMxAlana/*paMxeVmulana	n number bahu parsarg na 
paMxAlaniMci/paMxAlniMci/paMxAlanuMci/paMxAlnuMci/*paMxAlanuMdi/paMxAlnuMdi	n number bahu parsarg niMci 
*paMxAlaxvArA/paMxAlaxvAra/paMxeVmulaxvArA	n number bahu parsarg xvArA 
*paMxAlavalana/paMxAlavalla	n number bahu parsarg valana 
*paMxAlanubatti/paMxelanubatti/paMxAlnibatti	n number bahu parsarg batti 
*paMxAlacewa/paMxAlcewa/paMxAlace/paMxAlce/paMxeVmulace/paMxeVmulacewa	n number bahu parsarg ce 
*paMxAlawopAtu/paMxAlwopAtu/paMxeVmulawopAtu/paMxAlawobAtu/paMxAlwobAtu/paMxeVmulawobAtu	n number bahu parsarg wopAtu 
*paMxAlawokUdi/paMxAlwokUdi/paMxAlawokUda/paMxAlawokUdA/paMxAlwokUdA/paMxeVmulawokUda/paMxAlawogUdi/paMxAlwogUdi/paMxAlawogUda/paMxAlawogUdA/paMxAlwogUdA/paMxeVmulawogUda	n number bahu parsarg wokUdi 
*paMxAlakosaM/paMxAlakE/paMxeVmulakosamu/paMxeVmulakE/paMxAlArWaM	n number bahu parsarg kosaM 
*paMxAlakoVraku/paMxAlakoVrYaku/paMxeVmulakoVraku	n number bahu parsarg koVraku 
*paMxAlalonuMdi/paMxAlalonuMci/paMxAllonuMdi/paMxAllonuMci/paMxAlloniMci/paMxAlaloniMci/paMxeVmulanuMdi	n number bahu parsarg lonuMdi 
*paMxAlamIxanuMdi/paMxAlamIxanuMci/paMxAlamIxaniMci/paMxeVmulamIxanuMdi	n number bahu parsarg mIxanuMdi 
*paMxAlaxAkA/paMxAlaxAka/paMxeVmulaxAka	n number bahu parsarg xAkA 
*paMxAlavaraku/paMxeVmulavaraku	n number bahu parsarg varaku 
*paMxAlamIxaki/paMxAlamIxaku/paMxAlamIxiki	n number bahu parsarg mIxaki 
*paMxAlaxaggara/paMxAlaxaggira	n number bahu parsarg xaggara 
*paMxAlavaxxa/paMxAloVxxa	n number bahu parsarg vaxxa 
*paMxAlakAda/paMxeVmulakAda/paMxelakAda	n number bahu parsarg kAda 
paMxAleVxurugA/*paMxAlakeVxurugA	n number bahu parsarg keVxurugA 
*paMxAlamuMxu/paMxeVmulamuMxu	n number bahu parsarg muMxu 
*paMxAlaguriMci/paMxAlagUrci/paMxAlanuguriMci/paMxAlanigUrci	n number bahu parsarg guriMci 
paMxAlapE/paMxAlapEni/*paMxAlapEna	n number bahu parsarg pE 
*paMxAlapEki/paMxeVmulapEki/paMxelapEki	n number bahu parsarg pEki 
*paMxAlaguMdA/paMxeVmulaguMdA	n number bahu parsarg guMdA 
paMxAlalA/paMxAllA/paMxAlalAga/paMxAllAga/*paMxAllAgA	n number bahu parsarg lA 
paMxAlavale/*paMxAlavaleV/paMxAlamAxiri/paMxAlapoli/paMxAlabolina	n number bahu parsarg vale 
*paMxAlakumalleV/paMxeVmulakumalle/paMxelakumalle/paMxAlakumalle/paMxeVmulakumalleV/paMxelakumalleV	n number bahu parsarg kimalle 
*paMxAlukUdA/paMxAlugUdA/paMxelukUdA/paMxelugUdA	n number bahu parsarg kUdA 
*paMxAlaxqRtilo/paMxAlaxruRtilo	n number bahu parsarg xqRtilo 
*paMxAlulekuMdA/paMxAllekuMdA/paMxAluleka/paMxelulekuMdA/paMxeluleka	n number bahu parsarg lekuMdA 
*paMxAlukAkuMdA/paMxAlukAkuMda/paMxAlukAka/paMxAlugAkuMdA/paMxAlugAkuMda/paMxAlugAka/paMxelukAkuMdA/paMxelukAkuMda/paMxelukAka/paMxelugAkuMdA/paMxelugAkuMda/paMxelugAka	n number bahu parsarg kAkuMdA 
*paMxAlumoVxalukoVni/paMxAlanumoVxalukoVni/paMxelumoVxalukoVni	n number bahu parsarg moVxalukoVni 
*paMxAlavEpu/paMxAlavepu/paMxAlakesi	n number bahu parsarg vEpu 
paMxAlapakka/paMxAlapakkana/paMxAlaprakka/*paMxAlaprakkana	n number bahu parsarg pakka 
paMxAlapakkalo/*paMxAlaprakkalo	n number bahu parsarg pakkalo 
paMxAlaloki/paMxAlaloniki/paMxAlloki/paMxAlloniki/*paMxAlalopalaki/paMxAlalopaliki/paMxAllopaliki/paMxAllopalaku	n number bahu parsarg lopalaki 
paMxAlakiMxa/*paMxAlakriMxa/paMxAlakriMxana/paMxAlakiMxana	n number bahu parsarg kiMxa 
paMxAladuguna/*paMxAlakaduguna	n number bahu parsarg aduguna 
paMxAlakeVlla/*paMxAlakalla	n number bahu parsarg kalla 
paMxAlaveVnuka/paMxAlaveVnaka/*paMxAlaveVnakAla/paMxAlaveVnukAla/paMxAlaveVnakAwala/paMxAlaveVnukAwala	n number bahu parsarg veVnuka 
*paMxAlawaravAwa/paMxAlawarvAwa/paMxAlwaravAwa	n number bahu parsarg waravAwa 
paMxAleVxuruguMdA/*paMxAlakeVxuruguMdA	n number bahu parsarg eVxuruguMdA 
*paMxAlamaXya/paMxAlamaXyana/paMxAlamaXyalo	n number bahu parsarg maXya 
*paMxAlanaduma/paMxAlakinaduma	n number bahu parsarg naduma 
paMxAlabaxulugA/paMxAlakibaxulugA/paMxAlabaxulu/*paMxAlakibaxulu	n number bahu parsarg baxulugA 
*paMxAlacotlo/paMxAlacotulo	n number bahu parsarg cotlo 
paMxAlasWAnaMlo/paMxAlaswAnaMlo/*paMxAlasWAnamulo	n number bahu parsarg sWAnaMlo 
paMxAlanerugA/paMxAlakunerugA/*paMxAlakinerugA	n number bahu parsarg nerugA 
*paMxAlaprakAraM/paMxAlanubatti/paMxAlabatti/paMxAlanibatti	n number bahu parsarg prakAraM 
*paMxAlaxaggaranuMdi/paMxAlaxaggiranuMdi/paMxAlaxaggaranuMci/paMxAlaxaggiranuMci	n number bahu parsarg xaggaranuMdi 
*paMxAlavaxxanuMdi/paMxAlavaxxanuMci	n number bahu parsarg vaxxanuMdi 
*paMxAlapakkanuMdi/paMxAlapakkanuMci/paMxAlapakkalonuMdi/paMxAlapakkalonuMci	n number bahu parsarg pakkanuMdi 
*paMxAlalopalanuMdi/paMxAllopalanuMdi/paMxAlalopalanuMci/paMxAllopalanuMci/paMxAllopalinuMdi/paMxAlalopalinuMci	n number bahu parsarg lopalanuMdi 
*paMxAlabEtanuMdi/paMxAlabEtanuMci/paMxAlabEtaniMci	n number bahu parsarg bEtanuMdi 
*paMxAlapEnuMdi/paMxAlapEnuMci/paMxAlapEniMci	n number bahu parsarg pEnuMdi 
paMxAlakiMxanuMdi/paMxAlakiMxanuMci/paMxAlakiMxaniMci/*paMxAlakriMxanuMdi/paMxAlakriMxanuMci/paMxAlakriMxaniMci	n number bahu parsarg kriMxanuMdi 
*paMxAladugunuMdi/paMxAladugunuMci/paMxAladuguniMci	n number bahu parsarg adugunuMdi 
*paMxAlamuMxunuMdi/paMxAlamuMxunuMci/paMxAlamuMxuniMci	n number bahu parsarg muMxunuMdi 
paMxAlaveVnukanuMdi/paMxAlaveVnakanuMdi/*paMxAlaveVnakAlanuMdi/paMxAlaveVnakAlanuMci/paMxAlaveVnukanuMci/paMxAlaveVnakanuMci/paMxAlaveVnakAwalanuMdi/paMxAlaveVnakAwalanuMci	n number bahu parsarg veVnukanuMdi 
paMxAleVxutinuMdi/paMxAlakeVxutinuMdi/paMxAleVxutanuMdi/*paMxAlakeVxutanuMdi/paMxAleVxutinuMci/paMxAlakeVxutinuMci/paMxAleVxutanuMci/paMxAlakeVxutanuMci	n number bahu parsarg eVxutinuMdi 
*paMxAlamaXyanuMdi/paMxAlamaXyanuMci/paMxAlamaXyaniMci/paMxAlamaXyalonuMdi/paMxAlamaXyalonuMci/paMxAlamaXyaloniMci	n number bahu parsarg maXyanuMdi 
*paMxAlanadumanuMdi/paMxAlanadamanuMdi/paMxAlanadumanuMci/paMxAlanadamanuMci	n number bahu parsarg nadumanuMdi 
*paMxAlawaravAwanuMdi/paMxAlawarvAwanuMdi/paMxAlawaravAwanuMci/paMxAlawarvAwanuMci	n number bahu parsarg waravAwanuMdi 
paMxAlacotunuMci/paMxAlacotunuMdi/paMxAlacotlonuMci/*paMxAlacotlonuMdi/paMxAlacotulonuMci/paMxAlacotulonuMdi	n number bahu parsarg cotlonuMdi 
*paMxAlasWAnamunuMdi/paMxAlasWAnaMnuMdi/paMxAlasWAnamunuMci/paMxAlasWAnaMnuMci/paMxAlasWAnaMlonuMdi/paMxAlasWAnamulonuMdi/paMxAlasWAnaMlonuMci/paMxAlasWAnamulonuMci	n number bahu parsarg sWAnaMnuMdi 
*paMxAlayaMxu/paMxAlaMxu	n number bahu parsarg aMxu 
*paMxAlaMte/paMxAlaMteV	n number bahu parsarg aMte 
*paMxAlakaMteV/paMxAlakaMte/paMxAlakannA/paMxAlakanna	n number bahu parsarg kaMteV 
*paMxAlEna	n number bahu parsarg Ena 
*paMxAlapAti	n number bahu parsarg pAti 
*paMxAlalAMti/paMxAlalAti	n number bahu parsarg lAMti 
*paMxAlugAnI/paMxAlukAnI	n number bahu parsarg gAni 
*paMxAlugA	n number bahu parsarg gA 
