noun	
piMdi	
*piMdi	n number eka parsarg 0  case d
-	n number eka parsarg I 
-	n number eka parsarg gA 
*piMdigAdu	n number eka parsarg gAdu  case d
*piMdigawweV	n number eka parsarg gawweV  case d
*piMdivAdu	n number eka parsarg vAdu  case d
*piMdAyana	n number eka parsarg Ayana  case d
*piMdivAru	n number eka parsarg vAru  case d
*piMdixi	n number eka parsarg xi  case d
*piMdivi/piMdiy	n number eka parsarg vi  case d
*piMdigAru	n number eka parsarg gAru  case d
*piMdini	n number eka parsarg nu 
*piMdivi	n number eka parsarg vu  case d
*piMdiyoVkka	n number eka parsarg yoVkka 
*piMdi	n number eka parsarg obl 
*piMdini/piMdinu	n number eka parsarg ni 
*piMdiki/piMdiku	n number eka parsarg ki 
*piMdiwo/piMdiwoda/piMdiwoti	n number eka parsarg wo 
*piMdilo/piMdilona/piMdilopala	n number eka parsarg lo 
piMdiloni/*piMdilopali/piMdiyaMxali	n number eka parsarg loni 
*piMdimIxa	n number eka parsarg mIxa 
*piMdina	n number eka parsarg na 
piMdiniMci/piMdinuMci/*piMdinuMdi	n number eka parsarg niMci 
*piMdixvArA/piMdixvAra	n number eka parsarg xvArA 
*piMdivalana/piMdivalla	n number eka parsarg valana 
*piMdinibatti	n number eka parsarg batti 
piMdice/*piMdicewa	n number eka parsarg ce 
*piMdiwopAtu	n number eka parsarg wopAtu 
*piMdiwokUdi/piMdiwokUda/piMdiwokUdA	n number eka parsarg wokUdi 
*piMdikosaM/piMdikE/piMdArWaM	n number eka parsarg kosaM 
*piMdikoVraku/piMdikoVrYaku	n number eka parsarg koVraku 
*piMdilonuMdi/piMdilonuMci/piMdiloniMci	n number eka parsarg lonuMdi 
*piMdimIxanuMdi/piMdimIxanuMci/piMdimIxaniMci	n number eka parsarg mIxanuMdi 
*piMdixAkA/piMdixAka	n number eka parsarg xAkA 
*piMdivaraku	n number eka parsarg varaku 
*piMdimIxaki/piMdimIxaku/piMdimIxiki	n number eka parsarg mIxaki 
*piMdixaggara/piMdixaggira	n number eka parsarg xaggara 
*piMdivaxxa/piMdoVxxa	n number eka parsarg vaxxa 
*piMdikAda	n number eka parsarg kAda 
*piMdikeVxurugA/piMdeVxurugA	n number eka parsarg keVxurugA 
*piMdimuMxu	n number eka parsarg muMxu 
*piMdiguriMci/piMdiniguriMci/piMdinigUrci	n number eka parsarg guriMci 
piMdipE/*piMdipEna/piMdipEni	n number eka parsarg pE 
*piMdipEki	n number eka parsarg pEki 
*piMdiguMdA	n number eka parsarg guMdA 
piMdilA/piMdilAga/*piMdilAgA	n number eka parsarg lA 
*piMdivale/piMdimAxiri/piMdinipolina/piMdinibolina	n number eka parsarg vale 
piMdikimalle/*piMdikimalleV	n number eka parsarg kimalle 
*piMdikUdA/piMdinikUdA/piMdinigUdA/piMdigUdA	n number eka parsarg kUdA 
*piMdixqRtilo/piMdixruRtilo	n number eka parsarg xqRtilo 
*piMdilekuMdA/piMdinulekuMdA/piMdileka/piMdinilekuMdA	n number eka parsarg lekuMdA 
*piMdikAkuMdA/piMdinukAkuMdA/piMdikAka/piMdinikAkuMdA	n number eka parsarg kAkuMdA 
*piMdimoVxalukoVni/piMdinimoVxalukoVni/piMdinumoVxalukoVni	n number eka parsarg moVxalukoVni 
*piMdivEpu/piMdivepu/piMdikesi	n number eka parsarg vEpu 
piMdipakka/piMdiprakka/piMdipakkana/*piMdiprakkana/piMdipakkani	n number eka parsarg pakka 
piMdipakkalo/*piMdiprakkalo/piMdipakkalona/piMdipakkaloni	n number eka parsarg pakkalo 
*piMdiloki/piMdiloniki/piMdilopalaki/piMdilopalaku/piMdilopaliki	n number eka parsarg lopalaki 
piMdikiMxa/*piMdikriMxa/piMdikriMxana/piMdikiMxana	n number eka parsarg kiMxa 
piMdaduguna/*piMdikaduguna	n number eka parsarg aduguna 
piMdikeVlla/*piMdikalla	n number eka parsarg kalla 
piMdiveVnuka/*piMdiveVnakAla/piMdiveVnakAwala/piMdiveVnakana	n number eka parsarg veVnuka 
piMdiwaravAwa/piMdiwarvAwa/*piMdiwaruvAwa/piMdiwaravAwana/piMdiwarvAwana/piMdiwaruvAwana	n number eka parsarg waravAwa 
piMdeVxuruguMdA/*piMdikeVxuruguMdA	n number eka parsarg eVxuruguMdA 
piMdimaXya/*piMdimaXyalo/piMdimaXyana	n number eka parsarg maXya 
*piMdinaduma/piMdinadumana	n number eka parsarg naduma 
piMdibaxulugA/piMdibaxulu/*piMdikibaxulu/piMdikubaxulu	n number eka parsarg baxulugA 
*piMdicotlo/piMdicotulo/piMdicotuna/piMdicota	n number eka parsarg cotlo 
*piMdisWAnaMlo/piMdiswAnaMlo	n number eka parsarg sWAnaMlo 
piMdinerugA/piMdikunerugA/*piMdikinerugA	n number eka parsarg nerugA 
*piMdiprakAraM/piMdiprakAramu	n number eka parsarg prakAraM 
*piMdixaggaranuMdi/piMdixaggaranuMci/piMdixaggiranuMdi/piMdixaggiranuMci	n number eka parsarg xaggaranuMdi 
*piMdivaxxanuMdi/piMdivaxxanuMci/piMdivaxxaniMci	n number eka parsarg vaxxanuMdi 
*piMdipakkanuMdi/piMdipakkanuMci/piMdipakkaniMci/piMdipakkalonuMdi/piMdipakkalonuMci/piMdipakkaloniMci	n number eka parsarg pakkanuMdi 
*piMdilopalanuMdi/piMdilopalanuMci/piMdilopalaniMci	n number eka parsarg lopalanuMdi 
*piMdibEtanuMdi/piMdibEtanuMci/piMdibEtaniMci	n number eka parsarg bEtanuMdi 
*piMdipEnuMdi/piMdipEnuMci/piMdipEniMci	n number eka parsarg pEnuMdi 
piMdikiMxanuMdi/piMdikiMxanuMci/piMdikiMxaniMci/*piMdikriMxanuMdi/piMdikriMxanuMci/piMdikriMxaniMci	n number eka parsarg kriMxanuMdi 
piMdadugunuMdi/piMdadugunuMci/*piMdikadugunuMdi/piMdikadugunuMci/piMdikaduguniMci	n number eka parsarg adugunuMdi 
*piMdimuMxunuMdi/piMdimuMxunuMci/piMdimuMxuniMci	n number eka parsarg muMxunuMdi 
piMdiveVnukanuMdi/*piMdiveVnakAlanuMdi/piMdiveVnakAwalanuMdi/piMdiveVnakanuMdi/piMdiveVnukanuMci/piMdiveVnakAlanuMci/piMdiveVnakAwalanuMci/piMdiveVnakanuMci	n number eka parsarg veVnukanuMdi 
piMdeVxutinuMdi/*piMdikeVxutinuMdi/piMdikeVxutinuMci/piMdeVxutinuMci	n number eka parsarg eVxutinuMdi 
*piMdimaXyanuMdi/piMdimaXyanuMci/piMdimaXyalonuMdi/piMdimaXyalonuMci	n number eka parsarg maXyanuMdi 
*piMdinadumanuMdi/piMdinadumanuMci	n number eka parsarg nadumanuMdi 
*piMdiwaravAwanuMdi/piMdiwarvAwanuMdi/piMdiwaravAwanuMci/piMdiwarvAwanuMci	n number eka parsarg waravAwanuMdi 
*piMdicotlonuMdi/piMdicotunuMdi/piMdicotlonuMci/piMdicotunuMci	n number eka parsarg cotlonuMdi 
piMdisWAnaMnuMdi/*piMdisWAnamunuMdi/piMdisWAnaMnuMci/piMdisWAnamunuMci/piMdisWAnaMlonuMdi/piMdisWAnamulonuMdi/piMdisWAnaMlonuMci/piMdiswAnamulonuMci	n number eka parsarg sWAnaMnuMdi 
piMdaMxu/piMdinaMxu/*piMdiyaMxu	n number eka parsarg aMxu 
piMdaMte/*piMdaMteV	n number eka parsarg aMte 
*piMdikaMteV/piMdikaMte/piMdikanna/piMdikannA	n number eka parsarg kaMteV 
*piMdEna	n number eka parsarg Ena 
*piMdipAti	n number eka parsarg pAti 
*piMdilAMti/piMdilAti	n number eka parsarg lAMti 
*piMdigAnI/piMdikAnI	n number eka parsarg gAni 
*piMdigA	n number eka parsarg gA 
*piMdlu/piMdulu	n number bahu parsarg 0  case d
piMdlU/piMdlulArA/piMdillArA/*piMdullArA	n number bahu parsarg I  case d
-	n number bahu parsarg gA 
*piMdlagAdu/piMdulagAdu	n number bahu parsarg gAdu  case d
*piMdlagawweV/piMdulagawweV	n number bahu parsarg gawweV  case d
*piMdlavAdu/piMdlodu	n number bahu parsarg vAdu  case d
*piMdlAyana/piMdulAyana	n number bahu parsarg Ayana  case d
*piMdlavAru/piMdloru	n number bahu parsarg vAru  case d
*piMdlaxi/piMdilxi/piMdulxi	n number bahu parsarg xi  case d
*piMdlavi/piMdluy/piMdluvi	n number bahu parsarg vi  case d
*piMdlagAru/piMdulagAru	n number bahu parsarg gAru  case d
*piMdlaM/piMdlamu	n number bahu parsarg nu  case d
*piMdlu/piMdulu	n number bahu parsarg vu 
*piMdlayoVkka	n number bahu parsarg yoVkka 
*piMdla	n number bahu parsarg obl 
*piMdlani/piMdlanu/piMdlanu/piMdulni	n number bahu parsarg ni 
*piMdlaki/piMdlaku	n number bahu parsarg ki 
*piMdlawo/piMdilwo/piMdlawoda/piMdlawoti/piMdulwoti/piMdulwoda	n number bahu parsarg wo 
*piMdlalo/piMdillo/piMdlalona/piMdillona/piMdlalopala/piMdillopala	n number bahu parsarg lo 
*piMdlaloni/piMdlayaMxali/piMdilloni/piMdlalopali/piMdillopali	n number bahu parsarg loni 
*piMdlamIxa	n number bahu parsarg mIxa 
*piMdlana	n number bahu parsarg na 
piMdlaniMci/piMdilniMci/piMdlanuMci/piMdilnuMci/*piMdlanuMdi/piMdilnuMdi	n number bahu parsarg niMci 
*piMdlaxvArA/piMdlaxvAra	n number bahu parsarg xvArA 
*piMdlavalana/piMdlavalla	n number bahu parsarg valana 
*piMdlanubatti/piMdlanibatti	n number bahu parsarg batti 
*piMdlacewa/piMdilacewa/piMdlace/piMdilace	n number bahu parsarg ce 
*piMdlawopAtu/piMdilwopAtu	n number bahu parsarg wopAtu 
*piMdlawokUdi/piMdilwokUdi/piMdlawokUda/piMdlawokUdA/piMdilwokUdA/piMdlawogUdA	n number bahu parsarg wokUdi 
*piMdlakosaM/piMdlakE/piMdlArWaM	n number bahu parsarg kosaM 
*piMdlakoVraku/piMdlakoVrYaku	n number bahu parsarg koVraku 
piMdlalonuMdi/piMdlalonuMci/*piMdillonuMdi/piMdillonuMci/piMdilloniMci/piMdlaloniMci	n number bahu parsarg lonuMdi 
*piMdlamIxanuMdi/piMdlamIxanuMci/piMdlamIxaniMci	n number bahu parsarg mIxanuMdi 
*piMdlaxAkA/piMdlaxAka	n number bahu parsarg xAkA 
*piMdlavaraku	n number bahu parsarg varaku 
*piMdlamIxaki/piMdlamIxaku/piMdlamIxiki	n number bahu parsarg mIxaki 
*piMdlaxaggara/piMdlaxaggira	n number bahu parsarg xaggara 
*piMdlavaxxa/piMdiloVxxa	n number bahu parsarg vaxxa 
*piMdlakAda/piMdulakAda	n number bahu parsarg kAda 
piMdleVxurugA/*piMdlakeVxurugA	n number bahu parsarg keVxurugA 
*piMdlamuMxu	n number bahu parsarg muMxu 
*piMdlaguriMci/piMdlagUrci/piMdlanuguriMci/piMdlanigUrci	n number bahu parsarg guriMci 
piMdlapE/piMdlapEni/*piMdlapEna	n number bahu parsarg pE 
*piMdlapEki/piMdulapEki	n number bahu parsarg pEki 
*piMdlaguMdA	n number bahu parsarg guMdA 
piMdlalA/piMdlulA/piMdlalAga/piMdlulAga/*piMdlulAgA	n number bahu parsarg lA 
piMdlavale/*piMdlavaleV/piMdlamAxiri/piMdlanupolina/piMdlanubolina	n number bahu parsarg vale 
piMdlakumalle/piMdulakumalle/*piMdlakumalleV/piMdulakumalleV	n number bahu parsarg kimalle 
*piMdlukUdA/piMdlugUdA/piMdlukUda/piMdlugUda	n number bahu parsarg kUdA 
*piMdlaxqRtilo/piMdlaxruRtilo	n number bahu parsarg xqRtilo 
*piMdlulekuMdA/piMdillekuMdA/piMdluleka	n number bahu parsarg lekuMdA 
*piMdlukAkuMdA/piMdlukAkuMda/piMdlukAka	n number bahu parsarg kAkuMdA 
*piMdlumoVxalukoVni/piMdlanumoVxalukoVni	n number bahu parsarg moVxalukoVni 
*piMdlavEpu/piMdlavepu/piMdlakesi	n number bahu parsarg vEpu 
piMdlapakka/piMdlapakkana/piMdlaprakka/*piMdlaprakkana	n number bahu parsarg pakka 
piMdlapakkalo/*piMdlaprakkalo	n number bahu parsarg pakkalo 
*piMdlaloki/piMdlaloniki/piMdlalopalaki/piMdlalopaliki/piMdillopaliki/piMdillopalaku	n number bahu parsarg lopalaki 
piMdlakiMxa/*piMdlakriMxa/piMdlakriMxana/piMdlakiMxana	n number bahu parsarg kiMxa 
piMdladuguna/*piMdlakaduguna	n number bahu parsarg aduguna 
piMdlakeVlla/*piMdlakalla	n number bahu parsarg kalla 
piMdlaveVnuka/piMdlaveVnaka/*piMdlaveVnakAla/piMdlaveVnukAla/piMdlaveVnakAwala/piMdlaveVnukAwala	n number bahu parsarg veVnuka 
*piMdlawaravAwa/piMdlawarvAwa/piMdilwaravAwa	n number bahu parsarg waravAwa 
piMdleVxuruguMdA/*piMdlakeVxuruguMdA	n number bahu parsarg eVxuruguMdA 
*piMdlamaXya/piMdlamaXyana/piMdlamaXyalo	n number bahu parsarg maXya 
*piMdlanaduma/piMdlakinaduma	n number bahu parsarg naduma 
piMdlabaxulugA/piMdlakibaxulugA/piMdlabaxulu/*piMdlakibaxulu	n number bahu parsarg baxulugA 
*piMdlacotlo/piMdlacotulo	n number bahu parsarg cotlo 
piMdlasWAnaMlo/piMdlaswAnaMlo/*piMdlasWAnamulo	n number bahu parsarg sWAnaMlo 
piMdlanerugA/piMdlakunerugA/*piMdlakinerugA	n number bahu parsarg nerugA 
*piMdlaprakAraM/piMdlanubatti/piMdlabatti/piMdlanibatti	n number bahu parsarg prakAraM 
*piMdlaxaggaranuMdi/piMdlaxaggiranuMdi/piMdlaxaggaranuMci/piMdlaxaggiranuMci	n number bahu parsarg xaggaranuMdi 
*piMdlavaxxanuMdi/piMdlavaxxanuMci	n number bahu parsarg vaxxanuMdi 
*piMdlapakkanuMdi/piMdlapakkanuMci/piMdlapakkalonuMdi/piMdlapakkalonuMci	n number bahu parsarg pakkanuMdi 
*piMdlalopalanuMdi/piMdillopalanuMdi/piMdlalopalanuMci/piMdillopalanuMci/piMdillopalinuMdi/piMdlalopalinuMci	n number bahu parsarg lopalanuMdi 
*piMdlabEtanuMdi/piMdlabEtanuMci/piMdlabEtaniMci	n number bahu parsarg bEtanuMdi 
*piMdlapEnuMdi/piMdlapEnuMci/piMdlapEniMci	n number bahu parsarg pEnuMdi 
piMdlakiMxanuMdi/piMdlakiMxanuMci/piMdlakiMxaniMci/*piMdlakriMxanuMdi/piMdlakriMxanuMci/piMdlakriMxaniMci	n number bahu parsarg kriMxanuMdi 
*piMdladugunuMdi/piMdladugunuMci/piMdladuguniMci	n number bahu parsarg adugunuMdi 
*piMdlamuMxunuMdi/piMdlamuMxunuMci/piMdlamuMxuniMci	n number bahu parsarg muMxunuMdi 
piMdlaveVnukanuMdi/piMdlaveVnakanuMdi/*piMdlaveVnakAlanuMdi/piMdlaveVnakAlanuMci/piMdlaveVnukanuMci/piMdlaveVnakanuMci/piMdlaveVnakAwalanuMdi/piMdlaveVnakAwalanuMci	n number bahu parsarg veVnukanuMdi 
piMdleVxutinuMdi/*piMdlakeVxutinuMdi/piMdleVxutinuMci/piMdlakeVxutinuMci	n number bahu parsarg eVxutinuMdi 
*piMdlamaXyanuMdi/piMdlamaXyanuMci/piMdlamaXyaniMci/piMdlamaXyalonuMdi/piMdlamaXyalonuMci/piMdlamaXyaloniMci	n number bahu parsarg maXyanuMdi 
*piMdlanadumanuMdi/piMdlanadamanuMdi/piMdlanadumanuMci/piMdlanadamanuMci	n number bahu parsarg nadumanuMdi 
*piMdlawaravAwanuMdi/piMdlawarvAwanuMdi/piMdlawaravAwanuMci/piMdlawarvAwanuMci	n number bahu parsarg waravAwanuMdi 
*piMdlacotlonuMdi/piMdlacotunuMdi/piMdlacotlonuMci/piMdlacotloniMci/piMdlacotunuMci/piMdlacotuniMci	n number bahu parsarg cotlonuMdi 
*piMdlasWAnamunuMdi/piMdlasWAnaMnuMdi/piMdlasWAnamunuMci/piMdlasWAnaMnuMci/piMdlasWAnaMlonuMdi/piMdlasWAnamulonuMdi/piMdlasWAnaMlonuMci/piMdlasWAnamulonuMci	n number bahu parsarg sWAnaMnuMdi 
*piMdlayaMxu/piMdlaMxu	n number bahu parsarg aMxu 
piMdlaMte/*piMdlaMteV	n number bahu parsarg aMte 
*piMdlakaMteV/piMdlakaMte/piMdlakanna/piMdlakannA	n number bahu parsarg kaMteV 
*piMdlEna	n number bahu parsarg Ena 
*piMdlapAti	n number bahu parsarg pAti 
*piMdlulAMti/piMdlulAti	n number bahu parsarg lAMti 
*piMdlugAnI/piMdlukAnI	n number bahu parsarg gAni 
*piMdlugA	n number bahu parsarg gA 
