noun	
puswakaM	
*puswakaM/puswakamu	n number eka parsarg 0 
-	n number eka parsarg I 
-	n number eka parsarg gA 
*puswakaMgAdu/puswakagAdu	n number eka parsarg gAdu 
*puswakaMgawweV/puswakagawweV	n number eka parsarg gawweV 
*puswakaMvAdu/puswakapuvAdu	n number eka parsarg vAdu 
*puswakamAyana/puswakapAyana	n number eka parsarg Ayana 
*puswakaMvAru/puswakapuvAru	n number eka parsarg vAru 
puswakaMxi/*puswakAnixi/puswakapuxi	n number eka parsarg xi 
puswakaMvi/*puswakAnivi/puswakapuvi	n number eka parsarg vi 
*puswakaMgAru	n number eka parsarg gAru 
puswakaMnu/*puswakAnni/puswakamunu	n number eka parsarg nu 
puswakaMvu/*puswakAnivi/puswakamuvu	n number eka parsarg vu 
*puswakaMyoVkka	n number eka parsarg yoVkka 
puswakAni/puswakapu/*puswaka	n number eka parsarg obl 
*puswakAnni/puswakaMnu/puswakamunu	n number eka parsarg ni 
*puswakAniki/puswakaMki/puswakaMku/puswakamunaku	n number eka parsarg ki 
puswakAniwo/*puswakaMwo/puswakAniwoti/puswakaMwoti	n number eka parsarg wo 
*puswakaMlo/puswakaMlopala/puswakaMlona	n number eka parsarg lo 
puswakaMloni/*puswakaMlopali/puswakamaMxali	n number eka parsarg loni 
puswakaMmIxa/*puswakammIxa	n number eka parsarg mIxa 
puswakAna/*puswakamuna	n number eka parsarg na 
puswakaMniMci/puswakAnnuMdi/puswakaMnuMci/*puswakaMnuMdi	n number eka parsarg niMci 
*puswakaMxvArA/puswakaMxvAra	n number eka parsarg xvArA 
puswakaMvalana/puswakaMvalla/*puswakamuvalana/puswakamuvalla	n number eka parsarg valana 
puswakaMnubatti/puswakAnnibatti/*puswakamunubatti	n number eka parsarg batti 
puswakaMce/*puswakaMcewa	n number eka parsarg ce 
puswakaMwopAtu/*puswakamuwopAtu/puswakaMwobAtu/puswakamuwobAtu	n number eka parsarg wopAtu 
puswakaMwokUdi/puswakaMwokUda/*puswakaMwokUdA/puswakaMwogUdi/puswakaMwogUda/puswakaMwogUdA	n number eka parsarg wokUdi 
*puswakaMkosaM/puswakaMkE/puswakAnikE/puswakAnikosaM/puswakArWaM	n number eka parsarg kosaM 
*puswakaMkoVraku/puswakaMkoVrYaku/puswakanikoVraku	n number eka parsarg koVraku 
*puswakaMlonuMdi/puswakaMlonuMci/puswakaMloniMci	n number eka parsarg lonuMdi 
*puswakaMmIxanuMdi/puswakaMmIxanuMci/puswakaMmIxaniMci/puswakammIxanuMdi/puswakammIxanuMci/puswakammIxaniMci	n number eka parsarg mIxanuMdi 
*puswakaMxAkA/puswakaMxAka	n number eka parsarg xAkA 
*puswakaMvaraku	n number eka parsarg varaku 
*puswakaMmIxaki/puswakaMmIxaku/puswakaMmIxiki/puswakammIxaki/puswakammIxaku/puswakammIxiki	n number eka parsarg mIxaki 
*puswakaMxaggara/puswakaMxaggira	n number eka parsarg xaggara 
*puswakaMvaxxa/puswakamoVxxa	n number eka parsarg vaxxa 
*puswakaMkAda	n number eka parsarg kAda 
puswakaMkeVxurugA/puswakameVxurugA/*puswakAnikeVxurugA	n number eka parsarg keVxurugA 
*puswakaMmuMxu/puswakammuMxu	n number eka parsarg muMxu 
*puswakaMguriMci/puswakAnniguriMci/puswakAnnigUrci	n number eka parsarg guriMci 
puswakaMpE/*puswakaMpEna/puswakaMpEni	n number eka parsarg pE 
*puswakaMpEki	n number eka parsarg pEki 
*puswakaMguMdA	n number eka parsarg guMdA 
puswakaMlA/puswakaMlAga/*puswakaMlAgA	n number eka parsarg lA 
*puswakaMvaleV/puswakaMvale/puswakaMmAxiri/puswakAnnipolina/puswakAnnibolina/puswakammAxiri	n number eka parsarg vale 
puswakAnikimalle/*puswakAnikimalleV/puswakaMkimalleV/puswakaMkimalle	n number eka parsarg kimalle 
puswakaMkUdA/*puswakAnnikUdA/puswakamunukUdA/puswakaMgUdA	n number eka parsarg kUdA 
*puswakaMxqRtilo/puswakaMxruRtilo/puswakamuxqRtilo	n number eka parsarg xqRtilo 
*puswakaMlekuMdA/puswakAnnilekuMdA/puswakaMlekuMda/puswakamunulekuMdA/puswakaMleka	n number eka parsarg lekuMdA 
*puswakaMkAkuMdA/puswakAnnikAkuMdA/puswakamukAkuMda/puswakamunukAkuMdA/puswakaMkAka	n number eka parsarg kAkuMdA 
*puswakaMmoVxalukoVni/puswakAnnimoVxalukoVni/puswakamunumoVxalukoVni/puswakammoVxalukoVni	n number eka parsarg moVxalukoVni 
*puswakaMvEpu/puswakaMvepu/puswakaMkesi	n number eka parsarg vEpu 
puswakaMpakka/puswakaMprakka/puswakaMpakkana/*puswakaMprakkana/puswakaMpakkani	n number eka parsarg pakka 
puswakaMpakkalo/*puswakaMprakkalo/puswakaMpakkalona/puswakaMpakkaloni	n number eka parsarg pakkalo 
*puswakaMloki/puswakaMloniki/puswakaMlopalaku/puswakaMlopalaki/puswakaMlopalaku/puswakaMlopaliki	n number eka parsarg lopalaki 
puswakaMkiMxa/*puswakaMkriMxa/puswakaMkriMxana/puswakaMkiMxana	n number eka parsarg kiMxa 
puswakamaduguna/*puswakAnikaduguna	n number eka parsarg aduguna 
puswakaMkeVlla/*puswakaMkalla	n number eka parsarg kalla 
puswakaMveVnuka/*puswakaMveVnakAla/puswakaMveVnakAwala/puswakaMveVnakana	n number eka parsarg veVnuka 
puswakaMwaravAwa/puswakaMwarvAwa/*puswakaMwaruvAwa/puswakaMwaravAwana/puswakaMwarvAwana/puswakaMwaruvAwana	n number eka parsarg waravAwa 
puswakameVxuruguMdA/*puswakAnikeVxuruguMdA/puswakaMkeVxuruguMdA	n number eka parsarg eVxuruguMdA 
*puswakaMmaXya/puswakaMmaXyalo/puswakaMmaXyana/puswakammaXya/puswakammaXyalo/puswakammaXyana	n number eka parsarg maXya 
*puswakaMnaduma/puswakAnikinadumuna	n number eka parsarg naduma 
puswakaMbaxulugA/puswakaMbaxulu/*puswakAnikibaxulu/puswakamunakubaxulu	n number eka parsarg baxulugA 
*puswakaMcotlo/puswakaMcotulo/puswakaMcotuna/puswakaMcota	n number eka parsarg cotlo 
*puswakaMsWAnaMlo/puswakaMswAnaMlo	n number eka parsarg sWAnaMlo 
puswakaMnerugA/puswakamunakunerugA/*puswakAnikinerugA	n number eka parsarg nerugA 
*puswakaMprakAraM/puswakAniprakAramu/puswakamuprakAramu	n number eka parsarg prakAraM 
*puswakaMxaggaranuMdi/puswakaMxaggaranuMci/puswakaMxaggiranuMdi/puswakaMxaggiranuMci	n number eka parsarg xaggaranuMdi 
*puswakaMvaxxanuMdi/puswakaMvaxxanuMci/puswakaMvaxxaniMci	n number eka parsarg vaxxanuMdi 
*puswakaMpakkanuMdi/puswakaMpakkanuMci/puswakaMpakkaniMci/puswakaMpakkalonuMdi/puswakaMpakkalonuMci/puswakaMpakkaloniMci	n number eka parsarg pakkanuMdi 
*puswakaMlopalanuMdi/puswakaMlopalanuMci/puswakaMlopalaniMci	n number eka parsarg lopalanuMdi 
*puswakaMbEtanuMdi/puswakaMbEtanuMci/puswakaMbEtaniMci	n number eka parsarg bEtanuMdi 
*puswakaMpEnuMdi/puswakaMpEnuMci/puswakaMpEniMci	n number eka parsarg pEnuMdi 
puswakaMkiMxanuMdi/puswakaMkiMxanuMci/puswakAnikiMxaniMci/*puswakaMkriMxanuMdi/puswakaMkriMxanuMci/puswakaMkriMxaniMci	n number eka parsarg kriMxanuMdi 
puswakamadugunuMdi/puswakamadugunuMci/*puswakAnikadugunuMdi/puswakAnikadugunuMci/puswakAnikaduguniMci	n number eka parsarg adugunuMdi 
*puswakaMmuMxunuMdi/puswakaMmuMxunuMci/puswakaMmuMxuniMci/puswakammuMxunuMdi/puswakammuMxunuMci/puswakammuMxuniMci	n number eka parsarg muMxunuMdi 
puswakaMveVnukanuMdi/*puswakaMveVnakAlanuMdi/puswakaMveVnakAwalanuMdi/puswakaMveVnakanuMdi/puswakaMveVnukanuMci/puswakaMveVnakAlanuMci/puswakaMveVnakAwalanuMci/puswakaMveVnakanuMci	n number eka parsarg veVnukanuMdi 
puswakameVxutinuMdi/puswakAnikeVxutinuMdi/puswakAnikeVxutinuMci/puswakaMeVxutinuMci/puswakameVxutanuMdi/*puswakAnikeVxutanuMdi/puswakAnikeVxutanuMci/puswakaMeVxutanuMci	n number eka parsarg eVxutinuMdi 
*puswakaMmaXyanuMdi/puswakaMmaXyanuMci/puswakammaXyanuMdi/puswakammaXyanuMci/puswakaMmaXyalonuMdi/puswakaMmaXyalonuMci/puswakammaXyalonuMdi/puswakammaXyalonuMci	n number eka parsarg maXyanuMdi 
*puswakaMnadumanuMdi/puswakaMnadumanuMci	n number eka parsarg nadumanuMdi 
*puswakaMwaravAwanuMdi/puswakaMwarvAwanuMdi/puswakaMwaravAwanuMci/puswakaMwarvAwanuMci	n number eka parsarg waravAwanuMdi 
*puswakaMcotlonuMdi/puswakaMcotunuMdi/puswakaMcotlonuMci/puswakaMcotunuMci	n number eka parsarg cotlonuMdi 
puswakaMsWAnaMnuMdi/puswakaMsWAnamunuMdi/puswakaMsWAnaMnuMci/puswakaMsWAnamunuMci/puswakasWAnaMnuMdi/*puswakasWAnamunuMdi/puswakaMsWAnaMlonuMdi/puswakaMsWAnamulonuMdi/puswakasWAnaMlonuMdi/puswakasWAnamulonuMdi/puswakaMsWAnaMlonuMci/puswakaMswAnamulonuMci/puswakasWAnaMlonuMci/puswakasWAnamulonuMci	n number eka parsarg sWAnaMnuMdi 
*puswakamaMxu/puswakamunaMxu	n number eka parsarg aMxu 
*puswakamaMte/puswakaMaMteV/puswakAnnaMte	n number eka parsarg aMte 
*puswakaMkaMteV/puswakAnikaMte/puswakAnikanna/puswakAnikannA/puswakaMkannA/puswakaMkanna	n number eka parsarg kaMteV 
*puswakamEna	n number eka parsarg Ena 
*puswakaMpAti	n number eka parsarg pAti 
puswakaMlAti/*puswakaMlAMti/puswakaMvaMti	n number eka parsarg lAMti 
*puswakaMgAnI/puswakaMkAnI	n number eka parsarg gAni 
*puswakaMgA	n number eka parsarg gA 
*puswakAlu/puswakamulu	n number bahu parsarg 0 
puswakamulArA/*puswakAllArA	n number bahu parsarg I 
-	n number bahu parsarg gA 
*puswakAlagAdu/puswakamulagAdu	n number bahu parsarg gAdu 
*puswakAlagawweV/puswakamulagawweV	n number bahu parsarg gawweV 
*puswakAlavAdu/puswakAlodu/puswakamulavAdu	n number bahu parsarg vAdu 
*puswakAlAyana/puswakamulAyana	n number bahu parsarg Ayana 
*puswakAlavAru/puswakAloru/puswakamulavAru	n number bahu parsarg vAru 
*puswakAlaxi/puswakAlxi/puswakamulaxi	n number bahu parsarg xi 
*puswakAlavi/puswakAlay/puswakamulavi	n number bahu parsarg vi 
*puswakAlagAru/puswakamulagAru	n number bahu parsarg gAru 
puswakAlamu/*puswakAlaM/puswakamulamu/puswakAlaM	n number bahu parsarg nu 
*puswakAlu/puswakamulu	n number bahu parsarg vu 
*puswakamulayoVkka/puswakAlayoVkka	n number bahu parsarg yoVkka 
*puswakAla/*puswakamula	n number bahu parsarg obl 
*puswakAlani/puswakAlni/puswakAlanu/puswakAlnu/puswakamulanu	n number bahu parsarg ni 
*puswakAlaki/puswakAlaku/puswakamulaku	n number bahu parsarg ki 
*puswakAlawo/puswakAlwo/puswakamulawo/puswakAlawoti/puswakAlwoti/puswakamulawoda	n number bahu parsarg wo 
*puswakAlalo/puswakAllo/puswakAlalona/puswakAllona/puswakamulalo/puswakamullo/puswakamulalona/puswakamullona	n number bahu parsarg lo 
*puswakAlalopala/puswakAllopala/puswakamulalopala/puswakamullopala/puswakAlaloni/puswakAlayaMxali/puswakAlloni/puswakAlalopali/puswakAllopali/puswakamulaloni/puswakamulayaMxali/puswakamulloni/puswakamulalopali/puswakamullopali	n number bahu parsarg loni 
*puswakAlamIxa/puswakamulamIxa	n number bahu parsarg mIxa 
puswakAlana/*puswakamulana	n number bahu parsarg na 
puswakAlaniMci/puswakAlniMci/puswakAlanuMci/puswakAlnuMci/*puswakAlanuMdi/puswakAlnuMdi/puswakamulanuMdi	n number bahu parsarg niMci 
*puswakAlaxvArA/puswakAlaxvAra/puswakamulaxvArA	n number bahu parsarg xvArA 
*puswakAlavalana/puswakAlavalla	n number bahu parsarg valana 
*puswakAlanubatti/puswakAlnibatti	n number bahu parsarg batti 
*puswakAlacewa/puswakAlcewa/puswakAlace/puswakAlce/puswakamulace/puswakamulacewa	n number bahu parsarg ce 
*puswakAlawopAtu/puswakAlwopAtu/puswakamulawopAtu/puswakAlawobAtu/puswakAlwobAtu/puswakamulawobAtu	n number bahu parsarg wopAtu 
puswakAlawokUdi/puswakAlwokUdi/puswakAlawokUda/*puswakAlawokUdA/puswakAlwokUdA/puswakamulawokUda/puswakAlawogUdi/puswakAlwogUdi/puswakAlawogUda/puswakAlawogUdA/puswakAlwogUdA/puswakamulawogUda	n number bahu parsarg wokUdi 
*puswakAlakosaM/puswakAlakE/puswakamulakosamu/puswakamulakE/puswakAlArWaM	n number bahu parsarg kosaM 
*puswakAlakoVraku/puswakAlakoVrYaku/puswakamulakoVraku	n number bahu parsarg koVraku 
*puswakAlalonuMdi/puswakAlalonuMci/puswakAllonuMdi/puswakAllonuMci/puswakAlloniMci/puswakAlaloniMci/*puswakamulalonuMdi	n number bahu parsarg lonuMdi 
*puswakAlamIxanuMdi/puswakAlamIxanuMci/puswakAlamIxaniMci/puswakamulamIxanuMdi	n number bahu parsarg mIxanuMdi 
*puswakAlaxAkA/puswakAlaxAka/puswakamulaxAka	n number bahu parsarg xAkA 
*puswakAlavaraku/puswakamulavaraku	n number bahu parsarg varaku 
*puswakAlamIxaki/puswakAlamIxaku/puswakAlamIxiki	n number bahu parsarg mIxaki 
*puswakAlaxaggara/puswakAlaxaggira	n number bahu parsarg xaggara 
*puswakAlavaxxa/puswakAloVxxa	n number bahu parsarg vaxxa 
*puswakAlakAda/puswakamulakAda/puswakAlakAda	n number bahu parsarg kAda 
puswakAleVxurugA/*puswakAlakeVxurugA	n number bahu parsarg keVxurugA 
*puswakAlamuMxu/puswakamulamuMxu	n number bahu parsarg muMxu 
*puswakAlaguriMci/puswakAlagUrci/puswakAlanuguriMci/puswakAlanigUrci	n number bahu parsarg guriMci 
puswakAlapE/puswakAlapEni/*puswakAlapEna	n number bahu parsarg pE 
*puswakAlapEki/puswakamulapEki	n number bahu parsarg pEki 
*puswakAlaguMdA/puswakamulaguMdA	n number bahu parsarg guMdA 
puswakAlalA/puswakAllA/puswakAlalAga/puswakAllAga/*puswakAllAgA	n number bahu parsarg lA 
puswakAlavale/*puswakAlavaleV/puswakAlamAxiri/puswakAlapoli/puswakAlabolina	n number bahu parsarg vale 
*puswakAlakumalleV/puswakamulakumalle/puswakAlakumalle	n number bahu parsarg kimalle 
*puswakAlukUdA/puswakAlugUdA/puswakAlukUda/puswakAlugUda	n number bahu parsarg kUdA 
*puswakAlaxqRtilo/puswakAlaxruRtilo	n number bahu parsarg xqRtilo 
*puswakAlulekuMdA/puswakAllekuMdA/puswakAluleka/puswakAlulekuMda/puswakAlleka	n number bahu parsarg lekuMdA 
*puswakAlukAkuMdA/puswakAlukAkuMda/puswakAlukAka/puswakAlugAkuMdA/puswakAlugAkuMda/puswakAlugAka/puswakAlukAkuMdA/puswakAlukAkuMda/puswakAlukAka/puswakAlugAkuMdA/puswakAlugAkuMda/puswakAlugAka	n number bahu parsarg kAkuMdA 
puswakAlanumoVxalukoVni/*puswakAlumoVxalukoVni	n number bahu parsarg moVxalukoVni 
*puswakAlavEpu/puswakAlavepu/puswakAlakesi	n number bahu parsarg vEpu 
puswakAlapakka/puswakAlapakkana/puswakAlaprakka/*puswakAlaprakkana	n number bahu parsarg pakka 
puswakAlapakkalo/*puswakAlaprakkalo	n number bahu parsarg pakkalo 
*puswakAlaloki/puswakAlaloniki/puswakAlalopalaki/puswakAlalopaliki/puswakAllopaliki/puswakAllopalaku	n number bahu parsarg lopalaki 
puswakAlakiMxa/*puswakAlakriMxa/puswakAlakriMxana/puswakAlakiMxana	n number bahu parsarg kiMxa 
puswakAladuguna/*puswakAlakaduguna	n number bahu parsarg aduguna 
puswakAlakeVlla/*puswakAlakalla	n number bahu parsarg kalla 
puswakAlaveVnuka/puswakAlaveVnaka/*puswakAlaveVnakAla/puswakAlaveVnukAla/puswakAlaveVnakAwala/puswakAlaveVnukAwala	n number bahu parsarg veVnuka 
puswakAlawaravAwa/puswakAlawarvAwa/*puswakAlawaruvAwa/puswakAlwaruvAwa	n number bahu parsarg waravAwa 
puswakAleVxuruguMdA/*puswakAlakeVxuruguMdA	n number bahu parsarg eVxuruguMdA 
*puswakAlamaXya/puswakAlamaXyana/puswakAlamaXyalo	n number bahu parsarg maXya 
*puswakAlanaduma/puswakAlakinaduma	n number bahu parsarg naduma 
puswakAlabaxulugA/puswakAlakibaxulugA/puswakAlabaxulu/*puswakAlakibaxulu	n number bahu parsarg baxulugA 
*puswakAlacotlo/puswakAlacotulo	n number bahu parsarg cotlo 
puswakAlasWAnaMlo/puswakAlaswAnaMlo/*puswakAlasWAnamulo	n number bahu parsarg sWAnaMlo 
puswakAlanerugA/puswakAlakunerugA/*puswakAlakinerugA	n number bahu parsarg nerugA 
*puswakAlaprakAraM/puswakAlanubatti/puswakAlabatti/puswakAlanibatti	n number bahu parsarg prakAraM 
*puswakAlaxaggaranuMdi/puswakAlaxaggiranuMdi/puswakAlaxaggaranuMci/puswakAlaxaggiranuMci	n number bahu parsarg xaggaranuMdi 
*puswakAlavaxxanuMdi/puswakAlavaxxanuMci	n number bahu parsarg vaxxanuMdi 
*puswakAlapakkanuMdi/puswakAlapakkanuMci/puswakAlapakkalonuMdi/puswakAlapakkalonuMci	n number bahu parsarg pakkanuMdi 
*puswakAlalopalanuMdi/puswakAllopalanuMdi/puswakAlalopalanuMci/puswakAllopalanuMci/puswakAllopalinuMdi/puswakAlalopalinuMci	n number bahu parsarg lopalanuMdi 
*puswakAlabEtanuMdi/puswakAlabEtanuMci/puswakAlabEtaniMci	n number bahu parsarg bEtanuMdi 
*puswakAlapEnuMdi/puswakAlapEnuMci/puswakAlapEniMci	n number bahu parsarg pEnuMdi 
puswakAlakiMxanuMdi/puswakAlakiMxanuMci/puswakAlakiMxaniMci/*puswakAlakriMxanuMdi/puswakAlakriMxanuMci/puswakAlakriMxaniMci	n number bahu parsarg kriMxanuMdi 
*puswakAladugunuMdi/puswakAladugunuMci/puswakAladuguniMci	n number bahu parsarg adugunuMdi 
*puswakAlamuMxunuMdi/puswakAlamuMxunuMci/puswakAlamuMxuniMci	n number bahu parsarg muMxunuMdi 
puswakAlaveVnukanuMdi/puswakAlaveVnakanuMdi/*puswakAlaveVnakAlanuMdi/puswakAlaveVnakAlanuMci/puswakAlaveVnukanuMci/puswakAlaveVnakanuMci/puswakAlaveVnakAwalanuMdi/puswakAlaveVnakAwalanuMci	n number bahu parsarg veVnukanuMdi 
puswakAleVxutinuMdi/puswakAlakeVxutinuMdi/puswakAleVxutanuMdi/*puswakAlakeVxutanuMdi/puswakAleVxutinuMci/puswakAlakeVxutinuMci/puswakAleVxutanuMci/puswakAlakeVxutanuMci	n number bahu parsarg eVxutinuMdi 
*puswakAlamaXyanuMdi/puswakAlamaXyanuMci/puswakAlamaXyaniMci/puswakAlamaXyalonuMdi/puswakAlamaXyalonuMci/puswakAlamaXyaloniMci	n number bahu parsarg maXyanuMdi 
*puswakAlanadumanuMdi/puswakAlanadamanuMdi/puswakAlanadumanuMci/puswakAlanadamanuMci	n number bahu parsarg nadumanuMdi 
*puswakAlawaruvAwanuMdi/puswakAlawaravAwanuMdi/puswakAlawarvAwanuMdi/puswakAlawaravAwanuMci/puswakAlawarvAwanuMci	n number bahu parsarg waravAwanuMdi 
puswakAlacotunuMci/puswakAlacotunuMdi/puswakAlacotlonuMci/*puswakAlacotlonuMdi/puswakAlacotulonuMci/puswakAlacotulonuMdi	n number bahu parsarg cotlonuMdi 
*puswakAlasWAnamunuMdi/puswakAlasWAnaMnuMdi/puswakAlasWAnamunuMci/puswakAlasWAnaMnuMci/puswakAlasWAnaMlonuMdi/puswakAlasWAnamulonuMdi/puswakAlasWAnaMlonuMci/puswakAlasWAnamulonuMci	n number bahu parsarg sWAnaMnuMdi 
*puswakAlayaMxu/puswakAlaMxu	n number bahu parsarg aMxu 
puswakAlaMte/*puswakAlaMteV	n number bahu parsarg aMte 
*puswakAlakaMteV/puswakAlakaMte/puswakAlakannA/puswakAlakanna	n number bahu parsarg kaMteV 
*puswakAlEna/puswakamulEna	n number bahu parsarg Ena 
*puswakAlapAti/puswakamulapAti	n number bahu parsarg pAti 
puswakAlulAti/*puswakAlulAMti/puswakAlavaMti/puswakamulalAti/puswakamulavaMti	n number bahu parsarg lAMti 
*puswakAlugAnI/puswakAlukAnI/puswakamulugAnI/puswakamulukAnI	n number bahu parsarg gAni 
*puswakAlugA/puswakamulugA	n number bahu parsarg gA 
