noun	
peVnnu	
*peVnnu	n number eka parsarg 0  case d
-	n number eka parsarg I 
-	n number eka parsarg gA 
*peVnnugAdu	n number eka parsarg gAdu  case d
*peVnnugawweV	n number eka parsarg gawweV  case d
*peVnnuvAdu	n number eka parsarg vAdu  case d
*peVnnAyana	n number eka parsarg Ayana  case d
*peVnnuvAru	n number eka parsarg vAru  case d
*peVnnuxi	n number eka parsarg xi  case d
*peVnnuvi	n number eka parsarg vi  case d
*peVnnugAru	n number eka parsarg gAru  case d
*peVnnunu	n number eka parsarg nu 
*peVnnuvu	n number eka parsarg vu  case d
*peVnnuyoVkka	n number eka parsarg yoVkka 
*peVnnu	n number eka parsarg obl 
*peVnnuni/peVnnunu	n number eka parsarg ni 
*peVnnuki/peVnnuku	n number eka parsarg ki 
*peVnnuwo/peVnnuwoda/peVnnuwoti	n number eka parsarg wo 
peVnnulo/peVnnulona/*peVnnulopala	n number eka parsarg lo 
peVnnuloni/*peVnnulopali/peVnnunaMxali	n number eka parsarg loni 
*peVnnumIxa	n number eka parsarg mIxa 
*peVnnuna	n number eka parsarg na 
peVnnuniMci/peVnnunuMci/*peVnnunuMdi	n number eka parsarg niMci 
*peVnnuxvArA	n number eka parsarg xvArA 
*peVnnuvalana/peVnnuvalla	n number eka parsarg valana 
peVnnunubatti/*peVnnunibatti	n number eka parsarg batti 
peVnnuce/*peVnnucewa	n number eka parsarg ce 
*peVnnuwopAtu	n number eka parsarg wopAtu 
peVnnuwokUdi/peVnnuwokUda/*peVnnuwokUdA/peVnnuwogUdi/peVnnuwogUda/peVnnuwogUdA	n number eka parsarg wokUdi 
*peVnnukosaM/peVnnukE/peVnnArWaM	n number eka parsarg kosaM 
*peVnnukoVraku/peVnnukoVrYaku	n number eka parsarg koVraku 
*peVnnulonuMdi/peVnnulonuMci/peVnnuloniMci	n number eka parsarg lonuMdi 
*peVnnumIxanuMdi/peVnnumIxanuMci/peVnnumIxaniMci	n number eka parsarg mIxanuMdi 
*peVnnuxAkA/peVnnuxAka	n number eka parsarg xAkA 
*peVnnuvaraku	n number eka parsarg varaku 
*peVnnumIxaki/peVnnumIxaku/peVnnumIxiki	n number eka parsarg mIxaki 
*peVnnuxaggara/peVnnuxaggira	n number eka parsarg xaggara 
*peVnnuvaxxa/peVnnoVxxa	n number eka parsarg vaxxa 
*peVnnukAda	n number eka parsarg kAda 
*peVnnukeVxurugA/peVnneVxurugA	n number eka parsarg keVxurugA 
*peVnnumuMxu	n number eka parsarg muMxu 
*peVnnuguriMci/peVnnuniguriMci/peVnnunugUrci	n number eka parsarg guriMci 
peVnnupE/*peVnnupEna/peVnnupEni	n number eka parsarg pE 
*peVnnupEki	n number eka parsarg pEki 
*peVnnuguMdA	n number eka parsarg guMdA 
peVnnulA/peVnnulAga/*peVnnulAgA	n number eka parsarg lA 
*peVnnuvale/peVnnumAxiri/peVnnunipolina/peVnnunubolina	n number eka parsarg vale 
*peVnnukimalle/peVnnukumalle/peVnnukimalleV/peVnnukumalleV	n number eka parsarg kimalle 
*peVnnukUdA/peVnnunikUdA/peVnnunukUdA	n number eka parsarg kUdA 
*peVnnuxqRtilo/peVnnuxruRtilo	n number eka parsarg xqRtilo 
*peVnnulekuMdA/peVnnunilekuMdA/peVnnulekuMda/peVnnunulekuMdA	n number eka parsarg lekuMdA 
*peVnnukAkuMdA/peVnnunikAkuMdA/peVnnugAkuMda/peVnnunukAkuMdA/peVnnugAka/peVnnunugAka/peVnnunugAkuMdA	n number eka parsarg kAkuMdA 
*peVnnumoVxalukoVni/peVnnunimoVxalukoVni/peVnnunumoVxalukoVni	n number eka parsarg moVxalukoVni 
*peVnnuvEpu/peVnnuvepu/peVnnukesi	n number eka parsarg vEpu 
peVnnupakka/peVnnuprakka/peVnnupakkana/*peVnnuprakkana/peVnnupakkani	n number eka parsarg pakka 
peVnnupakkalo/*peVnnuprakkalo/peVnnupakkalona/peVnnupakkaloni	n number eka parsarg pakkalo 
peVnnuloki/peVnnuloniki/*peVnnulopalaki/peVnnulopalaku/peVnnulopaliki	n number eka parsarg lopalaki 
peVnnukiMxa/*peVnnukriMxa/peVnnukriMxana/peVnnukiMxana	n number eka parsarg kiMxa 
peVnnaduguna/*peVnnukaduguna	n number eka parsarg aduguna 
peVnnukeVlla/*peVnnukalla	n number eka parsarg kalla 
peVnnuveVnuka/*peVnnuveVnakAla/peVnnuveVnakAwala/peVnnuveVnakana	n number eka parsarg veVnuka 
peVnnuwaravAwa/peVnnuwarvAwa/*peVnnuwaruvAwa/peVnnuwaravAwana/peVnnuwarvAwana/peVnnuwaruvAwana	n number eka parsarg waravAwa 
peVnneVxuruguMdA/*peVnnukeVxuruguMdA	n number eka parsarg eVxuruguMdA 
*peVnnumaXya/peVnnumaXyalo/peVnnumaXyana	n number eka parsarg maXya 
*peVnnunaduma/peVnnunadumuna	n number eka parsarg naduma 
peVnnubaxulugA/peVnnubaxulu/*peVnnukibaxulu/peVnnukubaxulu	n number eka parsarg baxulugA 
*peVnnucotlo/peVnnucotulo/peVnnucotuna/peVnnucotu	n number eka parsarg cotlo 
*peVnnusWAnaMlo/peVnnuswAnaMlo	n number eka parsarg sWAnaMlo 
peVnnunerugA/peVnnukunerugA/*peVnnukinerugA	n number eka parsarg nerugA 
*peVnnuprakAraM/peVnnuprakAramu	n number eka parsarg prakAraM 
*peVnnuxaggaranuMdi/peVnnuxaggaranuMci/peVnnuxaggiranuMdi/peVnnuxaggiranuMci	n number eka parsarg xaggaranuMdi 
*peVnnuvaxxanuMdi/peVnnuvaxxanuMci/peVnnuvaxxaniMci	n number eka parsarg vaxxanuMdi 
*peVnnupakkanuMdi/peVnnupakkanuMci/peVnnupakkaniMci/peVnnupakkalonuMdi/peVnnupakkalonuMci/peVnnupakkaloniMci	n number eka parsarg pakkanuMdi 
*peVnnulopalanuMdi/peVnnulopalanuMci/peVnnulopalaniMci/peVnnulopalinuMdi/peVnnulopalinuMci/peVnnulopaliniMci	n number eka parsarg lopalanuMdi 
*peVnnubEtanuMdi/peVnnubEtanuMci/peVnnubEtaniMci	n number eka parsarg bEtanuMdi 
*peVnnupEnuMdi/peVnnupEnuMci/peVnnupEniMci	n number eka parsarg pEnuMdi 
peVnnukiMxanuMdi/peVnnukiMxanuMci/peVnnukimIxaniMci/*peVnnukriMxanuMdi/peVnnukriMxanuMci/peVnnukriMxaniMci	n number eka parsarg kriMxanuMdi 
peVnnadugunuMdi/peVnnadugunuMci/*peVnnukadugunuMdi/peVnnukadugunuMci/peVnnukaduguniMci	n number eka parsarg adugunuMdi 
*peVnnumuMxunuMdi/peVnnumuMxunuMci/peVnnumuMxuniMci	n number eka parsarg muMxunuMdi 
peVnnuveVnukanuMdi/*peVnnuveVnakAlanuMdi/peVnnuveVnakAwalanuMdi/peVnnuveVnakanuMdi/peVnnuveVnukanuMci/peVnnuveVnakAlanuMci/peVnnuveVnakAwalanuMci/peVnnuveVnakanuMci	n number eka parsarg veVnukanuMdi 
peVnneVxutinuMdi/*peVnnukeVxutinuMdi/peVnnukeVxutinuMci/peVnneVxutinuMci/peVnneVxutanuMdi/peVnneVxutanuMci	n number eka parsarg eVxutinuMdi 
*peVnnumaXyanuMdi/peVnnumaXyanuMci/peVnnumaXyalonuMdi/peVnnumaXyalonuMci	n number eka parsarg maXyanuMdi 
*peVnnunadumanuMdi/peVnnunadumanuMci	n number eka parsarg nadumanuMdi 
*peVnnuwaravAwanuMdi/peVnnuwarvAwanuMdi/peVnnuwaravAwanuMci/peVnnuwarvAwanuMci	n number eka parsarg waravAwanuMdi 
*peVnnucotlonuMdi/peVnnucotunuMdi/peVnnucotlonuMci/peVnnucotunuMci	n number eka parsarg cotlonuMdi 
peVnnusWAnaMnuMdi/*peVnnusWAnamunuMdi/peVnnusWAnaMnuMci/peVnnusWAnamunuMci/peVnnusWAnaMlonuMdi/peVnnusWAnamulonuMdi/peVnnusWAnaMlonuMci/peVnnuswAnamulonuMci	n number eka parsarg sWAnaMnuMdi 
peVnnaMxu/peVnnunaMxu/*peVnnuyaMxu	n number eka parsarg aMxu 
*peVnnaMte/peVnnaMteV	n number eka parsarg aMte 
peVnnukaMteV/*peVnnukaMte/peVnnukanna/peVnnukannA	n number eka parsarg kaMteV 
*peVnnEna	n number eka parsarg Ena 
*peVnnupAti	n number eka parsarg pAti 
*peVnnulAMti/peVnnulAti	n number eka parsarg lAMti 
*peVnnugAnI/peVnnukAnI	n number eka parsarg gAni 
*peVnnugA	n number eka parsarg gA 
*peVnnulu	n number bahu parsarg 0  case d
peVnnulU/peVnnulArA/*peVnnullArA	n number bahu parsarg I  case d
-	n number bahu parsarg gA 
*peVnnulagAdu	n number bahu parsarg gAdu  case d
*peVnnulagawweV	n number bahu parsarg gawweV  case d
*peVnnulavAdu/peVnnulAdu/peVnnulodu	n number bahu parsarg vAdu  case d
*peVnnulAyana	n number bahu parsarg Ayana  case d
*peVnnulavAru/peVnnuloru/peVnnulAru	n number bahu parsarg vAru  case d
*peVnnulaxi/peVnnulxi	n number bahu parsarg xi  case d
*peVnnulavi/peVnnuliy	n number bahu parsarg vi  case d
*peVnnulagAru	n number bahu parsarg gAru  case d
*peVnnulaM/peVnnulamu	n number bahu parsarg nu  case d
*peVnnulu	n number bahu parsarg vu 
*peVnnulayoVkka	n number bahu parsarg yoVkka 
*peVnnula	n number bahu parsarg obl 
*peVnnulani/peVnnulni/peVnnulanu/peVnnulnu	n number bahu parsarg ni 
*peVnnulaki/peVnnulaku	n number bahu parsarg ki 
*peVnnulawo/peVnnulwo/peVnnulawoda/peVnnulawoti/peVnnulwoti/peVnnulwoda	n number bahu parsarg wo 
peVnnulalo/peVnnullo/peVnnulalona/peVnnullona/*peVnnulalopala/peVnnullopala	n number bahu parsarg lo 
peVnnulaloni/peVnnulayaMxali/peVnnulloni/*peVnnulalopali/peVnnullopali	n number bahu parsarg loni 
*peVnnulamIxa	n number bahu parsarg mIxa 
*peVnnulana	n number bahu parsarg na 
peVnnulaniMci/peVnnulniMci/peVnnulanuMci/peVnnulnuMci/*peVnnulanuMdi/peVnnulnuMdi	n number bahu parsarg niMci 
*peVnnulaxvArA/peVnnulaxvAra	n number bahu parsarg xvArA 
*peVnnulavalana/peVnnulavalla	n number bahu parsarg valana 
*peVnnulanubatti/peVnnulnibatti/peVnnulabatti	n number bahu parsarg batti 
*peVnnulacewa/peVnnulcewa/peVnnulace/peVnnulce	n number bahu parsarg ce 
*peVnnulawopAtu/peVnnulwopAtu/peVnnulawobAtu/peVnnulwobAtu	n number bahu parsarg wopAtu 
*peVnnulawokUdi/peVnnulwokUdi/peVnnulawokUda/peVnnulawokUdA/peVnnulwokUdA/peVnnulawogUdi/peVnnulwogUdi/peVnnulawogUda/peVnnulawogUdA/peVnnulwogUdA	n number bahu parsarg wokUdi 
*peVnnulakosaM/peVnnulakE/peVnnulArWaM	n number bahu parsarg kosaM 
*peVnnulakoVraku/peVnnulakoVrYaku	n number bahu parsarg koVraku 
*peVnnulalonuMdi/peVnnulalonuMci/peVnnullonuMdi/peVnnullonuMci/peVnnulloniMci/peVnnulaloniMci	n number bahu parsarg lonuMdi 
*peVnnulamIxanuMdi/peVnnulamIxanuMci/peVnnulamIxaniMci	n number bahu parsarg mIxanuMdi 
*peVnnulaxAkA/peVnnulaxAka	n number bahu parsarg xAkA 
*peVnnulavaraku	n number bahu parsarg varaku 
*peVnnulamIxaki/peVnnulamIxaku/peVnnulamIxiki	n number bahu parsarg mIxaki 
*peVnnulaxaggara/peVnnulaxaggira	n number bahu parsarg xaggara 
*peVnnulavaxxa/peVnnuloVxxa	n number bahu parsarg vaxxa 
*peVnnulakAda	n number bahu parsarg kAda 
peVnnuleVxurugA/*peVnnulakeVxurugA	n number bahu parsarg keVxurugA 
*peVnnulamuMxu	n number bahu parsarg muMxu 
*peVnnulaguriMci/peVnnulagUrci/peVnnulanuguriMci/peVnnulanigUrci	n number bahu parsarg guriMci 
peVnnulapE/peVnnulapEni/*peVnnulapEna	n number bahu parsarg pE 
*peVnnulapEki	n number bahu parsarg pEki 
*peVnnulaguMdA	n number bahu parsarg guMdA 
peVnnulalA/peVnnullA/peVnnulalAga/peVnnullAga/*peVnnullAgA	n number bahu parsarg lA 
*peVnnulavale/peVnnulavaleV/peVnnulamAxiri/peVnnulanupolina/peVnnulanubolina	n number bahu parsarg vale 
*peVnnulakumalle/peVnnulakumalleV	n number bahu parsarg kimalle 
*peVnnulukUdA/peVnnulakUdA/peVnnulugUdA/peVnnulagUdA	n number bahu parsarg kUdA 
*peVnnulaxqRtilo/peVnnulaxruRtilo	n number bahu parsarg xqRtilo 
*peVnnululekuMdA/peVnnullekuMdA	n number bahu parsarg lekuMdA 
*peVnnulukAkuMdA/peVnnulukAkuMda	n number bahu parsarg kAkuMdA 
*peVnnulumoVxalukoVni/peVnnulanumoVxalukoVni	n number bahu parsarg moVxalukoVni 
*peVnnulavEpu/peVnnulavepu/peVnnulakesi	n number bahu parsarg vEpu 
peVnnulapakka/peVnnulapakkana/peVnnulaprakka/*peVnnulaprakkana	n number bahu parsarg pakka 
peVnnulapakkalo/*peVnnulaprakkalo	n number bahu parsarg pakkalo 
peVnnulaloki/peVnnulaloniki/peVnnulalopalaki/*peVnnulalopaliki/peVnnullopaliki/peVnnullopalaku	n number bahu parsarg lopalaki 
peVnnulakiMxa/*peVnnulakriMxa/peVnnulakriMxana/peVnnulakiMxana	n number bahu parsarg kiMxa 
peVnnuladuguna/*peVnnulakaduguna	n number bahu parsarg aduguna 
peVnnulakeVlla/*peVnnulakalla	n number bahu parsarg kalla 
peVnnulaveVnuka/peVnnulaveVnaka/*peVnnulaveVnakAla/peVnnulaveVnukAla/peVnnulaveVnakAwala/peVnnulaveVnukAwala	n number bahu parsarg veVnuka 
*peVnnulawaravAwa/peVnnulawarvAwa/peVnnulwaravAwa	n number bahu parsarg waravAwa 
peVnnuleVxuruguMdA/*peVnnulakeVxuruguMdA	n number bahu parsarg eVxuruguMdA 
*peVnnulamaXya/peVnnulamaXyana/peVnnulamaXyalo	n number bahu parsarg maXya 
*peVnnulanaduma/peVnnulakunaduma	n number bahu parsarg naduma 
peVnnulabaxulugA/peVnnulakibaxulugA/peVnnulabaxulu/*peVnnulakibaxulu	n number bahu parsarg baxulugA 
*peVnnulacotlo/peVnnulacotulo	n number bahu parsarg cotlo 
peVnnulasWAnaMlo/peVnnulaswAnaMlo/*peVnnulasWAnamulo	n number bahu parsarg sWAnaMlo 
peVnnulanerugA/peVnnulakunerugA/*peVnnulakinerugA	n number bahu parsarg nerugA 
*peVnnulaprakAraM/peVnnulanubatti/peVnnulabatti/peVnnulanibatti	n number bahu parsarg prakAraM 
*peVnnulaxaggaranuMdi/peVnnulaxaggiranuMdi/peVnnulaxaggaranuMci/peVnnulaxaggiranuMci	n number bahu parsarg xaggaranuMdi 
*peVnnulavaxxanuMdi/peVnnulavaxxanuMci	n number bahu parsarg vaxxanuMdi 
*peVnnulapakkanuMdi/peVnnulapakkanuMci/peVnnulapakkalonuMdi/peVnnulapakkalonuMci	n number bahu parsarg pakkanuMdi 
*peVnnulalopalanuMdi/peVnnullopalanuMdi/peVnnulalopalanuMci/peVnnullopalanuMci/peVnnullopalinuMdi/peVnnulalopalinuMci	n number bahu parsarg lopalanuMdi 
*peVnnulabEtanuMdi/peVnnulabEtanuMci/peVnnulabEtaniMci	n number bahu parsarg bEtanuMdi 
*peVnnulapEnuMdi/peVnnulapEnuMci/peVnnulapEniMci	n number bahu parsarg pEnuMdi 
peVnnulakiMxanuMdi/peVnnulakiMxanuMci/peVnnulakiMxaniMci/*peVnnulakriMxanuMdi/peVnnulakriMxanuMci/peVnnulakriMxaniMci	n number bahu parsarg kriMxanuMdi 
*peVnnuladugunuMdi/peVnnuladugunuMci/peVnnuladuguniMci	n number bahu parsarg adugunuMdi 
*peVnnulamuMxunuMdi/peVnnulamuMxunuMci/peVnnulamuMxuniMci	n number bahu parsarg muMxunuMdi 
peVnnulaveVnukanuMdi/peVnnulaveVnakanuMdi/*peVnnulaveVnakAlanuMdi/peVnnulaveVnakAlanuMci/peVnnulaveVnukanuMci/peVnnulaveVnakanuMci/peVnnulaveVnakAwalanuMdi/peVnnulaveVnakAwalanuMci	n number bahu parsarg veVnukanuMdi 
peVnnuleVxutinuMdi/peVnnulakeVxutinuMdi/peVnnuleVxutanuMdi/*peVnnulakeVxutanuMdi/peVnnuleVxutinuMci/peVnnulakeVxutinuMci/peVnnuleVxutanuMci/peVnnulakeVxutanuMci	n number bahu parsarg eVxutinuMdi 
*peVnnulamaXyanuMdi/peVnnulamaXyanuMci/peVnnulamaXyaniMci/peVnnulamaXyalonuMdi/peVnnulamaXyalonuMci/peVnnulamaXyaloniMci	n number bahu parsarg maXyanuMdi 
*peVnnulanadumanuMdi/peVnnulanadamanuMdi/peVnnulanadumanuMci/peVnnulanadamanuMci	n number bahu parsarg nadumanuMdi 
*peVnnulawaravAwanuMdi/peVnnulawarvAwanuMdi/peVnnulawaravAwanuMci/peVnnulawarvAwanuMci	n number bahu parsarg waravAwanuMdi 
peVnnulacotnuMci/peVnnulacotunuMdi/*peVnnulacotlonuMci/peVnnulacotloniMci/peVnnulacotulouMdi/peVnnulacotulonuMci	n number bahu parsarg cotlonuMdi 
*peVnnulasWAnamunuMdi/peVnnulasWAnaMnuMdi/peVnnulasWAnamunuMci/peVnnulasWAnaMnuMci/peVnnulasWAnaMlonuMdi/peVnnulasWAnamulonuMdi/peVnnulasWAnaMlonuMci/peVnnulasWAnamulonuMci	n number bahu parsarg sWAnaMnuMdi 
*peVnnulayaMxu/peVnnulaMxu	n number bahu parsarg aMxu 
*peVnnulaMte/peVnnulaMteV	n number bahu parsarg aMte 
*peVnnulakaMteV/peVnnulakaMte/peVnnulakanna/peVnnulakannA	n number bahu parsarg kaMteV 
*peVnnulEna	n number bahu parsarg Ena 
*peVnnulapAti	n number bahu parsarg pAti 
*peVnnulalAMti/peVnnulalAti	n number bahu parsarg lAMti 
*peVnnulugAnI/peVnnulukAnI	n number bahu parsarg gAni 
*peVnnulugA	n number bahu parsarg gA 
