noun	
rAwri	
*rAwri	n number eka parsarg 0 
-	n number eka parsarg I 
-	n number eka parsarg gA 
*rAwrigAdu	n number eka parsarg gAdu 
*rAwrigawweV	n number eka parsarg gawweV 
*rAwrivAdu	n number eka parsarg vAdu 
*rAwrAyana	n number eka parsarg Ayana 
*rAwrivAru	n number eka parsarg vAru 
*rAwrixi	n number eka parsarg xi 
*rAwrivi/rAwriy/rAwriyyi	n number eka parsarg vi 
*rAwrigAru	n number eka parsarg gAru 
*rAwrini	n number eka parsarg nu 
*rAwrivi	n number eka parsarg vu 
*rAwriyoVkka	n number eka parsarg yoVkka 
*rAwri	n number eka parsarg obl 
*rAwrini	n number eka parsarg ni 
*rAwriki/rAwriku	n number eka parsarg ki 
*rAwriwo/rAwriwoda/rAwriwoti	n number eka parsarg wo 
rAwrilo/rAwrilona/*rAwrilopala	n number eka parsarg lo 
rAwriloni/*rAwrilopali/rAwriyaMxali	n number eka parsarg loni 
*rAwrimIxa	n number eka parsarg mIxa 
*rAwrina	n number eka parsarg na 
rAwriniMci/rAwrinuMci/*rAwrinuMdi	n number eka parsarg niMci 
*rAwrixvArA/rAwrixvAra	n number eka parsarg xvArA 
*rAwrivalana/rAwrivalla	n number eka parsarg valana 
*rAwrinibatti/rAwribatti	n number eka parsarg batti 
rAwrice/*rAwricewa	n number eka parsarg ce 
*rAwriwopAtu	n number eka parsarg wopAtu 
*rAwriwokUdi/rAwriwokUda/rAwriwokUdA	n number eka parsarg wokUdi 
*rAwrikosaM/rAwrikE/rAwrArWaM	n number eka parsarg kosaM 
*rAwrikoVraku/rAwrikoVrYaku	n number eka parsarg koVraku 
*rAwrilonuMdi/rAwrilonuMci	n number eka parsarg lonuMdi 
*rAwrimIxanuMdi/rAwrimIxanuMci	n number eka parsarg mIxanuMdi 
*rAwrixAkA/rAwrixAka	n number eka parsarg xAkA 
*rAwrivaraku	n number eka parsarg varaku 
*rAwrimIxaki/rAwrimIxaku	n number eka parsarg mIxaki 
*rAwrixaggara/rAwrixaggira	n number eka parsarg xaggara 
*rAwrivaxxa/rAwroVxxa	n number eka parsarg vaxxa 
*rAwrikAda	n number eka parsarg kAda 
*rAwrikeVxurugA/rAwreVxurugA	n number eka parsarg keVxurugA 
*rAwrimuMxu	n number eka parsarg muMxu 
*rAwriguriMci/rAwriniguriMci/rAwrinigUrci	n number eka parsarg guriMci 
rAwripE/*rAwripEna/rAwripEni	n number eka parsarg pE 
*rAwripEki	n number eka parsarg pEki 
*rAwriguMdA	n number eka parsarg guMdA 
rAwrilA/rAwrilAga/*rAwrilAgA	n number eka parsarg lA 
*rAwrivale/rAwrimAxiri/rAwrinipoli/rAwrivaleV/rAwrinibolina	n number eka parsarg vale 
*rAwrikimalle	n number eka parsarg kimalle 
*rAwrikUdA/rAwrinikUdA	n number eka parsarg kUdA 
*rAwrixqRtilo/rAwrixruRtilo	n number eka parsarg xqRtilo 
*rAwrilekuMdA/rAwrinilekuMdA/rAwrileka	n number eka parsarg lekuMdA 
*rAwrikAkuMdA/rAwrinikAkuMdA/rAwrikAka	n number eka parsarg kAkuMdA 
*rAwrimoVxalukoVni/rAwrinimoVxalukoVni	n number eka parsarg moVxalukoVni 
*rAwrivEpu/rAwrivepu/rAwrikesi	n number eka parsarg vEpu 
rAwripakka/*rAwriprakka/rAwripakkana	n number eka parsarg pakka 
rAwripakkalo/*rAwriprakkalo	n number eka parsarg pakkalo 
rAwriloki/rAwriloniki/*rAwrilopalaki/rAwrilopalaku/rAwrilopaliki	n number eka parsarg lopalaki 
rAwrikiMxa/*rAwrikriMxa/rAwrikriMxana/rAwrikiMxana	n number eka parsarg kiMxa 
rAwraduguna/*rAwrikaduguna	n number eka parsarg aduguna 
rAwrikeVlla/*rAwrikalla	n number eka parsarg kalla 
rAwriveVnuka/*rAwriveVnakAla/rAwriveVnakAwala	n number eka parsarg veVnuka 
rAwriwaravAwa/rAwriwarvAwa/*rAwriwaruvAwa	n number eka parsarg waravAwa 
rAwreVxuruguMdA/*rAwrikeVxuruguMdA	n number eka parsarg eVxuruguMdA 
*rAwrimaXya/rAwrimaXyalo/rAwrimaXyana	n number eka parsarg maXya 
*rAwrinaduma/rAwrinadama	n number eka parsarg naduma 
rAwribaxulugA/rAwribaxulu/*rAwrikibaxulu/rAwrinibaxulu	n number eka parsarg baxulugA 
*rAwricotlo/rAwricotulo/rAwricotuna	n number eka parsarg cotlo 
rAwrisWAnaMlo/*rAwrisWAnamulo	n number eka parsarg sWAnaMlo 
rAwrinerugA/rAwrikunerugA/*rAwrikinerugA	n number eka parsarg nerugA 
*rAwriprakAraM/rAwriprakAramu	n number eka parsarg prakAraM 
*rAwrixaggaranuMdi/rAwrixaggaranuMci/rAwrixaggiranuMdi/rAwrixaggiranuMci	n number eka parsarg xaggaranuMdi 
*rAwrivaxxanuMdi/rAwrivaxxanuMci	n number eka parsarg vaxxanuMdi 
*rAwripakkanuMdi/rAwripakkanuMci/rAwripakkalonuMdi/rAwripakkalonuMci	n number eka parsarg pakkanuMdi 
*rAwrilopalanuMdi/rAwrilopalanuMci/rAwrilopalinuMci/rAwrilopalinuMdi	n number eka parsarg lopalanuMdi 
*rAwribEtanuMdi/rAwribEtanuMci	n number eka parsarg bEtanuMdi 
*rAwripEnuMdi/rAwripEnuMci	n number eka parsarg pEnuMdi 
*rAwrikiMxanuMdi/rAwrikiMxanuMci/*rAwrikriMxanuMdi/rAwrikriMxanuMci	n number eka parsarg kriMxanuMdi 
rAwradugunuMdi/rAwradugunuMci/*rAwrikadugunuMdi/rAwrikadugunuMci	n number eka parsarg adugunuMdi 
*rAwrimuMxunuMdi/rAwrimuMxunuMci	n number eka parsarg muMxunuMdi 
rAwriveVnukanuMdi/*rAwriveVnakAlanuMdi/rAwriveVnakAwalanuMdi/rAwriveVnakanuMdi/rAwriveVnukanuMci/rAwriveVnakAlanuMci/rAwriveVnakAwalanuMci/rAwriveVnakanuMci	n number eka parsarg veVnukanuMdi 
rAwreVxutinuMdi/rAwreVxutanuMdi/*rAwrikeVxutinuMdi/rAwreVxutinuMci/rAwreVxutanuMci/rAwrikeVxutinuMci	n number eka parsarg eVxutinuMdi 
*rAwrimaXyanuMdi/rAwrimaXyanuMci/rAwrimaXyalonuMdi/rAwrimaXyalonuMci	n number eka parsarg maXyanuMdi 
*rAwrinadumanuMdi/rAwrinadumanuMci	n number eka parsarg nadumanuMdi 
*rAwriwaruvAwanuMdi/rAwriwaravAwanuMdi/rAwriwarvAwanuMdi/rAwriwaravAwanuMci/rAwriwarvAwanuMci	n number eka parsarg waravAwanuMdi 
*rAwricotlonuMdi/rAwricotunuMdi/rAwricotlonuMci/rAwricotunuMci	n number eka parsarg cotlonuMdi 
*rAwrisWAnaMnuMdi/rAwriswAnaMnuMdi/rAwrisWAnamunuMci/rAwrisWAnaMnuMci/rAwrisWAnaMlonuMdi/rAwrisWAnamulonuMdi/rAwrisWAnaMlonuMci/rAwriswAnamulonuMci	n number eka parsarg sWAnaMnuMdi 
rAwraMxu/rAwrinaMxu/*rAwriyaMxu	n number eka parsarg aMxu 
*rAwraMte/rAwraMteV	n number eka parsarg aMte 
rAwrikaMteV/*rAwrikaMte/rAwrikanna/rAwrikannA	n number eka parsarg kaMteV 
*rAwrEna/rAwriyEna	n number eka parsarg Ena 
*rAwripAti	n number eka parsarg pAti 
*rAwrilAMti/rAwrilAti	n number eka parsarg lAMti 
*rAwrigAnI/rAwrikAnI	n number eka parsarg gAni 
*rAwrigA	n number eka parsarg gA 
*rAwrilYlYu/rAwrilYlu	n number bahu parsarg 0 
*rAwrilYlYU/rAwrilYlU/rawrilYlulArA	n number bahu parsarg I 
-	n number bahu parsarg gA 
*rAwrilYlYagAdu/rAwrilYlagAdu	n number bahu parsarg gAdu 
*rAwrilYlYagawweV/rAwrilYlagawweV	n number bahu parsarg gawweV 
*rAwrilYlYavAdu/rAwrilYlavAdu	n number bahu parsarg vAdu 
*rAwrilYlYAyana/rAwrilYlAyana	n number bahu parsarg Ayana 
*rAwrilYlYavAru/rAwrilYlavAru	n number bahu parsarg vAru 
*rAwrilYlYaxi/rAwrilYlaxi	n number bahu parsarg xi 
*rAwrilYlYavi/rAwrilYlavi	n number bahu parsarg vi 
*rAwrilYlYagAru/rAwrilYlagAru	n number bahu parsarg gAru 
rAwrilYlamu/rAwrilYlaM/*rAwrilYlYaM	n number bahu parsarg nu 
*rAwrilYlYu/rAwrilYlu	n number bahu parsarg vu 
*rAwrilYlYayoVkka/rAwrilYlayoVkka	n number bahu parsarg yoVkka 
*rAwrilYlYa/rAwrilYla	n number bahu parsarg obl 
*rAwrilYlYani/rAwrilYlani/rAwrilni/rAwrilYlanu	n number bahu parsarg ni 
*rAwrilYlYaki/rAwrilYlaki/rAwrilYlaku	n number bahu parsarg ki 
*rAwrilYlYawo/rAwrilYlawo/rAwrilYlawoda	n number bahu parsarg wo 
*rAwrulalo/rAwrilYlalo/rAwrilYlalona/rAwrilYlalopala	n number bahu parsarg lo 
rAwrilYlaloni/*rAwrilYlYalopali/rAwrilYlalopali/rAwrilYlayaMxali	n number bahu parsarg loni 
*rAwrilYlYamIxa/rAwrilYlamIxa	n number bahu parsarg mIxa 
*rAwrilYlYana/rAwrilYlana	n number bahu parsarg na 
rAwrilYlaniMci/rAwrilYlanuMci/*rAwrilYlYanuMdi/rAwrilYlanuMdi	n number bahu parsarg niMci 
*rAwrilYlYaxvArA/rAwrilYlaxvArA	n number bahu parsarg xvArA 
*rAwrilYlYavalana/rAwrilYlavalana/rAwrilYlavalla	n number bahu parsarg valana 
*rAwrilYlYanubatti/rAwrilYlanubatti/rAwrilYlanibatti	n number bahu parsarg batti 
*rAwrilYlYacewa/rAwrilYlacewa/rAwrilYlace	n number bahu parsarg ce 
*rAwrilYlYawopAtu/rAwrilYlawopAtu/rAwrilYlawobAtu	n number bahu parsarg wopAtu 
*rAwrilYlYawokUdi/rAwrilYlawokUdi/rAwrilYlawokUda/rAwrilYlawokUdA	n number bahu parsarg wokUdi 
*rAwrilYlYakosaM/rAwrilYlakosaM/rAwrilYlakE/rAwrulArWaM	n number bahu parsarg kosaM 
*rAwrilYlYakoVraku/rAwrilYlakoVraku/rAwrilYlakoVrYaku	n number bahu parsarg koVraku 
*rAwrilYlYalonuMdi/rAwrilYlalonuMdi/rAwrilYlalonuMci/rAwrilYlaloniMci	n number bahu parsarg lonuMdi 
*rAwrilYlYamIxanuMdi/rAwrilYlamIxanuMdi/rAwrilYlamIxanuMci	n number bahu parsarg mIxanuMdi 
*rAwrilYlYaxAkA/rAwrilYlaxAkA/rAwrilYlaxAka	n number bahu parsarg xAkA 
*rAwrilYlYavaraku/rAwrilYlavaraku	n number bahu parsarg varaku 
*rAwrilYlYamIxaki/rAwrilYlamIxaki/rAwrilYlamIxaku	n number bahu parsarg mIxaki 
*rAwrilYlYaxaggara/rAwrilYlaxaggara/rAwrilYlaxaggira	n number bahu parsarg xaggara 
*rAwrilYlYavaxxa/rAwrilYlavaxxa	n number bahu parsarg vaxxa 
*rAwrilYlYakAda/rAwrilYlakAda	n number bahu parsarg kAda 
rAwrilYleVxurugA/*rAwrilYlYakeVxurugA/rAwrilYlakeVxurugA	n number bahu parsarg keVxurugA 
*rAwrilYlYamuMxu/rAwrilYlamuMxu	n number bahu parsarg muMxu 
*rAwrilYlYaguriMci/rAwrilYlaguriMci/rAwrilYlagUrci/rAwrilYlanuguriMci/rAwrilYlanigUrci	n number bahu parsarg guriMci 
rAwrilYlapE/rAwrilYlapEni/*rAwrilYlYapEna/rAwrilYlapEna	n number bahu parsarg pE 
*rAwrilYlYapEki/rAwrilYlapEki	n number bahu parsarg pEki 
*rAwrilYlYaguMdA/rAwrilYlaguMdA	n number bahu parsarg guMdA 
rAwrilYlalA/rAwrilYlulA/rAwrilYlalAga/rAwrilYlulAgA/*rAwrilYlYulAgA	n number bahu parsarg lA 
*rAwrilYlYavale/rAwrilYlavale/rAwrilYlavaleV/rAwrilYlamAxiri/rAwrilYlanupolina/rAwrilYlanubolina	n number bahu parsarg vale 
*rAwrilYlYakumalle/rAwrilYlakumalle/rAwrilYlakumalleV	n number bahu parsarg kimalle 
*rAwrilYlYukUdA/rAwrilYlukUdA/rAwrilYugUdA/rAwrilYlagUdA	n number bahu parsarg kUdA 
*rAwrilYlYaxqRtilo/rAwrilYlaxqRtilo/rAwrilYlaxruRtilo	n number bahu parsarg xqRtilo 
*rAwrilYlYulekuMdA/rAwrilYlulekuMdA/rAwrilYluleka/rAwrilYlulekuMda	n number bahu parsarg lekuMdA 
*rAwrilYlYukAkuMdA/rAwrilYlukAkuMdA/rAwrilYlukAkuMda/rAwrilYlukAka/rAwrilYlugAka	n number bahu parsarg kAkuMdA 
*rAwrilYlYumoVxalukoVni/rAwrilYlumoVxalukoVni/rAwrilYlanumoVxalukoVni	n number bahu parsarg moVxalukoVni 
*rAwrilYlYavEpu/rAwrilYlavEpu/rAwrilYlavepu/rAwrilYlakesi	n number bahu parsarg vEpu 
rAwrilYlapakka/rAwrilYlapakkana/rAwrilYlaprakka/*rAwrilYlYaprakkana/rAwrilYlaprakkana	n number bahu parsarg pakka 
rAwrilYlapakkalo/*rAwrilYlYaprakkalo/rAwrilYlaprakkalo	n number bahu parsarg pakkalo 
rAwrilYlaloki/rAwrilYlaloniki/rAwrilYlalopalaku/rAwrilYlalopaliki/*rAwrilYlYalopaliki	n number bahu parsarg lopalaki 
rAwrilYlakiMxa/*rAwrilYlYakriMxa/rAwrilYlakriMxa/rAwrilYlakriMxana/rAwrilYlakiMxana	n number bahu parsarg kiMxa 
rAwrilYladuguna/*rAwrilYlYakaduguna/rAwrilYlakaduguna	n number bahu parsarg aduguna 
rAwrilYlakeVlla/rAwrilYlakalla/rAwrilYlYakalla	n number bahu parsarg kalla 
rAwrilYlaveVnuka/rAwrilYlaveVnaka/*rAwrilYlYaveVnakAla/rAwrilYlaveVnakAla/rAwrilYlaveVnukAla/rAwrilYlaveVnakAwala/rAwrilYlaveVnukAwala	n number bahu parsarg veVnuka 
*rAwrilYlYawaruvAwa/rAwrilYlawaravAwa/rAwrilYlawarvAwa	n number bahu parsarg waravAwa 
rAwrilYleVxuruguMdA/*rAwrilYlYakeVxuruguMdA/rAwrilYlakeVxuruguMdA	n number bahu parsarg eVxuruguMdA 
*rAwrilYlYamaXya/rAwrilYlamaXya/rAwrilYlamaXyana/rAwrilYlamaXyalo	n number bahu parsarg maXya 
*rAwrilYlYanaduma/rAwrilYlanaduma/rAwrilYlakinaduma/rAwrilYlakunaduma	n number bahu parsarg naduma 
rAwrilYlabaxulugA/rAwrilYlakibaxulugA/rAwrilYlabaxulu/*rAwrilYlYakibaxulu/rAwrilYlakibaxulu	n number bahu parsarg baxulugA 
*rAwrilYlYacotlo/rAwrilYlacotlo/rAwrilYlacotulo	n number bahu parsarg cotlo 
rAwrilYlasWAnaMlo/rAwrilYlaswAnaMlo/*rAwrilYlYasWAnamulo/rAwrilYlasWAnamulo	n number bahu parsarg sWAnaMlo 
rAwrilYlanerugA/rAwrilYlakunerugA/*rAwrilYlYakinerugA/rAwrilYlakinerugA	n number bahu parsarg nerugA 
*rAwrilYlYaprakAraM/rAwrilYlaprakAraM/rAwrilYlanubatti/rAwrilYlabatti/rAwrilYlanibatti	n number bahu parsarg prakAraM 
*rAwrilYlYaxaggaranuMdi/rAwrilYlaxaggaranuMdi/rAwrilYlaxaggiranuMdi/rAwrilYlaxaggaranuMci/rAwrilYlaxaggiranuMci	n number bahu parsarg xaggaranuMdi 
*rAwrilYlYavaxxanuMdi/rAwrilYlavaxxanuMdi/rAwrilYlavaxxanuMci	n number bahu parsarg vaxxanuMdi 
*rAwrilYlYapakkanuMdi/rAwrilYlapakkanuMdi/rAwrilYlapakkanuMci/rAwrilYlYapakkalonuMdi/rAwrilYlapakkalonuMdi/rAwrilYlapakkalonuMci	n number bahu parsarg pakkanuMdi 
*rAwrilYlYalopalanuMdi/rAwrilYlalopalanuMdi/rAwrilYlalopalanuMci/rAwrilYlalopalinuMci	n number bahu parsarg lopalanuMdi 
*rAwrilYlYabEtanuMdi/rAwrilYlabEtanuMdi/rAwrilYlabEtanuMci/rAwrilYlabEtaniMci	n number bahu parsarg bEtanuMdi 
*rAwrilYlYapEnuMdi/rAwrilYlapEnuMdi/rAwrilYlapEnuMci/rAwrilYlapEniMci	n number bahu parsarg pEnuMdi 
rAwrilYlYakiMxanuMdi/rAwrilYlakiMxanuMdi/rAwrilYlakiMxanuMci/rAwrilYlakiMxaniMci/*rAwrilYlYakriMxanuMdi/rAwrilYlakriMxanuMdi/rAwrilYlakriMxanuMci/rAwrilYlakriMxaniMci	n number bahu parsarg kriMxanuMdi 
*rAwrilYlYadugunuMdi/rAwrilYladugunuMdi/rAwrilYladugunuMci/rAwrilYladuguniMci	n number bahu parsarg adugunuMdi 
rAwrilYlamuMxunuMdi/*rAwrulYlYamuMxunuMdi/rAwrulYlamuMxunuMdi/rAwrilYlamuMxunuMci	n number bahu parsarg muMxunuMdi 
rAwrilYlaveVnukanuMdi/rAwrilYlaveVnakanuMdi/*rAwrilYlYaveVnakAlanuMdi/rAwrilYlaveVnakAlanuMdi/rAwrilYlYaveVnakAlanuMci/rAwrilYlaveVnakAlanuMci/rAwrilYlaveVnukanuMci/rAwrilYlaveVnakanuMci/rAwrilYlaveVnakAwalanuMdi/rAwrilYlaveVnakAwalanuMci	n number bahu parsarg veVnukanuMdi 
rAwrilYleVxutinuMdi/*rAwrilYlYakeVxutinuMdi/rAwrilYlakeVxutinuMdi/rAwrilYleVxutinuMci/rAwrilYlakeVxutinuMci	n number bahu parsarg eVxutinuMdi 
*rAwrilYlYamaXyanuMdi/rAwrilYlamaXyanuMdi/rAwrilYlamaXyanuMci/rAwrilYlamaXyaniMci/rAwrilYlYamaXyalonuMdi/rAwrilYlamaXyalonuMdi/rAwrilYlamaXyalonuMci/rAwrilYlamaXyaloniMci	n number bahu parsarg maXyanuMdi 
*rAwrilYlYanadumanuMdi/rAwrilYlanadumanuMdi/rAwrilYlanadumanuMci/rAwrilYlanadamanuMci	n number bahu parsarg nadumanuMdi 
*rAwrilYlYawaruvAwanuMdi/rAwrilYlawaravAwanuMdi/rAwrilYlawarvAwanuMdi/rAwrilYlawaravAwanuMci/rAwrilYlawarvAwanuMci	n number bahu parsarg waravAwanuMdi 
rAwrilYlacotunuMdi/rAwrilYlacotunuMci/rAwrilYlacotuniMci/*rAwrilYlYacotlonuMdi/rAwrilYlacotlonuMdi/rAwrilYlacotlonuMci/rAwrilYlacotloniMci	n number bahu parsarg cotlonuMdi 
*rAwrilYlYasWAnamunuMdi/rAwrilYlasWAnamunuMdi/rAwrilYlasWAnaMnuMdi/rAwrilYlasWAnamunuMci/rAwrilYlasWAnaMnuMci/rAwrilYlasWAnaMlonuMdi/rAwrilYlYasWAnamulonuMdi/rAwrilYlasWAnamulonuMdi/rAwrilYlasWAnaMlonuMci/rAwrilYlYasWAnamulonuMci/rAwrilYlasWAnamulonuMci	n number bahu parsarg sWAnaMnuMdi 
*rAwrilYlYayaMxu/rAwrilYlayaMxu/rAwrilYlaMxu	n number bahu parsarg aMxu 
*rAwrilYlYaMte/rAwrilYlaMte/rAwrilYlaMteV	n number bahu parsarg aMte 
rAwrilYlakaMteV/*rAwrilYlYakaMte/rAwrilYlakaMte/rAwrilYlakanna/rawrilYlakannA	n number bahu parsarg kaMteV 
*rAwrilYlYEna/rAwrilYlEna	n number bahu parsarg Ena 
*rAwrilYlYapAti/rAwrilYlapAti	n number bahu parsarg pAti 
*rAwrilYlYalAMti/rAwrilYlalAMti/rAwrilYlalAti	n number bahu parsarg lAMti 
*rAwrilYlYugAnI/rAwrilYlugAnI/rAwrilYlukAnI	n number bahu parsarg gAni 
*rAwrilYlYugA/rAwrilYlugA	n number bahu parsarg gA 
