noun	
rikRA	
*rikRA	n number eka parsarg 0 
-	n number eka parsarg I 
-	n number eka parsarg gA 
*rikRAgAdu	n number eka parsarg gAdu 
*rikRAgawweV	n number eka parsarg gawweV 
*rikRAvAdu	n number eka parsarg vAdu 
*rikRAAyana	n number eka parsarg Ayana 
*rikRAvAru	n number eka parsarg vAru 
*rikRAxi	n number eka parsarg xi 
*rikRAvi	n number eka parsarg vi 
*rikRAgAru	n number eka parsarg gAru 
*rikRAnu	n number eka parsarg nu 
*rikRAvu	n number eka parsarg vu 
*rikRAyoVkka	n number eka parsarg yoVkka 
*rikRA	n number eka parsarg obl 
*rikRAni/rikRAnu	n number eka parsarg ni 
*rikRAki/rikRAku	n number eka parsarg ki 
*rikRAwo/rikRAwoda/rikRAwoti	n number eka parsarg wo 
rikRAlo/rikRAlona/*rikRAlopala	n number eka parsarg lo 
rikRAloni/*rikRAlopali	n number eka parsarg loni 
*rikRAmIxa	n number eka parsarg mIxa 
*rikRAna	n number eka parsarg na 
rikRAniMci/rikRAnuMci/*rikRAnuMdi	n number eka parsarg niMci 
*rikRAxvArA/rikRAxvAra	n number eka parsarg xvArA 
*rikRAvalana/rikRAvalla	n number eka parsarg valana 
*rikRAnubatti/rikRAnibatti	n number eka parsarg batti 
rikRAce/*rikRAcewa	n number eka parsarg ce 
*rikRAwopAtu	n number eka parsarg wopAtu 
*rikRAwokUdi/rikRAwokUda/rikRAwokUdA/rikRAwogUdA/rikRAwogUdi	n number eka parsarg wokUdi 
*rikRAkosaM/rikRAkE/rikRArWaM	n number eka parsarg kosaM 
*rikRAkoVraku/rikRAkoVrYaku	n number eka parsarg koVraku 
*rikRAlonuMdi/rikRAlonuMci/rikRAloniMci	n number eka parsarg lonuMdi 
*rikRAmIxanuMdi/rikRAmIxanuMci/rikRAmIxaniMci/rikRAmIxinuMci	n number eka parsarg mIxanuMdi 
*rikRAxAkA/rikRAxAka	n number eka parsarg xAkA 
*rikRAvaraku	n number eka parsarg varaku 
*rikRAmIxaki/rikRAmIxaku/rikRAmIxiki	n number eka parsarg mIxaki 
*rikRAxaggara/rikRAxaggira	n number eka parsarg xaggara 
*rikRAvaxxa/rikRAyoVxxa	n number eka parsarg vaxxa 
*rikRAkAda	n number eka parsarg kAda 
*rikRAkeVxurugA/rikRAeVxurugA	n number eka parsarg keVxurugA 
*rikRAmuMxu	n number eka parsarg muMxu 
*rikRAguriMci/rikRAniguriMci/rikRAnugUrci	n number eka parsarg guriMci 
rikRApE/*rikRApEna/rikRApEni	n number eka parsarg pE 
*rikRApEki	n number eka parsarg pEki 
*rikRAguMdA	n number eka parsarg guMdA 
rikRAlA/rikRAlAga/*rikRAlAgA/rikRAllA/rikRAllAgA	n number eka parsarg lA 
*rikRAvale/rikRAvaleV/rikRAmAxiri/rikRAnupolina/rikRAnubolina	n number eka parsarg vale 
*rikRAkumalle/rikRAkumalleV	n number eka parsarg kimalle 
*rikRAkUdA/rikRAnikUdA/rikRAnukUdA/rikRAnugUdA	n number eka parsarg kUdA 
*rikRAxqRtilo/rikRAxruRtilo	n number eka parsarg xqRtilo 
*rikRAlekuMdA/rikRAnilekuMdA/rikRAlekuMda/rikRAnulekuMdA	n number eka parsarg lekuMdA 
*rikRAkAkuMdA/rikRAnikAkuMdA/rikRAkAkuMda/rikRAnukAkuMdA	n number eka parsarg kAkuMdA 
*rikRAmoVxalukoVni/rikRAnimoVxalukoVni/rikRAnumoVxalukoVni	n number eka parsarg moVxalukoVni 
*rikRAvEpu/rikRAvepu/rikRAkesi	n number eka parsarg vEpu 
rikRApakka/rikRAprakka/rikRApakkana/*rikRAprakkana/rikRApakkani	n number eka parsarg pakka 
rikRApakkalo/*rikRAprakkalo/rikRApakkalona/rikRApakkaloni	n number eka parsarg pakkalo 
rikRAloki/rkRAloniki/*rikRAlopalaki/rikRAlopalaku/rikRAlopaliki	n number eka parsarg lopalaki 
rikRAkiMxa/*rikRAkriMxa/rikRAkriMxane/rikRAkiMxane	n number eka parsarg kiMxa 
*rikRAkaduguna/rikRAaduguna	n number eka parsarg aduguna 
rikRAkeVlla/*rikRAkalla	n number eka parsarg kalla 
rikRAveVnuka/*rikRAveVnakAla/rikRAveVnakAwala/rikRAveVnakana	n number eka parsarg veVnuka 
rikRAwaravAwa/rikRAwarvAwa/*rikRAwaruvAwa/rikRAwaravAwana/rikRAwarvAwana/rikRAwaruvAwana	n number eka parsarg waravAwa 
rikRAeVxuruguMdA/*rikRAkeVxuruguMdA	n number eka parsarg eVxuruguMdA 
rikRAmaXya/*rikRAmaXyalo/rikRAmaXyana	n number eka parsarg maXya 
*rikRAnaduma/rikRAnadumana	n number eka parsarg naduma 
rikRAbaxulugA/rikRAbaxulu/*rikRAkibaxulu/rikRAkubaxulu	n number eka parsarg baxulugA 
*rikRAcotlo/rikRAcotulo/rikRAcotuna/rikRAcota	n number eka parsarg cotlo 
rikRAsWAnaMlo/rikRAswAnaMlo/*rikRAswAnamulo	n number eka parsarg sWAnaMlo 
rikRAnerugA/rikRAkunerugA/*rikRAkinerugA	n number eka parsarg nerugA 
*rikRAprakAraM/rikRAprakAramu	n number eka parsarg prakAraM 
*rikRAxaggaranuMdi/rikRAxaggaranuMci/rikRAxaggiranuMdi/rikRAxaggiranuMci	n number eka parsarg xaggaranuMdi 
*rikRAvaxxanuMdi/rikRAvaxxanuMci/rikRAvaxxaniMci	n number eka parsarg vaxxanuMdi 
*rikRApakkanuMdi/rikRApakkanuMci/rikRApakkaniMci/rikRApakkalonuMdi/rikRApakkalonuMci/rikRApakkaloniMci	n number eka parsarg pakkanuMdi 
*rikRAlopalanuMdi/rikRAlopalanuMci/rikRAlopalaniMci	n number eka parsarg lopalanuMdi 
*rikRAbEtanuMdi/rikRAbEtanuMci/rikRAbEtaniMci	n number eka parsarg bEtanuMdi 
*rikRApEnuMdi/rikRApEnuMci/rikRApEniMci	n number eka parsarg pEnuMdi 
rikRAkiMxanuMdi/rikRAkiMxanuMci/rikRAkiMxaniMci/*rikRAkriMxanuMdi/rikRAkriMxanuMci/rikRAkriMxaniMci	n number eka parsarg kriMxanuMdi 
rikRAadugunuMdi/rikRAadugunuMci/*rikRAkadugunuMdi/rikRAkadugunuMci/rikRAkaduguniMci	n number eka parsarg adugunuMdi 
*rikRAmuMxunuMdi/rikRAmuMxunuMci/rikRAmuMxuniMci	n number eka parsarg muMxunuMdi 
rikRAveVnukanuMdi/*rikRAveVnakAlanuMdi/rikRAveVnakAwalanuMdi/rikRAveVnakanuMdi/rikRAveVnukanuMci/rikRAveVnakAlanuMci/rikRAveVnakAwalanuMci/rikRAveVnakanuMci	n number eka parsarg veVnukanuMdi 
rikRAeVxutinuMdi/*rikRAkeVxutinuMdi/rikRAkeVxutinuMci/rikRAeVxutinuMci	n number eka parsarg eVxutinuMdi 
*rikRAmaXyanuMdi/rikRAmaXyanuMci/rikRAmaXyalonuMdi/rikRAmaXyalonuMci	n number eka parsarg maXyanuMdi 
*rikRAnadumanuMdi/rikRAnadumanuMci	n number eka parsarg nadumanuMdi 
*rikRAwaruvAwanuMdi/rikRAwaravAwanuMdi/rikRAwarvAwanuMdi/rikRAwaravAwanuMci/rikRAwarvAwanuMci	n number eka parsarg waravAwanuMdi 
*rikRAcotlonuMdi/rikRAcotunuMdi/rikRAcotlonuMci/rikRAcotunuMci	n number eka parsarg cotlonuMdi 
rikRAsWAnaMnuMdi/*rikRAsWAnamunuMdi/rikRAsWAnaMnuMci/rikRAsWAnamunuMci/rikRAsWAnaMlonuMdi/rikRAsWAnamulonuMdi/rikRAsWAnaMlonuMci/rikRAswAnamulonuMci	n number eka parsarg sWAnaMnuMdi 
rikRAnaMxu/*rikRAyaMxu	n number eka parsarg aMxu 
*rikRAaMte/rikRAaMteV	n number eka parsarg aMte 
rikRAkaMteV/*rikRAkaMte/rikRAkanna/rikRAkannA	n number eka parsarg kaMteV 
rikRAEna/*rikRAayina	n number eka parsarg Ena 
*rikRApAti	n number eka parsarg pAti 
*rikRAlAMti/rikRAlAti	n number eka parsarg lAMti 
*rikRAgAnI/rikRAkAnI	n number eka parsarg gAni 
*rikRAgA	n number eka parsarg gA 
*rikRAlu	n number bahu parsarg 0 
rikRAlU/*rikRAlArA	n number bahu parsarg I 
-	n number bahu parsarg gA 
*rikRAlagAdu	n number bahu parsarg gAdu 
*rikRAlagawweV	n number bahu parsarg gawweV 
*rikRAlavAdu/rikRAlodu	n number bahu parsarg vAdu 
*rikRAlAyana	n number bahu parsarg Ayana 
*rikRAlavAru/rikRAloru	n number bahu parsarg vAru 
rikRAlxi/*rikRAlaxi	n number bahu parsarg xi 
*rikRAlavi/rikRAliy	n number bahu parsarg vi 
*rikRAlagAru	n number bahu parsarg gAru 
rikRAlamu/*rikRAlaM	n number bahu parsarg nu 
*rikRAlu	n number bahu parsarg vu 
*rikRAlayoVkka	n number bahu parsarg yoVkka 
*rikRAla	n number bahu parsarg obl 
*rikRAlani/rikRAlni/rikRAlanu/rikRAlnu	n number bahu parsarg ni 
*rikRAlaki/rikRAlaku	n number bahu parsarg ki 
*rikRAlawo/rikRAlwo/rikRAlawoda/rikRAlawoti/rikRAlwoti/rikRAlwoda	n number bahu parsarg wo 
rikRAlalo/rikRAllo/rikRAlalona/rikRAllona/*rikRAlalopala/rikRAllopala	n number bahu parsarg lo 
rikRAlaloni/rikRAlayaMxali/rikRAlloni/*rikRAlalopali/rikRAllopali	n number bahu parsarg loni 
*rikRAlamIxa	n number bahu parsarg mIxa 
*rikRAlana	n number bahu parsarg na 
rikRAlaniMci/rikRAlniMci/rikRAlanuMci/rikRAlnuMci/*rikRAlanuMdi/rikRAlnuMdi	n number bahu parsarg niMci 
*rikRAlaxvArA/rikRAlaxvAra	n number bahu parsarg xvArA 
*rikRAlavalana/rikRAlavalla	n number bahu parsarg valana 
*rikRalanubatti/rikRAlanibatti/rikRalnibatti	n number bahu parsarg batti 
*rikRAlacewa/rikRAlcewa/rikRAlace/rikRAlce	n number bahu parsarg ce 
*rikRAlawopAtu/rikRAlwopAtu/rikRAlawobAtu/rikRAlwobAtu	n number bahu parsarg wopAtu 
*rikRAlawokUdi/rikRAlwokUdi/rikRAlawokUda/rikRAlawokUdA/rikRAlwokUdA	n number bahu parsarg wokUdi 
*rikRAlakosaM/rikRAlakE/rikRAlArWaM	n number bahu parsarg kosaM 
*rikRAlakoVraku/rikRAlakoVrYaku	n number bahu parsarg koVraku 
*rikRAlalonuMdi/rikRAlalonuMci/rikRAllonuMdi/rikRAllonuMci/rikRAlloniMci/rikRAlaloniMci	n number bahu parsarg lonuMdi 
*rikRAlamIxanuMdi/rikRAlamIxanuMci/rikRAlamIxaniMci	n number bahu parsarg mIxanuMdi 
*rikRAlaxAkA/rikRAlaxAka	n number bahu parsarg xAkA 
*rikRAlavaraku	n number bahu parsarg varaku 
*rikRAlamIxaki/rikRAlamIxaku/rikRAlamIxiki	n number bahu parsarg mIxaki 
*rikRAlaxaggara/rikRAlaxaggira	n number bahu parsarg xaggara 
*rikRAlavaxxa/rikRAloVxxa	n number bahu parsarg vaxxa 
*rikRAlakAda	n number bahu parsarg kAda 
rikRAleVxurugA/*rikRAlakeVxurugA	n number bahu parsarg keVxurugA 
*rikRAlamuMxu	n number bahu parsarg muMxu 
*rikRAlaguriMci/rikRAlnugUrci/rikRAlanuguriMci/rikRAlnigUrci/rikRAlnuguriMci	n number bahu parsarg guriMci 
rikRAlapE/rikRAlapEni/*rikRAlapEna	n number bahu parsarg pE 
*rikRAlapEki	n number bahu parsarg pEki 
*rikRAlaguMdA	n number bahu parsarg guMdA 
rikRAlalA/rikRAllA/rikRAlulA/rikRAlulAgA/rikRAlalAga/*rikRAllAga/rikRAllAgA	n number bahu parsarg lA 
*rikRAlavale/rikRAlavaleV/rikRAlamAxiri/rikRAlanupolina/rikRAlnibolina	n number bahu parsarg vale 
*rikRAlakumalle/rikRAlakumalleV	n number bahu parsarg kimalle 
*rikRAlukUdA/rikRAlugUdA/rikRAlnigUdA	n number bahu parsarg kUdA 
*rikRAlaxqRtilo/rikRAlaxruRtilo	n number bahu parsarg xqRtilo 
*rikRAlulekuMdA/rikRAllekuMdA	n number bahu parsarg lekuMdA 
*rikRAlukAkuMdA/rikRAlukAkuMda	n number bahu parsarg kAkuMdA 
*rikRAlumoVxalukoVni/rikRAlanumoVxalukoVni	n number bahu parsarg moVxalukoVni 
*rikRAlavEpu/rikRAlavepu/rikRAlakesi	n number bahu parsarg vEpu 
rikRAlapakka/rikRAlapakkana/rikRAlaprakka/*rikRAlaprakkana	n number bahu parsarg pakka 
rikRAlapakkalo/*rikRAlaprakkalo	n number bahu parsarg pakkalo 
rikRAlaloki/rikRAlloki/rikRAlaloniki/rikRAlloniki/*rikRAlalopalaki/rikRAlalopaliki/rikRAllopaliki/rikRAllopalaku	n number bahu parsarg lopalaki 
rikRAlakiMxa/*rikRAlakriMxa/rikRAlakriMxane/rikRAlakiMxane	n number bahu parsarg kiMxa 
rikRAladuguna/*rikRAlakaduguna	n number bahu parsarg aduguna 
rikRAlakeVlla/*rikRAlakalla	n number bahu parsarg kalla 
rikRAlaveVnuka/rikRAlaveVnaka/*rikRAlaveVnakAla/rikRAlaveVnukAla/rikRAlaveVnakAwala/rikRAlaveVnukAwala	n number bahu parsarg veVnuka 
*rikRAlawaruvAwa/rikRAlawaravAwa/rikRAlawarvAwa/rikRAlwaravAwa	n number bahu parsarg waravAwa 
rikRAleVxuruguMdA/*rikRAlakeVxuruguMdA	n number bahu parsarg eVxuruguMdA 
*rikRAlamaXya/rikRAlamaXyana/rikRAlamaXyalo	n number bahu parsarg maXya 
*rikRAlanaduma/rikRAlakinaduma	n number bahu parsarg naduma 
rikRAlabaxulugA/rikRAlakibaxulugA/rikRAlabaxulu/*rikRAlakibaxulu	n number bahu parsarg baxulugA 
*rikRAlacotlo/rikRAlacotulo	n number bahu parsarg cotlo 
rikRAlasWAnaMlo/rikRAlaswAnaMlo/*rikRAlasWAnamulo	n number bahu parsarg sWAnaMlo 
rikRAlanerugA/rikRAlakunerugA/*rikRAlakinerugA	n number bahu parsarg nerugA 
*rikRAlaprakAraM/rikRAlanubatti/rikRAlabatti/rikRAlanibatti	n number bahu parsarg prakAraM 
*rikRAlaxaggaranuMdi/rikRAlaxaggiranuMdi/rikRAlaxaggaranuMci/rikRAlaxaggiranuMci	n number bahu parsarg xaggaranuMdi 
*rikRAlavaxxanuMdi/rikRAlavaxxanuMci	n number bahu parsarg vaxxanuMdi 
*rikRAlapakkanuMdi/rikRAlapakkanuMci/rikRAlapakkalonuMdi/rikRAlapakkalonuMci	n number bahu parsarg pakkanuMdi 
*rikRAlalopalanuMdi/rikRAllopalanuMdi/rikRAlalopalanuMci/rikRAllopalanuMci/rikRAllopalinuMdi/rikRAlalopalinuMci	n number bahu parsarg lopalanuMdi 
*rikRAlabEtanuMdi/rikRAlabEtanuMci/rikRAlabEtaniMci	n number bahu parsarg bEtanuMdi 
*rikRAlapEnuMdi/rikRAlapEnuMci/rikRAlapEniMci	n number bahu parsarg pEnuMdi 
rikRAlakiMxanuMdi/rikRAlakiMxanuMci/rikRAlakiMxaniMci/*rikRAlakriMxanuMdi/rikRAlakriMxanuMci/rikRAlakriMxaniMci	n number bahu parsarg kriMxanuMdi 
*rikRAladugunuMdi/rikRAladugunuMci/rikRAladuguniMci	n number bahu parsarg adugunuMdi 
*rikRAlamuMxunuMdi/rikRAlamuMxunuMci/rikRAlamuMxuniMci	n number bahu parsarg muMxunuMdi 
*rikRAlaveVnukanuMdi/rikRAlaveVnakanuMdi/rikRAlaveVnakAlanuMdi/rikRAlaveVnakAlanuMci/rikRAlaveVnukanuMci/rikRAlaveVnakanuMci/rikRAlaveVnakAwalanuMdi/rikRAlaveVnakAwalanuMci	n number bahu parsarg veVnukanuMdi 
rikRAleVxutinuMdi/*rikRAlakeVxutinuMdi/rikRAleVxutinuMci/rikRAlakeVxutinuMci	n number bahu parsarg eVxutinuMdi 
*rikRAlamaXyanuMdi/rikRAlamaXyanuMci/rikRAlamaXyaniMci/rikRAlamaXyalonuMdi/rikRAlamaXyalonuMci/rikRAlamaXyaloniMci	n number bahu parsarg maXyanuMdi 
*rikRAlanadumanuMdi/rikRAlanadamanuMdi/rikRAlanadumanuMci/rikRAlanadamanuMci	n number bahu parsarg nadumanuMdi 
*rikRAlawaruvAwanuMdi/rikRAlawaravAwanuMdi/rikRAlawarvAwanuMdi/rikRAlawaravAwanuMci/rikRAlawarvAwanuMci	n number bahu parsarg waravAwanuMdi 
rikRAlacotunuMdi/rikRAlacotunuMci/rikRAlacotuniMci/*rikRAlacotlonuMdi/rikRAlacotloniMci/rikRAlacotlonuMci	n number bahu parsarg cotlonuMdi 
*rikRAlasWAnamunuMdi/rikRAlasWAnaMnuMdi/rikRAlasWAnamunuMci/rikRAlasWAnaMnuMci/rikRAlasWAnaMlonuMdi/rikRAlasWAnamulonuMdi/rikRAlasWAnaMlonuMci/rikRAlasWAnamulonuMci/rikRAlasWAnaMloniMci/rikRAlasWAnamuloniMci	n number bahu parsarg sWAnaMnuMdi 
*rikRAlayaMxu/rikRAlaMxu	n number bahu parsarg aMxu 
*rikRAlaMte/rikRAlaMteV	n number bahu parsarg aMte 
rikRAlakaMteV/*rikRAlakaMte/rikRAlakanna/rikRAlakannA	n number bahu parsarg kaMteV 
*rikRAlEna	n number bahu parsarg Ena 
*rikRAlapAti	n number bahu parsarg pAti 
*rikRAlalAMti/rikRAlalAti	n number bahu parsarg lAMti 
*rikRAlugAnI/rikRAlukAnI	n number bahu parsarg gAni 
*rikRAlugA	n number bahu parsarg gA 
