noun	
rANi	
*rANi	n number eka parsarg 0  case d
-	n number eka parsarg I 
-	n number eka parsarg gA 
*rANigAdu	n number eka parsarg gAdu  case d
*rANigawweV	n number eka parsarg gawweV  case d
*rANivAdu	n number eka parsarg vAdu  case d
*rANAyana	n number eka parsarg Ayana  case d
*rANivAru	n number eka parsarg vAru  case d
*rANixi	n number eka parsarg xi  case d
*rANivi/rANiy	n number eka parsarg vi  case d
*rANigAru	n number eka parsarg gAru  case d
*rANini	n number eka parsarg nu 
*rANivi	n number eka parsarg vu  case d
*rANiyoVkka	n number eka parsarg yoVkka 
*rANi	n number eka parsarg obl 
*rANini/rANinu	n number eka parsarg ni 
*rANiki/rANiku	n number eka parsarg ki 
*rANiwo/rANiwoda/rANiwoti	n number eka parsarg wo 
rANilo/rANilona/*rANilopala	n number eka parsarg lo 
rANiloni/*rANilopali/rANiyaMxali	n number eka parsarg loni 
*rANimIxa	n number eka parsarg mIxa 
*rANina	n number eka parsarg na 
rANiniMci/rANinuMci/*rANinuMdi	n number eka parsarg niMci 
*rANixvArA/rANixvAra	n number eka parsarg xvArA 
*rANivalana/rANivalla	n number eka parsarg valana 
*rANinibatti	n number eka parsarg batti 
rANice/*rANicewa	n number eka parsarg ce 
*rANiwopAtu	n number eka parsarg wopAtu 
*rANiwokUdi/rANiwokUda/rANiwokUdA/rANiwogUdi/rANiwogUda/rANiwogUdA	n number eka parsarg wokUdi 
*rANikosaM/rANikE/rANArWaM	n number eka parsarg kosaM 
*rANikoVraku/rANikoVrYaku	n number eka parsarg koVraku 
*rANilonuMdi/rANilonuMci/rANiloniMci	n number eka parsarg lonuMdi 
*rANimIxanuMdi/rANimIxanuMci/rANimIxaniMci	n number eka parsarg mIxanuMdi 
*rANixAkA/rANixAka	n number eka parsarg xAkA 
*rANivaraku	n number eka parsarg varaku 
*rANimIxaki/rANimIxaku/rANimIxiki	n number eka parsarg mIxaki 
*rANixaggara/rANixaggira	n number eka parsarg xaggara 
*rANivaxxa/rANoVxxa	n number eka parsarg vaxxa 
*rANikAda	n number eka parsarg kAda 
*rANikeVxurugA/rANeVxurugA	n number eka parsarg keVxurugA 
*rANimuMxu	n number eka parsarg muMxu 
*rANiguriMci/rANiniguriMci/rANinigUrci	n number eka parsarg guriMci 
rANipE/*rANipEna/rANipEni	n number eka parsarg pE 
*rANipEki	n number eka parsarg pEki 
*rANiguMdA	n number eka parsarg guMdA 
rANilA/rANilAga/*rANilAgA	n number eka parsarg lA 
*rANivale/rANimAxiri/rANinipoli/rANinuboli	n number eka parsarg vale 
*rANikimalle/rANikumalle	n number eka parsarg kimalle 
*rANikUdA/rANinikUdA/rANigUdA/rANinigUdA	n number eka parsarg kUdA 
*rANixqRtilo/rANixruRtilo	n number eka parsarg xqRtilo 
*rANilekuMdA/rANinilekuMdA/rANileka/rANilekuMda	n number eka parsarg lekuMdA 
*rANikAkuMdA/rANinikAkuMdA/rANikAka/rANigAka	n number eka parsarg kAkuMdA 
*rANimoVxalukoVni/rANinimoVxalukoVni/rANinumoVxalukoVni	n number eka parsarg moVxalukoVni 
*rANivEpu/rANivepu/rANikesi	n number eka parsarg vEpu 
rANipakka/rANiprakka/rANipakkana/*rANiprakkana/rANipakkani	n number eka parsarg pakka 
rANipakkalo/*rANiprakkalo/rANipakkalona/rANipakkaloni	n number eka parsarg pakkalo 
*rANiloki/rANiloniki/rANilopalaki/rANilopalaku/rANilopaliki	n number eka parsarg lopalaki 
rANikiMxa/*rANikriMxa/rANikriMxane/rANikiMxane	n number eka parsarg kiMxa 
rANaduguna/*rANikaduguna	n number eka parsarg aduguna 
rANikeVlla/*rANikalla	n number eka parsarg kalla 
rANiveVnuka/*rANiveVnakAla/rANiveVnakAwala/rANiveVnakana	n number eka parsarg veVnuka 
rANiwaravAwa/rANiwarvAwa/*rANiwaruvAwa/rANiwaravAwana/rANiwarvAwana/rANiwaruvAwana	n number eka parsarg waravAwa 
rANeVxuruguMdA/*rANikeVxuruguMdA	n number eka parsarg eVxuruguMdA 
rANimaXya/*rANimaXyalo/rANimaXyana	n number eka parsarg maXya 
*rANinaduma/rANinadumana	n number eka parsarg naduma 
rANibaxulugA/rANibaxulu/*rANikibaxulu/rANikubaxulu	n number eka parsarg baxulugA 
*rANicotlo/rANicotulo/rANicotuna/rANicota	n number eka parsarg cotlo 
rANisWAnaMlo/rANiswAnaMlo/*rANisWAnamulo	n number eka parsarg sWAnaMlo 
rANinerugA/rANikunerugA/*rANikinerugA	n number eka parsarg nerugA 
*rANiprakAraM/rANiprakAramu	n number eka parsarg prakAraM 
*rANixaggaranuMdi/rANixaggaranuMci/rANixaggiranuMdi/rANixaggiranuMci	n number eka parsarg xaggaranuMdi 
*rANivaxxanuMdi/rANivaxxanuMci/rANivaxxaniMci	n number eka parsarg vaxxanuMdi 
*rANipakkanuMdi/rANipakkanuMci/rANipakkaniMci/rANipakkalonuMdi/rANipakkalonuMci/rANipakkaloniMci	n number eka parsarg pakkanuMdi 
*rANilopalanuMdi/rANilopalanuMci/rANilopalaniMci	n number eka parsarg lopalanuMdi 
*rANibEtanuMdi/rANibEtanuMci/rANibEtaniMci	n number eka parsarg bEtanuMdi 
*rANipEnuMdi/rANipEnuMci/rANipEniMci	n number eka parsarg pEnuMdi 
*rANikiMxanuMdi/rANikiMxanuMci/rANikiMxaniMci/rANikriMxanuMdi/rANikriMxanuMci/rANikriMxaniMci	n number eka parsarg kriMxanuMdi 
rANadugunuMdi/rANadugunuMci/*rANikadugunuMdi/rANikadugunuMci/rANikaduguniMci	n number eka parsarg adugunuMdi 
*rANimuMxunuMdi/rANimuMxunuMci/rANimuMxuniMci	n number eka parsarg muMxunuMdi 
rANiveVnukanuMdi/*rANiveVnakAlanuMdi/rANiveVnakAwalanuMdi/rANiveVnakanuMdi/rANiveVnukanuMci/rANiveVnakAlanuMci/rANiveVnakAwalanuMci/rANiveVnakanuMci	n number eka parsarg veVnukanuMdi 
rANeVxutinuMdi/*rANikeVxutinuMdi/rANikeVxutinuMci/rANeVxutinuMci	n number eka parsarg eVxutinuMdi 
*rANimaXyanuMdi/rANimaXyanuMci/rANimaXyalonuMdi/rANimaXyalonuMci	n number eka parsarg maXyanuMdi 
*rANinadumanuMdi/rANinadumanuMci	n number eka parsarg nadumanuMdi 
*rANiwaravAwanuMdi/rANiwarvAwanuMdi/rANiwaravAwanuMci/rANiwarvAwanuMci	n number eka parsarg waravAwanuMdi 
*rANicotlonuMdi/rANicotunuMdi/rANicotlonuMci/rANicotunuMci	n number eka parsarg cotlonuMdi 
rANisWAnaMnuMdi/*rANisWAnamunuMdi/rANisWAnaMnuMci/rANisWAnamunuMci/rANisWAnaMlonuMdi/rANisWAnamulonuMdi/rANisWAnaMlonuMci/rANiswAnamulonuMci	n number eka parsarg sWAnaMnuMdi 
rANaMxu/rANinaMxu/*rANiyaMxu	n number eka parsarg aMxu 
rANaMte/*rANaMteV	n number eka parsarg aMte 
*rANikaMteV/rANikaMte/rANikannA/rANikanna	n number eka parsarg kaMteV 
*rANEna/rANiyEna	n number eka parsarg Ena 
*rANipAti	n number eka parsarg pAti 
*rANilAMti/rANilAti	n number eka parsarg lAMti 
*rANigAnI/rANikAnI	n number eka parsarg gAni 
*rANigA	n number eka parsarg gA 
*rANulu	n number bahu parsarg 0  case d
rANulU/rANululArA/*rANullArA	n number bahu parsarg I  case d
-	n number bahu parsarg gA 
*rANulagAdu	n number bahu parsarg gAdu  case d
*rANulagawweV	n number bahu parsarg gawweV  case d
*rANulavAdu/rANilodu	n number bahu parsarg vAdu  case d
*rANulAyana	n number bahu parsarg Ayana  case d
*rANulavAru/rANiloru	n number bahu parsarg vAru  case d
rANulaxi/rANulxi	n number bahu parsarg xi  case d
*rANulavi/rANulay/rANuliy	n number bahu parsarg vi  case d
*rANulagAru	n number bahu parsarg gAru  case d
*rANulaM/rANulamu	n number bahu parsarg nu  case d
*rANulu	n number bahu parsarg vu 
*rANulayoVkka	n number bahu parsarg yoVkka 
*rANula	n number bahu parsarg obl 
*rANulani/rANulni/rANulanu/rANulnu	n number bahu parsarg ni 
*rANulaki/rANulaku	n number bahu parsarg ki 
*rANulawo/rANulwo/rANulawoda/rANulawoti/rANulwoti/rANulwoda	n number bahu parsarg wo 
*rANulalo/rANullo/rANulalona/rANullona/rANulalopala/rANullopala	n number bahu parsarg lo 
*rANulaloni/rANulayaMxali/rANulloni/rANulalopali/rANullopali	n number bahu parsarg loni 
*rANulamIxa	n number bahu parsarg mIxa 
*rANulana	n number bahu parsarg na 
rANulaniMci/rANulniMci/rANulanuMci/rANulnuMci/*rANulanuMdi/rANulnuMdi	n number bahu parsarg niMci 
*rANulaxvArA/rANulaxvAra	n number bahu parsarg xvArA 
*rANulavalana/rANulavalla	n number bahu parsarg valana 
*rANulanubatti/rANulnibatti/rANulanibatti	n number bahu parsarg batti 
*rANulacewa/rANulcewa/rANulace/rANulce	n number bahu parsarg ce 
*rANulawopAtu/rANulwopAtu	n number bahu parsarg wopAtu 
*rANulawokUdi/rANulwokUdi/rANulawogUdi/rANulawokUdA/rANulawogUdA/rANulwogUdA	n number bahu parsarg wokUdi 
*rANulakosaM/rANulakE/rANulArWaM	n number bahu parsarg kosaM 
*rANulakoVraku/rANulakoVrYaku	n number bahu parsarg koVraku 
*rANulalonuMdi/rANulalonuMci/rANullonuMdi/rANullonuMci/rANulloniMci/rANulaloniMci	n number bahu parsarg lonuMdi 
*rANulamIxanuMdi/rANulamIxanuMci/rANulamIxaniMci	n number bahu parsarg mIxanuMdi 
*rANulaxAkA/rANulaxAka	n number bahu parsarg xAkA 
*rANulavaraku	n number bahu parsarg varaku 
*rANulamIxaki/rANulamIxaku/rANulamIxiki	n number bahu parsarg mIxaki 
*rANulaxaggara/rANulaxaggira	n number bahu parsarg xaggara 
*rANulavaxxa/rANuloVxxa	n number bahu parsarg vaxxa 
*rANulakAda	n number bahu parsarg kAda 
rANuleVxurugA/*rANulakeVxurugA	n number bahu parsarg keVxurugA 
*rANulamuMxu	n number bahu parsarg muMxu 
*rANulaguriMci/rANulagUrci/rANulanuguriMci/rANulanigUrci	n number bahu parsarg guriMci 
rANulapE/rANulapEni/*rANulapEna	n number bahu parsarg pE 
*rANulapEki	n number bahu parsarg pEki 
*rANulaguMdA	n number bahu parsarg guMdA 
rANulalA/rANullA/rANulalAga/*rANullAga/rANullAgA	n number bahu parsarg lA 
rANulavale/*rANulavaleV/rANulamAxiri/rANulanupolina/rANulanubolina	n number bahu parsarg vale 
rANulakumalle/*rANulakumalleV	n number bahu parsarg kimalle 
*rANulukUdA/rANulakUdA/rANulugUdA/rANulugUda	n number bahu parsarg kUdA 
*rANulaxqRtilo/rANulaxruRtilo	n number bahu parsarg xqRtilo 
*rANululekuMdA/rANullekuMdA/rANululeka/rANulleka	n number bahu parsarg lekuMdA 
*rANulukAkuMdA/rANulukAkuMda/rANulukAka/rANulugAka	n number bahu parsarg kAkuMdA 
*rANulumoVxalukoVni/rANulanumoVxalukoVni	n number bahu parsarg moVxalukoVni 
*rANulavEpu/rANulavepu/rANulakesi	n number bahu parsarg vEpu 
rANulapakka/rANulapakkana/rANulaprakka/*rANulaprakkana	n number bahu parsarg pakka 
rANulapakkalo/*rANulaprakkalo	n number bahu parsarg pakkalo 
*rANulaloki/rANulaloniki/rANulloki/rANulloniki/rANulalopalaki/rANulalopaliki/rANullopaliki/rANullopalaku	n number bahu parsarg lopalaki 
rANulakiMxa/*rANulakriMxa/rANulakriMxane/rANulakiMxane	n number bahu parsarg kiMxa 
rANuladuguna/*rANulakaduguna	n number bahu parsarg aduguna 
*rANulakeVlla/rANulakalla	n number bahu parsarg kalla 
rANulaveVnuka/rANulaveVnaka/*rANulaveVnakAla/rANulaveVnukAla/rANulaveVnakAwala/rANulaveVnukAwala	n number bahu parsarg veVnuka 
*rANulawaravAwa/rANulawarvAwa/rANulwaravAwa	n number bahu parsarg waravAwa 
rANuleVxuruguMdA/*rANulakeVxuruguMdA	n number bahu parsarg eVxuruguMdA 
*rANulamaXya/rANulamaXyana/rANulamaXyalo	n number bahu parsarg maXya 
*rANulanaduma/rANulakinaduma	n number bahu parsarg naduma 
rANulabaxulugA/rANulakibaxulugA/rANulabaxulu/*rANulakibaxulu	n number bahu parsarg baxulugA 
*rANulacotlo/rANulacotulo	n number bahu parsarg cotlo 
rANulasWAnaMlo/rANulaswAnaMlo/*rANulasWAnamulo	n number bahu parsarg sWAnaMlo 
rANulanerugA/rANulakunerugA/*rANulakinerugA	n number bahu parsarg nerugA 
*rANulaprakAraM/rANulanubatti/rANulabatti/rANulanibatti	n number bahu parsarg prakAraM 
*rANulaxaggaranuMdi/rANulaxaggiranuMdi/rANulaxaggaranuMci/rANulaxaggiranuMci	n number bahu parsarg xaggaranuMdi 
*rANulavaxxanuMdi/rANulavaxxanuMci	n number bahu parsarg vaxxanuMdi 
*rANulapakkanuMdi/rANulapakkanuMci/rANulapakkalonuMdi/rANulapakkalonuMci	n number bahu parsarg pakkanuMdi 
*rANulalopalanuMdi/rANullopalanuMdi/rANulalopalanuMci/rANullopalanuMci/rANullopalinuMdi/rANulalopalinuMci	n number bahu parsarg lopalanuMdi 
*rANulabEtanuMdi/rANulabEtanuMci/rANulabEtaniMci	n number bahu parsarg bEtanuMdi 
*rANulapEnuMdi/rANulapEnuMci/rANulapEniMci	n number bahu parsarg pEnuMdi 
rANulakiMxanuMdi/rANulakiMxanuMci/rANulakiMxaniMci/*rANulakriMxanuMdi/rANulakriMxanuMci/rANulakriMxaniMci	n number bahu parsarg kriMxanuMdi 
*rANuladugunuMdi/rANuladugunuMci/rANuladuguniMci	n number bahu parsarg adugunuMdi 
*rANulamuMxunuMdi/rANulamuMxunuMci/rANulamuMxuniMci	n number bahu parsarg muMxunuMdi 
rANulaveVnukanuMdi/rANulaveVnakanuMdi/*rANulaveVnakAlanuMdi/rANulaveVnakAlanuMci/rANulaveVnukanuMci/rANulaveVnakanuMci/rANulaveVnakAwalanuMci/rANulaveVnakAwalanuMci	n number bahu parsarg veVnukanuMdi 
rANuleVxutinuMdi/*rANulakeVxutinuMdi/rANuleVxutinuMci/rANulakeVxutinuMci	n number bahu parsarg eVxutinuMdi 
*rANulamaXyanuMdi/rANulamaXyanuMci/rANulamaXyaniMci/rANulamaXyalonuMdi/rANulamaXyalonuMci/rANulamaXyaloniMci	n number bahu parsarg maXyanuMdi 
*rANulanadumanuMdi/rANulanadamanuMdi/rANulanadumanuMci/rANulanadamanuMci	n number bahu parsarg nadumanuMdi 
*rANulawaravAwanuMdi/rANulawarvAwanuMdi/rANulawaravAwanuMci/rANulawarvAwanuMci	n number bahu parsarg waravAwanuMdi 
rANulacotunuMci/rANulacotunuMdi/rANulacotlonuMci/rANulacotloniMci/rANulacotulonuMci/rANulacotulonuMdi/*rANulacotlonuMdi	n number bahu parsarg cotlonuMdi 
*rANulasWAnamunuMdi/rANulasWAnaMnuMdi/rANulasWAnamunuMci/rANulasWAnaMnuMci/rANulasWAnaMlonuMdi/rANulasWAnamulonuMdi/rANulasWAnaMlonuMci/rANulasWAnamulonuMci	n number bahu parsarg sWAnaMnuMdi 
*rANulayaMxu/rANulaMxu	n number bahu parsarg aMxu 
rANulaMte/*rANulaMteV	n number bahu parsarg aMte 
*rANulakaMteV/rANulakaMte/rANulakanna/rANulakannA	n number bahu parsarg kaMteV 
*rANulEna	n number bahu parsarg Ena 
*rANulapAti	n number bahu parsarg pAti 
*rANulalAMti/rANulalAti	n number bahu parsarg lAMti 
*rANulugAnI/rANulukAnI	n number bahu parsarg gAni 
*rANulugA	n number bahu parsarg gA 
