noun	
snehiwudu	
*snehiwudu	n number eka parsarg 0 
snehiwudU/*snehiwudA/snehiwA	n number eka parsarg I 
-	n number eka parsarg gA 
*snehiwudugAdu/snehiwudigAdu	n number eka parsarg gAdu 
*snehiwudugawweV/snehiwunigawweV	n number eka parsarg gawweV 
*snehiwudivAdu/snehiwunivAdu	n number eka parsarg vAdu 
*snehiwudAyana/snehiwuduAyana	n number eka parsarg Ayana 
*snehiwudivAru/snehiwunivAru	n number eka parsarg vAru 
*snehiwudixi/snehiwunixi	n number eka parsarg xi 
*snehiwudivi/snehiwudiy/snehiwunivi/snehiwuniy	n number eka parsarg vi 
*snehiwudugAru/snehiwudigAru	n number eka parsarg gAru 
snehiwudanu/snehiwudini/*snehiwuNNi	n number eka parsarg nu 
snehiwudavu/*snehiwudivi/snehiwuduvu/snehiwunivi	n number eka parsarg vu 
snehiwuniyoVkka/*snehiwudiyoVkka	n number eka parsarg yoVkka 
*snehiwudi/snehiwuni/snehiwa	n number eka parsarg obl 
*snehiwudini/snehiwudni/snehiwuNNi	n number eka parsarg ni 
*snehiwudiki/snehiwuduku/snehiwuniki	n number eka parsarg ki 
*snehiwudiwo/snehiwudiwoda/snehiwudiwoti/snehiwuniwo/snehiwuniwoda/snehiwuniwoti	n number eka parsarg wo 
snehiwudilo/snehiwudilona/*snehiwudilopala/snehiwunilo/snehiwunilona/snehiwunilopala	n number eka parsarg lo 
snehiwudiloni/*snehiwudilopali/snehiwudiyaMxali/snehiwuniloni/snehiwunilopali/snehiwuniyaMxali	n number eka parsarg loni 
*snehiwudimIxa/snehiwunimIxa	n number eka parsarg mIxa 
*snehiwudina/snehiwunina	n number eka parsarg na 
snehiwudiniMci/snehiwudinuMci/*snehiwudinuMdi/snehiwuNNiMci/snehiwuninuMci/snehiwuninuMdi	n number eka parsarg niMci 
*snehiwudixvArA/snehiwunixvArA/snehiwudixvAra/snehiwunixvAra	n number eka parsarg xvArA 
*snehiwudivalana/snehiwudivalla	n number eka parsarg valana 
*snehiwudinibatti/snehiwunibatti/snehiwuNNibatti/snehiwunivalana/snehiwunivalla	n number eka parsarg batti 
snehiwudice/*snehiwudicewa/snehiwunice/snehiwunicewa	n number eka parsarg ce 
*snehiwudiwopAtu/snehiwuniwopAtu	n number eka parsarg wopAtu 
*snehiwudiwokUdi/snehiwudiwokUda/snehiwudiwokUdA/snehiwuniwokUdi/snehiwuniwokUda/snehiwuniwokUdA	n number eka parsarg wokUdi 
*snehiwudikosaM/snehiwudikE/snehiwunikosaM/snehiwunikE/snehiwudArWaM	n number eka parsarg kosaM 
*snehiwudikoVraku/snehiwudikoVrYaku/snehiwunikoVraku/snehiwunikoVrYaku	n number eka parsarg koVraku 
*snehiwudilonuMdi/snehiwudilonuMci/snehiwudiloniMci/snehiwunilonuMdi/snehiwunilonuMci/snehiwuniloniMci/snehiwunilonuMdi/snehiwunilonuMci/snehiwuniloniMci	n number eka parsarg lonuMdi 
*snehiwudimIxanuMdi/snehiwudimIxanuMci/snehiwudimIxaniMci/snehiwunimIxanuMdi/snehiwunimIxanuMci/snehiwunimIxaniMci	n number eka parsarg mIxanuMdi 
*snehiwudixAkA/snehiwudixAka/snehiwunixAkA/snehiwunixAka	n number eka parsarg xAkA 
*snehiwudivaraku/snehiwunivaraku	n number eka parsarg varaku 
*snehiwudimIxaki/snehiwudimIxaku/snehiwudimIxiki/snehiwunimIxaki/snehiwunimIxaku/snehiwunimIxiki	n number eka parsarg mIxaki 
*snehiwudixaggara/snehiwudixaggira/snehiwunixaggara/snehiwunixaggira	n number eka parsarg xaggara 
*snehiwudivaxxa/snehiwudoVxxa/snehiwunivaxxa/snehiwunoVxxa	n number eka parsarg vaxxa 
*snehiwudikAda/snehiwunikAda	n number eka parsarg kAda 
*snehiwudikeVxurugA/snehiwudeVxurugA/snehiwunikeVxurugA/snehiwuneVxurugA	n number eka parsarg keVxurugA 
*snehiwudimuMxu/snehiwunimuMxu	n number eka parsarg muMxu 
*snehiwudiguriMci/snehiwudiniguriMci/snehiwudinugUrci/snehiwuniguriMci/snehiwuNNiguriMci/snehiwuninugUrci	n number eka parsarg guriMci 
snehiwudipE/*snehiwudipEna/snehiwudipEni/snehiwunipE/snehiwunipEna/snehiwunipEni	n number eka parsarg pE 
*snehiwudipEki/snehiwunipEki	n number eka parsarg pEki 
*snehiwudiguMdA/snehiwuniguMdA	n number eka parsarg guMdA 
snehiwudilA/snehiwudilAga/*snehiwudilAgA/snehiwunilA/snehiwunilAga/snehiwunilAgA	n number eka parsarg lA 
*snehiwudivale/snehiwudivaleV/snehiwudimAxiri/snehiwudinipoli/snehiwudinuboli/snehiwunivale/snehiwunivaleV/snehiwunimAxiri/snehiwuNNipoli/snehiwuninuboli	n number eka parsarg vale 
*snehiwudikimalle/snehiwudikimalleV/snehiwunikimalle/snehiwunikimalleV	n number eka parsarg kimalle 
snehiwudikUdA/snehiwudinikUdA/snehiwudinukUdA/snehiwunikUdA/*snehiwuNNikUdA/snehiwuninukUdA	n number eka parsarg kUdA 
*snehiwudixqRtilo/snehiwudixruRtilo/snehiwunixqRtilo/snehiwunixruRtilo	n number eka parsarg xqRtilo 
*snehiwudulekuMdA/snehiwudinilekuMdA/snehiwuduleka/snehiwuNNilekuMdA/snehiwudulekuMdA/snehiwuNNilekuMdA/snehiwuduleka/snehiwuNNilekuMdA	n number eka parsarg lekuMdA 
snehiwudukAkuMdA/snehiwudinikAkuMdA/snehiwudukAka/snehiwudugAka/snehiwudukAkuMdA/*snehiwuNNikAkuMdA/snehiwudukAka/snehiwudugAka	n number eka parsarg kAkuMdA 
*snehiwudumoVxalukoVni/snehiwudinimoVxalukoVni/snehiwudinumoVxalukoVni/snehiwudumoVxalukoVni/snehiwuNNimoVxalukoVni/snehiwuninumoVxalukoVni	n number eka parsarg moVxalukoVni 
*snehiwudivEpu/snehiwudivepu/snehiwunivEpu/snehiwunivepu/snehiwudikesi/snehiwunikesi	n number eka parsarg vEpu 
snehiwudipakka/snehiwudiprakka/snehiwudipakkana/*snehiwudiprakkana/snehiwudipakkani/snehiwunipakka/snehiwuniprakka/snehiwunipakkana/snehiwuniprakkana/snehiwunipakkani	n number eka parsarg pakka 
snehiwudipakkalo/*snehiwudiprakkalo/snehiwudipakkalona/snehiwudipakkaloni/snehiwunipakkalo/snehiwuniprakkalo/snehiwunipakkalona/snehiwunipakkaloni	n number eka parsarg pakkalo 
snehiwudiloki/snehiwudiloniki/snehiwuniloki/snehiwuniloniki/*snehiwudilopalaki/snehiwudilopalaku/snehiwudilopaliki/snehiwunilopalaki/snehiwunilopalaku/snehiwunilopaliki	n number eka parsarg lopalaki 
snehiwudikiMxa/*snehiwudikriMxa/snehiwunikiMxa/snehiwunikriMxa/snehiwudikriMxane/snehiwudikiMxane/snehiwunikriMxane/snehiwunikiMxane	n number eka parsarg kiMxa 
snehiwudaduguna/*snehiwudikaduguna/snehiwunikaduguna	n number eka parsarg aduguna 
snehiwudikeVlla/*snehiwudikalla/snehiwunikeVlla/snehiwunikalla	n number eka parsarg kalla 
*snehiwudiveVnuka/snehiwudiveVnakAwala/snehiwudiveVnakana/snehiwuniveVnuka/snehiwuniveVnasnehiwuda/snehiwuniveVnakAwala/snehiwuniveVnakana	n number eka parsarg veVnuka 
snehiwudiwaravAwa/snehiwudiwarvAwa/*snehiwudiwaruvAwa/snehiwudiwaravAwana/snehiwudiwarvAwana/snehiwudiwaruvAwana/snehiwuniwaravAwa/snehiwuniwarvAwa/snehiwuniwaruvAwa/snehiwuniwaravAwana/snehiwuniwarvAwana/snehiwuniwaruvAwana	n number eka parsarg waravAwa 
*snehiwudikeVxuruguMdA/snehiwudeVxuruguMdA/snehiwunikeVxuruguMdA	n number eka parsarg eVxuruguMdA 
snehiwudimaXya/*snehiwudimaXyalo/snehiwudimaXyana/snehiwunimaXya/snehiwunimaXyalo/snehiwunimaXyana	n number eka parsarg maXya 
*snehiwudinaduma/snehiwudinadumana/snehiwuninaduma/snehiwuninadumana	n number eka parsarg naduma 
snehiwudibaxulugA/snehiwudibaxulu/*snehiwudikibaxulu/snehiwudikubaxulu/snehiwunibaxulugA/snehiwunibaxulu/snehiwunikibaxulu/snehiwunikubaxulu	n number eka parsarg baxulugA 
*snehiwudicotlo/snehiwudicotulo/snehiwudicotuna/snehiwudicota/snehiwunicotlo/snehiwunicotulo/snehiwunicotuna/snehiwunicotu	n number eka parsarg cotlo 
*snehiwudisWAnamulo/snehiwudisWAnaMlo/snehiwudiswAnaMlo/snehiwunisWAnaMlo/snehiwuniswAnaMlo	n number eka parsarg sWAnaMlo 
snehiwudinerugA/snehiwudikunerugA/*snehiwudikinerugA/snehiwuninerugA/snehiwunikunerugA/snehiwunikinerugA	n number eka parsarg nerugA 
*snehiwudiprakAraM/snehiwudiprakAramu/snehiwuniprakAraM/snehiwuniprakAramu	n number eka parsarg prakAraM 
*snehiwudixaggaranuMdi/snehiwudixaggaranuMci/snehiwudixaggiranuMdi/snehiwudixaggiranuMci/snehiwunixaggaranuMdi/snehiwunixaggaranuMci/snehiwunixaggiranuMdi/snehiwunixaggiranuMci	n number eka parsarg xaggaranuMdi 
*snehiwudivaxxanuMdi/snehiwudivaxxanuMci/snehiwudivaxxaniMci/snehiwunivaxxanuMdi/snehiwunivaxxanuMci/snehiwunivaxxaniMci	n number eka parsarg vaxxanuMdi 
*snehiwudipakkanuMdi/snehiwudipakkanuMci/snehiwudipakkaniMci/snehiwunipakkanuMdi/snehiwunipakkanuMci/snehiwunipakkaniMci/snehiwudipakkalonuMdi/snehiwudipakkalonuMci/snehiwudipakkaloniMci/snehiwunipakkalonuMdi/snehiwunipakkalonuMci/snehiwunipakkaloniMci	n number eka parsarg pakkanuMdi 
*snehiwudilopalanuMdi/snehiwudilopalanuMci/snehiwudilopalinuMci/snehiwudilopalaniMci/snehiwunilopalanuMdi/snehiwunilopalanuMdi/snehiwunilopalanuMci/snehiwunilopalanuMci/snehiwunilopalaniMci	n number eka parsarg lopalanuMdi 
*snehiwudibEtanuMdi/snehiwudibEtanuMci/snehiwudibEtaniMci/snehiwunibEtanuMdi/snehiwunibEtanuMci/snehiwunibEtaniMci	n number eka parsarg bEtanuMdi 
*snehiwudipEnuMdi/snehiwudipEnuMci/snehiwudipEniMci/snehiwunipEnuMdi/snehiwunipEnuMci/snehiwunipEniMci	n number eka parsarg pEnuMdi 
snehiwudikiMxanuMdi/snehiwudikiMxanuMci/snehiwudikiMxaniMci/snehiwunikiMxanuMdi/snehiwunikiMxanuMci/snehiwunikimIxaniMci/*snehiwudikriMxanuMdi/snehiwudikriMxanuMci/snehiwudikriMxaniMci/snehiwunikriMxanuMdi/snehiwunikriMxanuMci/snehiwunikriMxaniMci	n number eka parsarg kriMxanuMdi 
snehiwudadugunuMdi/snehiwudadugunuMci/*snehiwudikadugunuMdi/snehiwudikadugunuMci/snehiwudikaduguniMci/snehiwudadugunuMdi/snehiwudadugunuMci/snehiwunikadugunuMdi/snehiwunikadugunuMci/snehiwunikaduguniMci	n number eka parsarg adugunuMdi 
*snehiwudimuMxunuMdi/snehiwudimuMxunuMci/snehiwudimuMxuniMci/snehiwunimuMxunuMdi/snehiwunimuMxunuMci/snehiwunimuMxuniMci	n number eka parsarg muMxunuMdi 
*snehiwudiveVnukanuMdi/snehiwudiveVnakAwalanuMdi/snehiwudiveVnakanuMdi/snehiwuniveVnukanuMdi/snehiwuniveVnasnehiwudanuMdi/snehiwuniveVnakAwalanuMdi/snehiwuniveVnakanuMdi/snehiwudiveVnukanuMci/snehiwudiveVnakAwalanuMci/snehiwudiveVnakanuMci/snehiwuniveVnukanuMci/snehiwuniveVnasnehiwudanuMci/snehiwuniveVnakAwalanuMci/snehiwuniveVnakanuMci	n number eka parsarg veVnukanuMdi 
snehiwudeVxutinuMdi/*snehiwudikeVxutinuMdi/snehiwudikeVxutinuMci/snehiwudeVxutinuMci/snehiwudeVxutinuMdi/snehiwunikeVxutinuMdi/snehiwunikeVxutinuMci/snehiwudeVxutinuMci	n number eka parsarg eVxutinuMdi 
*snehiwudimaXyanuMdi/snehiwudimaXyanuMci/snehiwunimaXyanuMdi/snehiwunimaXyanuMci/snehiwudimaXyalonuMdi/snehiwudimaXyalonuMci/snehiwunimaXyalonuMdi/snehiwunimaXyalonuMci	n number eka parsarg maXyanuMdi 
*snehiwudinadumanuMdi/snehiwudinadumanuMci/snehiwuninadumanuMdi/snehiwuninadumanuMci	n number eka parsarg nadumanuMdi 
*snehiwudiwaruvAwanuMdi/snehiwudiwaravAwanuMdi/snehiwudiwarvAwanuMdi/snehiwudiwaravAwanuMci/snehiwudiwarvAwanuMci/snehiwuniwaravAwanuMdi/snehiwuniwarvAwanuMdi/snehiwuniwaravAwanuMci/snehiwuniwarvAwanuMci	n number eka parsarg waravAwanuMdi 
*snehiwudicotlonuMdi/snehiwudicotunuMdi/snehiwudicotlonuMci/snehiwudicotunuMci/snehiwunicotlonuMdi/snehiwunicotunuMdi/snehiwunicotlonuMci/snehiwunicotunuMci	n number eka parsarg cotlonuMdi 
snehiwudisWAnaMnuMdi/*snehiwudisWAnamunuMdi/snehiwudisWAnaMnuMci/snehiwudisWAnamunuMci/snehiwunisWAnaMnuMdi/snehiwunisWAnamunuMdi/snehiwunisWAnaMnuMci/snehiwunisWAnamunuMci/snehiwudisWAnaMlonuMdi/snehiwudisWAnamulonuMdi/snehiwunisWAnaMlonuMdi/snehiwunisWAnamulonuMdi/snehiwudisWAnaMlonuMci/snehiwudiswAnamulonuMci/snehiwunisWAnaMlonuMci/snehiwuniswAnamulonuMci	n number eka parsarg sWAnaMnuMdi 
snehiwudaMxu/snehiwudinaMxu/*snehiwudiyaMxu/snehiwudaMxu/snehiwuninaMxu/snehiwuniyaMxu	n number eka parsarg aMxu 
*snehiwudaMte/snehiwudaMteV	n number eka parsarg aMte 
snehiwudikaMteV/*snehiwudikaMte/snehiwunikaMteV/snehiwunikaMte/snehiwudikanna/snehiwudikannA/snehiwunikannA/snehiwunikanna	n number eka parsarg kaMteV 
*snehiwudEna/snehiwunEna	n number eka parsarg Ena 
*snehiwudipAti/snehiwunipAti	n number eka parsarg pAti 
*snehiwudilAMti/snehiwunilAMti/snehiwudilAti/snehiwunilAti	n number eka parsarg lAMti 
*snehiwudugAnI/snehiwunigAnI	n number eka parsarg gAni 
snehiwudugA/snehiwunigA/*snehiwudigA	n number eka parsarg gA 
*snehiwulu	n number bahu parsarg 0 
snehiwulU/snehiwulArA/*snehiwullArA	n number bahu parsarg I 
-	n number bahu parsarg gA 
*snehiwulagAdu	n number bahu parsarg gAdu 
*snehiwulagawweV	n number bahu parsarg gawweV 
*snehiwulavAdu/snehiwulodu	n number bahu parsarg vAdu 
*snehiwulAyana	n number bahu parsarg Ayana 
*snehiwulavAru/snehiwuloru	n number bahu parsarg vAru 
*snehiwulaxi/snehiwulxi	n number bahu parsarg xi 
*snehiwulavi/snehiwuliy	n number bahu parsarg vi 
*snehiwulugAru	n number bahu parsarg gAru 
*snehiwulaM/snehiwulamu	n number bahu parsarg nu 
*snehiwulu	n number bahu parsarg vu 
*snehiwulayoVkka	n number bahu parsarg yoVkka 
*snehiwula	n number bahu parsarg obl 
*snehiwulani/snehiwulanu/snehiwulni	n number bahu parsarg ni 
snehiwulaki/*snehiwulaku	n number bahu parsarg ki 
*snehiwulawo/snehiwulwo/snehiwulawoda/snehiwulawoti/snehiwulwoti/snehiwulawoda	n number bahu parsarg wo 
snehiwulalo/*snehiwulalopala/snehiwulalona	n number bahu parsarg lo 
snehiwulaloni/*snehiwulalopali/snehiwulayaMxali	n number bahu parsarg loni 
*snehiwulamIxa	n number bahu parsarg mIxa 
*snehiwulana	n number bahu parsarg na 
snehiwulaniMci/snehiwulniMci/snehiwulanuMci/snehiwulnuMci/*snehiwulanuMdi/snehiwulnuMdi	n number bahu parsarg niMci 
*snehiwulaxvArA/snehiwulaxvAra	n number bahu parsarg xvArA 
*snehiwulavalana/snehiwulavalla	n number bahu parsarg valana 
*snehiwulanubatti/snehiwulnibatti/snehiwulanibatti	n number bahu parsarg batti 
*snehiwulacewa/snehiwulace	n number bahu parsarg ce 
*snehiwulawopAtu/snehiwulawobAtu	n number bahu parsarg wopAtu 
*snehiwulawokUdi/snehiwulwokUdi/snehiwulawokUda/snehiwulawokUdA/snehiwulawogUdA	n number bahu parsarg wokUdi 
*snehiwulakosaM/snehiwulakE/snehiwulArWaM	n number bahu parsarg kosaM 
*snehiwulakoVraku/snehiwulakoVrYaku	n number bahu parsarg koVraku 
*snehiwulalonuMdi/snehiwulalonuMci/snehiwullonuMdi/snehiwullonuMci/snehiwulaloniMci/snehiwulaloniMci	n number bahu parsarg lonuMdi 
*snehiwulamIxanuMdi/snehiwulamIxanuMci/snehiwulamIxaniMci	n number bahu parsarg mIxanuMdi 
*snehiwulaxAkA/snehiwulaxAka	n number bahu parsarg xAkA 
*snehiwulavaraku	n number bahu parsarg varaku 
*snehiwulamIxaki/snehiwulamIxaku/snehiwulamIxiki	n number bahu parsarg mIxaki 
*snehiwulaxaggara/snehiwulaxaggira	n number bahu parsarg xaggara 
*snehiwulavaxxa/snehiwulayoVxxa	n number bahu parsarg vaxxa 
*snehiwulakAda	n number bahu parsarg kAda 
snehiwuleVxurugA/*snehiwulakeVxurugA	n number bahu parsarg keVxurugA 
*snehiwulamuMxu	n number bahu parsarg muMxu 
snehiwulaguriMci/snehiwulnigUrci/*snehiwulanuguriMci/snehiwulanigUrci/snehiwulniguriMci	n number bahu parsarg guriMci 
snehiwulapE/snehiwulapEni/*snehiwulapEna	n number bahu parsarg pE 
*snehiwulapEki	n number bahu parsarg pEki 
*snehiwulaguMdA	n number bahu parsarg guMdA 
snehiwulalA/snehiwululA/snehiwulalAga/snehiwululAga/*snehiwullAgA/snehiwululAgA	n number bahu parsarg lA 
*snehiwulavale/snehiwulavaleV/snehiwulamAxiri/snehiwulanupolina/snehiwulanubolina/snehiwulnipolina/snehiwulnipolina	n number bahu parsarg vale 
*snehiwulakumalle/snehiwulakumalleV	n number bahu parsarg kimalle 
*snehiwulukUdA/snehiwulugUdA	n number bahu parsarg kUdA 
*snehiwulaxqRtilo/snehiwulaxruRtilo	n number bahu parsarg xqRtilo 
*snehiwululekuMdA/snehiwululeka	n number bahu parsarg lekuMdA 
*snehiwulukAkuMdA/snehiwulukAka/snehiwulugAka	n number bahu parsarg kAkuMdA 
*snehiwulumoVxalukoVni/snehiwulanumoVxalukoVni	n number bahu parsarg moVxalukoVni 
*snehiwulavEpu/snehiwulavepu/snehiwulakesi	n number bahu parsarg vEpu 
snehiwulapakka/snehiwulapakkana/snehiwulaprakka/*snehiwulaprakkana	n number bahu parsarg pakka 
snehiwulapakkalo/*snehiwulaprakkalo	n number bahu parsarg pakkalo 
snehiwulaloki/snehiwulloki/snehiwulaloniki/snehiwulloniki/*snehiwulalopalaki/snehiwulalopaliki/snehiwullopaliki/snehiwulalopalaku	n number bahu parsarg lopalaki 
snehiwulakiMxa/*snehiwulakriMxa/snehiwulakriMxane/snehiwulakiMxane	n number bahu parsarg kiMxa 
snehiwuladuguna/*snehiwulakaduguna	n number bahu parsarg aduguna 
snehiwulakeVlla/*snehiwulakalla	n number bahu parsarg kalla 
*snehiwulaveVnuka/snehiwulaveVnaka/snehiwulaveVnukana/snehiwulaveVnuka/snehiwulaveVnakAwala/snehiwulaveVnukAwala	n number bahu parsarg veVnuka 
snehiwulawaravAwa/snehiwulawarvAwa/*snehiwulawaruvAwa	n number bahu parsarg waravAwa 
snehiwuleVxuruguMdA/*snehiwulakeVxuruguMdA	n number bahu parsarg eVxuruguMdA 
*snehiwulamaXya/snehiwulamaXyana/snehiwulamaXyalo	n number bahu parsarg maXya 
*snehiwulanaduma/snehiwulakinaduma	n number bahu parsarg naduma 
snehiwulabaxulugA/snehiwulakibaxulugA/snehiwulabaxulu/*snehiwulakibaxulu	n number bahu parsarg baxulugA 
*snehiwulacotlo/snehiwulacotulo	n number bahu parsarg cotlo 
snehiwulasWAnaMlo/snehiwulaswAnaMlo/*snehiwulasWAnamulo	n number bahu parsarg sWAnaMlo 
snehiwulanerugA/snehiwulakunerugA/*snehiwulakinerugA	n number bahu parsarg nerugA 
*snehiwulaprakAraM/snehiwulanubatti/snehiwulabatti/snehiwulanibatti/snehiwulnibatti	n number bahu parsarg prakAraM 
*snehiwulaxaggaranuMdi/snehiwulaxaggiranuMdi/snehiwulaxaggaranuMci/snehiwulaxaggiranuMci	n number bahu parsarg xaggaranuMdi 
*snehiwulavaxxanuMdi/snehiwulavaxxanuMci	n number bahu parsarg vaxxanuMdi 
*snehiwulapakkanuMdi/snehiwulapakkanuMci/snehiwulapakkalonuMdi/snehiwulapakkalonuMci	n number bahu parsarg pakkanuMdi 
*snehiwulalopalanuMdi/snehiwulalopalanuMdi/snehiwulalopalanuMci/snehiwulalopalanuMci/snehiwulalopalinuMdi/snehiwulalopalinuMci	n number bahu parsarg lopalanuMdi 
*snehiwulabEtanuMdi/snehiwulabEtanuMci/snehiwulabEtaniMci	n number bahu parsarg bEtanuMdi 
*snehiwulapEnuMdi/snehiwulapEnuMci/snehiwulapEniMci	n number bahu parsarg pEnuMdi 
snehiwulakiMxanuMdi/snehiwulakiMxanuMci/snehiwulakiMxaniMci/*snehiwulakriMxanuMdi/snehiwulakriMxanuMci/snehiwulakriMxaniMci	n number bahu parsarg kriMxanuMdi 
*snehiwuladugunuMdi/snehiwuladugunuMci/snehiwuladuguniMci	n number bahu parsarg adugunuMdi 
*snehiwulamuMxunuMdi/snehiwulamuMxunuMci/snehiwulamuMxuniMci	n number bahu parsarg muMxunuMdi 
*snehiwulaveVnukanuMdi/snehiwulaveVnakanuMdi/snehiwulaveVnakAlanuMdi/snehiwulaveVnakAlanuMci/snehiwulaveVnukanuMci/snehiwulaveVnakanuMci/snehiwulaveVnakAwalanuMdi/snehiwulaveVnakAwalanuMci	n number bahu parsarg veVnukanuMdi 
snehiwuleVxutinuMdi/*snehiwulakeVxutinuMdi/snehiwuleVxutinuMci/snehiwulakeVxutinuMci	n number bahu parsarg eVxutinuMdi 
*snehiwulamaXyanuMdi/snehiwulamaXyanuMci/snehiwulamaXyaniMci/snehiwulamaXyalonuMdi/snehiwulamaXyalonuMci/snehiwulamaXyaloniMci	n number bahu parsarg maXyanuMdi 
*snehiwulanadumanuMdi/snehiwulanadumanuMci/snehiwulanadamanuMci	n number bahu parsarg nadumanuMdi 
*snehiwulawaruvAwanuMdi/snehiwulawaravAwanuMdi/snehiwulawarvAwanuMdi/snehiwulawaravAwanuMci/snehiwulawarvAwanuMci	n number bahu parsarg waravAwanuMdi 
snehiwulacotunuMci/snehiwulacotunuMdi/snehiwulacotlonuMci/*snehiwulacotlonuMdi/snehiwulacotulonuMci/snehiwulacotulonuMdi	n number bahu parsarg cotlonuMdi 
*snehiwulasWAnamunuMdi/snehiwulasWAnaMnuMdi/snehiwulasWAnamunuMci/snehiwulasWAnaMnuMci/snehiwulasWAnaMlonuMdi/snehiwulasWAnamulonuMdi/snehiwulasWAnaMlonuMci/snehiwulasWAnamulonuMci/snehiwulasWAnaMloniMci/snehiwulasWAnamuloniMci	n number bahu parsarg sWAnaMnuMdi 
*snehiwulayaMxu/snehiwulaMxu	n number bahu parsarg aMxu 
*snehiwulaMte/snehiwulaMteV	n number bahu parsarg aMte 
snehiwulakaMteV/*snehiwulakaMte/snehiwulakanna/snehiwulakannA	n number bahu parsarg kaMteV 
*snehiwulEna/snehiwulayina	n number bahu parsarg Ena 
*snehiwulapAti	n number bahu parsarg pAti 
*snehiwulalAMti/snehiwulalAti/snehiwululAMti/snehiwululAti	n number bahu parsarg lAMti 
*snehiwulugAnI/snehiwulukAnI	n number bahu parsarg gAni 
*snehiwulugA	n number bahu parsarg gA 
