noun	
Uru	
*Uru	n number eka parsarg 0  case d
-	n number eka parsarg I 
-	n number eka parsarg gA 
*UrigAdu	n number eka parsarg gAdu  case d
*UrigawweV	n number eka parsarg gawweV  case d
*UrivAdu	n number eka parsarg vAdu  case d
*UrAyana	n number eka parsarg Ayana  case d
*UrivAru	n number eka parsarg vAru  case d
*Urixi	n number eka parsarg xi  case d
*Urivi/Uriy	n number eka parsarg vi  case d
*UrugAru	n number eka parsarg gAru  case d
Urunu/*Urini	n number eka parsarg nu 
Uruvu/*Urivi	n number eka parsarg vu  case d
*UriyoVkka	n number eka parsarg yoVkka 
*Uri	n number eka parsarg obl 
Uruni/*Urini	n number eka parsarg ni 
*Uriki	n number eka parsarg ki 
*Uriwo/Uriwoda/Uriwoti	n number eka parsarg wo 
Urilo/Urilona/*Urilopala/Urlo/UlYlo	n number eka parsarg lo 
Uriloni/*Urilopali/UriyaMxali/UlYloni/UlYlopali	n number eka parsarg loni 
*UrimIxa	n number eka parsarg mIxa 
*Urina	n number eka parsarg na 
UriniMci/UrinuMci/*UrinuMdi	n number eka parsarg niMci 
*UrixvArA/UrixvAra/UruxvArA/UruxvAra	n number eka parsarg xvArA 
*Urivalana/Urivalla	n number eka parsarg valana 
*Urunubatti/Urinibatti/Urnibatti	n number eka parsarg batti 
Urice/*Uricewa	n number eka parsarg ce 
*UriwopAtu/UriwobAtu	n number eka parsarg wopAtu 
*UriwokUdi/UriwokUda/UriwokUdA/UriwogUda/UriwogUdA	n number eka parsarg wokUdi 
*UrikosaM/UrikE/UrArWaM	n number eka parsarg kosaM 
*UrikoVraku/UrikoVrYaku	n number eka parsarg koVraku 
*UrilonuMdi/UrilonuMci/UrlonuMdi/UrlonuMci/UlYlonuMci/UlYlonuMdi	n number eka parsarg lonuMdi 
*UrimIxanuMdi/UrimIxanuMci	n number eka parsarg mIxanuMdi 
*UrixAkA/UrixAka	n number eka parsarg xAkA 
*Urivaraku	n number eka parsarg varaku 
*UrimIxaki/UrimIxaku	n number eka parsarg mIxaki 
*Urixaggara/Urixaggira	n number eka parsarg xaggara 
*Urivaxxa	n number eka parsarg vaxxa 
*UrikAda	n number eka parsarg kAda 
*UrikeVxurugA/UreVxurugA	n number eka parsarg keVxurugA 
*UrimuMxu	n number eka parsarg muMxu 
*UriguriMci/UriniguriMci/UrinigUrci	n number eka parsarg guriMci 
UripE/*UripEna/UripEni	n number eka parsarg pE 
*UripEki	n number eka parsarg pEki 
*UriguMdA	n number eka parsarg guMdA 
UrilA/UrilAga/*UrilAgA	n number eka parsarg lA 
Urivale/UrimAxiri/Urinipoli/*UrivaleV/Urinibolina	n number eka parsarg vale 
*Urikimalle 	n number eka parsarg kimalle 
*UrukUdA/UrinikUdA/UrugUdA/UrinigUdA	n number eka parsarg kUdA 
*UrixqRtilo/UrixruRtilo	n number eka parsarg xqRtilo 
*UrulekuMdA/Uruleka	n number eka parsarg lekuMdA 
UrukAkuMdA/UrukAka/UrugAka/UrugAkuMdA/UrukAkuMda/UrugAkuMda	n number eka parsarg kAkuMdA 
*UrumoVxalukoVni/UrinimoVxalukoVni	n number eka parsarg moVxalukoVni 
*UrivEpu/Urivepu/Urikesi/Urukesi	n number eka parsarg vEpu 
Uripakka/*Uriprakka/Uripakkana	n number eka parsarg pakka 
Uripakkalo/*Uriprakkalo	n number eka parsarg pakkalo 
Uriloki/Uriloniki/*Urilopalaki/Urilopalaku/Urilopaliki/UlYloki	n number eka parsarg lopalaki 
UrikiMxa/*UrikriMxa/UrikriMxane/UrikiMxane	n number eka parsarg kiMxa 
Uraduguna/*Urikaduguna	n number eka parsarg aduguna 
UrikeVlla/*Urikalla	n number eka parsarg kalla 
UriveVnuka/*UriveVnakAla/UriveVnakAwala	n number eka parsarg veVnuka 
UriwaravAwa/UriwarvAwa/*UriwaruvAwa	n number eka parsarg waravAwa 
UreVxuruguMdA/*UrikeVxuruguMdA	n number eka parsarg eVxuruguMdA 
UrimaXya/*UrimaXyalo/UrimaXyana	n number eka parsarg maXya 
*Urinaduma/Urinadama	n number eka parsarg naduma 
UribaxulugA/Uribaxulu/*Urikibaxulu/Urinibaxulu	n number eka parsarg baxulugA 
*Uricotlo/Uricotulo/Uricotuna	n number eka parsarg cotlo 
UrisWAnaMlo/*UrisWAnamulo	n number eka parsarg sWAnaMlo 
UrinerugA/UrukunerugA/*UrikinerugA	n number eka parsarg nerugA 
UriprakAraM/*UriprakAramu	n number eka parsarg prakAraM 
*UrixaggaranuMdi/UrixaggaranuMci/UrixaggiranuMdi/UrixaggiranuMci	n number eka parsarg xaggaranuMdi 
*UrivaxxanuMdi/UrivaxxanuMci	n number eka parsarg vaxxanuMdi 
*UripakkanuMdi/UripakkanuMci/UripakkalonuMdi/UripakkalonuMci	n number eka parsarg pakkanuMdi 
*UrilopalanuMdi/UrilopalanuMci/UrilopalinuMci/UrilopalinuMdi	n number eka parsarg lopalanuMdi 
*UribEtanuMdi/UribEtanuMci	n number eka parsarg bEtanuMdi 
*UripEnuMdi/UripEnuMci	n number eka parsarg pEnuMdi 
UrikiMxanuMdi/UrikiMxanuMci/*UrikriMxanuMdi/UrikriMxanuMci	n number eka parsarg kriMxanuMdi 
UradugunuMdi/UradugunuMci/*UrikadugunuMdi/UrikadugunuMci	n number eka parsarg adugunuMdi 
*UrimuMxunuMdi/UrimuMxunuMci	n number eka parsarg muMxunuMdi 
UriveVnukanuMdi/*UriveVnakAlanuMdi/UriveVnakAwalanuMdi/UriveVnakanuMdi/UriveVnukanuMci/UriveVnakAlanuMci/UriveVnakAwalanuMci/UriveVnakanuMci	n number eka parsarg veVnukanuMdi 
UreVxutinuMdi/UreVxutanuMdi/*UrikeVxutinuMdi/UreVxutinuMci/UreVxutanuMci/UrikeVxutinuMci	n number eka parsarg eVxutinuMdi 
*UrimaXyanuMdi/UrimaXyanuMci/UrimaXyalonuMdi/UrimaXyalonuMci	n number eka parsarg maXyanuMdi 
*UrinadumanuMdi/UrinadumanuMci	n number eka parsarg nadumanuMdi 
*UriwaravAwanuMdi/UriwarvAwanuMdi/UriwaravAwanuMci/UriwarvAwanuMci	n number eka parsarg waravAwanuMdi 
*UricotlonuMdi/UricotunuMdi/UricotlonuMci/UricotunuMci	n number eka parsarg cotlonuMdi 
*UrisWAnamunuMdi/UrisWAnaMnuMdi/UrisWAnamunuMci/UrisWAnaMnuMci/UrisWAnaMlonuMdi/UrisWAnamulonuMdi/UrisWAnaMlonuMci/UriswAnamulonuMci	n number eka parsarg sWAnaMnuMdi 
UraMxu/UrinaMxu/*UriyaMxu	n number eka parsarg aMxu 
UraMte/*UraMteV	n number eka parsarg aMte 
*UrikaMteV/UrikaMte/Urikanna/UrikannA	n number eka parsarg kaMteV 
*UrEna	n number eka parsarg Ena 
*UripAti	n number eka parsarg pAti 
*UrilAMti/UrilAti	n number eka parsarg lAMti 
*UrugAnI/UrukAnI	n number eka parsarg gAni 
*UrugA	n number eka parsarg gA 
*UlYlYu/UlYlu/Urlu	n number bahu parsarg 0  case d
UlYlU/*UlYlYalArA/UlYlalArA/UlYlArA/UrlU/UrlalArA/UrlArA	n number bahu parsarg I  case d
-	n number bahu parsarg gA 
UlYlugAdu/UrlagAdu/UlYlagAdu/*UlYlYagAdu	n number bahu parsarg gAdu  case d
UlYlugawweV/UrlagawweV/UlYlagawweV/*UlYlYagawweV	n number bahu parsarg gawweV  case d
*UlYlYavAdu/UlYlavAdu/UrlavAdu	n number bahu parsarg vAdu  case d
*UlYlYAyana/UlYlAyana/UrlaAyana	n number bahu parsarg Ayana  case d
*UlYlYavAru/UlYlavAru/UrlavAru	n number bahu parsarg vAru  case d
*UlYlYaxi/UlYlaxi/Urlaxi	n number bahu parsarg xi  case d
*UlYlYavi/UlYlavi/Urlavi	n number bahu parsarg vi  case d
*UlYlYagAru/UlYlagAru/UrlagAru	n number bahu parsarg gAru  case d
*UlYlYaM/UlYlaM/UlYlamu/UrlaM/Urlamu	n number bahu parsarg nu  case d
*UlYlYu/UlYlu/Urlu	n number bahu parsarg vu 
*UlYlYayoVkka/UlYlayoVkka/UrlayoVkka	n number bahu parsarg yoVkka 
*UlYlYa/UlYla/Urla	n number bahu parsarg obl 
*UlYlYani/UlYlani/Urlani/UlYlanu/Urlanu	n number bahu parsarg ni 
*UlYlYaki/UlYlaki/Urlaki/UlYlaku/Urlaku	n number bahu parsarg ki 
*UlYlYawo/UlYlawo/Urlawo/UlYlawoda	n number bahu parsarg wo 
*UlYlYallo/UlYlallo/UlYlalo/Urlalo/UlYlalona/Urlalona/UlYlalopala/Urlalopala	n number bahu parsarg lo 
*UlYlYaloni/UlYlaloni/Urlaloni/UlYlalopali/UrlayaMxali/Urlalopali	n number bahu parsarg loni 
*UlYlYamIxa/UlYlamIxa/UrlamIxa	n number bahu parsarg mIxa 
*UlYlYana/UlYlana/Urlana	n number bahu parsarg na 
UlYlaniMci/UrlaniMci/UlYlanuMci/UrlanuMci/*UlYlYanuMdi/UlYlanuMdi/UrlanuMdi	n number bahu parsarg niMci 
*UlYlYaxvArA/UlYlaxvArA/UrlaxvArA	n number bahu parsarg xvArA 
*UlYlYavalana/UlYlavalana/UlYlavalla/Urlavalana/Urlavalla	n number bahu parsarg valana 
*UlYlYanubatti/UlYlanubatti/Urlanubatti	n number bahu parsarg batti 
*UlYlYacewa/UlYlacewa/Urlacewa/UlYlace/Urlace	n number bahu parsarg ce 
*UlYlYawopAtu/UlYlawopAtu/UrlawopAtu	n number bahu parsarg wopAtu 
*UlYlYawokUdi/UlYlawokUdi/UrlawokUdi/UlYlawokUda/UrlawokUda/UlYlawokUdA/UrlawokUdA	n number bahu parsarg wokUdi 
*UlYlYakosaM/UlYlakosaM/UrlakosaM/UlYlakE/UrlakE/UlYlArWaM	n number bahu parsarg kosaM 
*UlYlYakoVraku/UlYlakoVraku/UrlakoVraku/UlYlakoVrYaku/UrlakoVrYaku	n number bahu parsarg koVraku 
*UlYlYalonuMdi/UlYlalonuMdi/UlYlalonuMci/UrlalonuMdi/UrlalonuMci/UlYlaloniMci/UrlaloniMci	n number bahu parsarg lonuMdi 
*UlYlYamIxanuMdi/UlYlamIxanuMdi/UrlamIxanuMdi/UlYlamIxanuMci/UrlamIxanuMci	n number bahu parsarg mIxanuMdi 
*UlYlYaxAkA/UlYlaxAkA/UrlaxAkA	n number bahu parsarg xAkA 
*UlYlYavaraku/UlYlavaraku/Urlavaraku	n number bahu parsarg varaku 
*UlYlYamIxaki/UlYlamIxaki/UrlamIxaki/UlYlamIxaku/UrlamIxaku	n number bahu parsarg mIxaki 
*UlYlYaxaggara/UlYlaxaggara/Urlaxaggara/Urlaxaggira/UlYlaxaggira	n number bahu parsarg xaggara 
*UlYlYavaxxa/UlYlavaxxa/Urlavaxxa	n number bahu parsarg vaxxa 
*UlYlYakAda/UlYlakAda/UrlakAda	n number bahu parsarg kAda 
UlYleVxurugA/UrleVxurugA/*UlYlYakeVxurugA/UlYlakeVxurugA/UrlakeVxurugA	n number bahu parsarg keVxurugA 
*UlYlYamuMxu/UlYlamuMxu/UrlamuMxu	n number bahu parsarg muMxu 
*UlYlYaguriMci/UlYlaguriMci/UlYlagUrci/UlYlanuguriMci/UlYlanigUrci	n number bahu parsarg guriMci 
UlYlapE/UlYlapEni/*UlYlYapEna/UlYlapEna	n number bahu parsarg pE 
*UlYlYapEki/UlYlapEki/UrlapEki	n number bahu parsarg pEki 
*UlYlYaguMdA/UlYlaguMdA/UrlaguMdA	n number bahu parsarg guMdA 
UlYlalA/UrlalA/UlYlalAga/*UlYlYulAgA/UlYlulAgA/UrlalAga/UrlulAgA	n number bahu parsarg lA 
*UlYlYavale/UlYlavale/UlYlavaleV/UlYlamAxiri/UlYlanupolina/UlYlanubolina/Urlavale/UrlavaleV/UrlamAxiri/Urlanupolina/Urlanubolina	n number bahu parsarg vale 
*UlYlYakumalle/UlYlakumalle/Urlakumalle/UlYlakumalleV/UrlakumalleV	n number bahu parsarg kimalle 
UrlukUdA/*UlYlYukUdA/UlYlukUdA/UrlugUdA/UlYlugUdA/UrlanugUdA/UlYlanugUdA	n number bahu parsarg kUdA 
*UlYlYaxqRtilo/UlYlaxqRtilo/UlYlaxruRtilo/UrlaxqRtilo/UrlaxruRtilo	n number bahu parsarg xqRtilo 
*UlYlYulekuMda/UrlulekuMdA/Urluleka/UlYluleka	n number bahu parsarg lekuMdA 
UrlukAkuMdA/UrlukAka/UlYlukAka/UlYlugAka/UrlugAka/UrlugAkuMdA/UrlugAkuMda/UrlugAkuMda/*UlYlYukAkuMda/UlYlukAkuMda/UlYlugAkuMda	n number bahu parsarg kAkuMdA 
*UlYlYumoVxalukoVni/UlYlumoVxalukoVni/UlYlanumoVxalukoVni/UrlumoVxalukoVni/UrlanumoVxalukoVni	n number bahu parsarg moVxalukoVni 
*UlYlYavEpu/UlYlavEpu/UlYlavepu/UrlavEpu/Urlavepu/UlYlakesi/Urlakesi	n number bahu parsarg vEpu 
UlYlapakka/UlYlapakkana/*UlYlYaprakka/UlYlaprakka/UlYlaprakkana/Urlapakka/Urlapakkana/Urlaprakka/Urlaprakkana	n number bahu parsarg pakka 
UlYlapakkalo/*UlYlYaprakkalo/UlYlaprakkalo/Urlapakkalo/Urlaprakkalo	n number bahu parsarg pakkalo 
*UlYlYalopalaki/UlYlalopalaki/UlYlalopaliki/Urlalopaliki/Urlalopalaku/UlYlaloniki/UlYlaloki/Urlaloki/Urlaloniki	n number bahu parsarg lopalaki 
UlYlakiMxa/*UlYlYakriMxa/UlYlakriMxa/UrlakiMxa/UrlakriMxa/UlYlakriMxane/UrlakriMxane	n number bahu parsarg kiMxa 
UlYladuguna/*UlYlYakaduguna/UlYlakaduguna/Urladuguna/Urlakaduguna	n number bahu parsarg aduguna 
*UlYlYakeVlla/UlYlakeVlla/UrlakeVlla	n number bahu parsarg kalla 
UlYlaveVnuka/UlYlaveVnaka/*UlYlYaveVnakAla/UlYlaveVnakAla/UlYlaveVnukAla/UlYlaveVnakAwala/UlYlaveVnukAwala/UrlaveVnakAwala/UrlaveVnukAwala	n number bahu parsarg veVnuka 
*UlYlYawaravAwa/UlYlawaravAwa/UlYlawarvAwa/UrlawaravAwa	n number bahu parsarg waravAwa 
UrleVxuruguMdA/*UlYlYakeVxuruguMdA/UlYlakeVxuruguMdA/UrlakeVxuruguMdA/UlYleVxuruguMdA	n number bahu parsarg eVxuruguMdA 
*UlYlYamaXya/UlYlamaXya/UlYlamaXyana/UlYlamaXyalo/UrlamaXya/UrlamaXyana/UrlamaXyalo	n number bahu parsarg maXya 
*UlYlYanaduma/UlYlanaduma/UlYlakinaduma/Urlanaduma/Urlakinaduma	n number bahu parsarg naduma 
UlYlabaxulugA/UlYlakibaxulugA/UlYlabaxulu/*UlYlYakibaxulu/UlYlakibaxulu	n number bahu parsarg baxulugA 
*UlYlYacotlo/UlYlacotlo/UlYlacotulo/Urlacotlo/Urlacotulo	n number bahu parsarg cotlo 
UlYlasWAnaMlo/*UlYlYasWAnaMlo/UlYlaswAnamulo/UrlaswAnaMlo/UrlasWAnamulo	n number bahu parsarg sWAnaMlo 
UlYlanerugA/UlYlakunerugA/*UlYlYakinerugA/UlYlakinerugA/UrlanerugA/UrlakunerugA/UrlakinerugA	n number bahu parsarg nerugA 
*UlYlYaprakAraM/UlYlaprakAraM/UlYlanubatti/UlYlabatti/UlYlanibatti/UrlaprakAraM/Urlanubatti/Urlabatti/Urlanibatti	n number bahu parsarg prakAraM 
*UlYlYaxaggaranuMdi/UlYlaxaggaranuMdi/UlYlaxaggiranuMdi/UlYlaxaggaranuMci/UlYlaxaggiranuMci/UrlaxaggaranuMdi/UrlaxaggiranuMdi/UrlaxaggaranuMci/UrlaxaggiranuMci	n number bahu parsarg xaggaranuMdi 
*UlYlYavaxxanuMdi/UlYlavaxxanuMdi/UlYlavaxxanuMci/UrlavaxxanuMdi/UrlavaxxanuMci	n number bahu parsarg vaxxanuMdi 
*UlYlYapakkanuMdi/UlYlapakkanuMdi/UlYlapakkanuMci/UrlapakkanuMdi/UrlapakkanuMci/UlYlapakkalonuMdi/UlYlapakkalonuMci/UrlapakkalonuMdi/UrlapakkalonuMci	n number bahu parsarg pakkanuMdi 
*UlYlYalopalanuMdi/UlYlalopalanuMdi/UrlalopalanuMdi/UlYlalopalanuMci/UrlalopalanuMci/UrlalopalinuMdi/UlYlalopalinuMci	n number bahu parsarg lopalanuMdi 
*UlYlYabEtanuMdi/UlYlabEtanuMdi/UlYlabEtanuMci/UlYlabEtaniMci/UrlabEtanuMdi/UrlabEtanuMci/UrlabEtaniMci	n number bahu parsarg bEtanuMdi 
*UlYlYapEnuMdi/UlYlapEnuMdi/UlYlapEnuMci/UlYlapEniMci/UrlapEnuMdi/UrlapEnuMci/UrlapEniMci	n number bahu parsarg pEnuMdi 
UlYlakiMxanuMdi/UlYlakiMxanuMci/UlYlakiMxaniMci/UrlakiMxanuMdi/UrlakiMxanuMci/UrlakiMxaniMci/*UlYlYakriMxanuMdi/UlYlakriMxanuMdi/UlYlakriMxanuMci/UlYlakriMxaniMci/UrlakriMxanuMdi/UrlakriMxanuMci/UrlakriMxaniMci	n number bahu parsarg kriMxanuMdi 
*UlYlYadugunuMdi/UlYladugunuMdi/UlYladugunuMci/UrladugunuMdi/UrladugunuMci/UrladuguniMci	n number bahu parsarg adugunuMdi 
*UlYlYamuMxunuMdi/UlYlamuMxunuMdi/UlYlamuMxunuMci/UlYlamuMxuniMci/UrlamuMxunuMdi/UrlamuMxunuMci/UrlamuMxuniMci	n number bahu parsarg muMxunuMdi 
UlYlaveVnukanuMdi/UlYlaveVnakanuMdi/*UlYlYaveVnakAlanuMdi/UlYlaveVnakAlanuMdi/UrlaveVnukanuMdi/UlaveVnakanuMdi/UlaveVnakAlanuMdi/UlYlaveVnakAlanuMci/UlYlaveVnukanuMci/UlYlaveVnakanuMci/UrlaveVnakAlanuMci/UrlaveVnukanuMci/UrlaveVnakanuMci/UlYlaveVnakAwalanuMdi/UlYlaveVnakAwalanuMci/UrlaveVnakAwalanuMdi/UrlaveVnakAwalanuMci	n number bahu parsarg veVnukanuMdi 
UrleVxutinuMdi/UlYlakeVxutinuMdi/UrleVxutanuMdi/*UlYlYakeVxutanuMdi/UlYlakeVxutanuMdi/UrleVxutinuMci/UlYlakeVxutinuMci/UrleVxutanuMci/UlYlakeVxutanuMci	n number bahu parsarg eVxutinuMdi 
*UlYlYamaXyanuMdi/UlYlamaXyanuMdi/UlYlamaXyanuMci/UlYlamaXyaniMci/UrlamaXyanuMdi/UrlamaXyanuMci/UrlamaXyaniMci/UlYlamaXyalonuMdi/UlYlamaXyalonuMci/UlYlamaXyaloniMci/UrlamaXyalonuMdi/UrlamaXyalonuMci/UrlamaXyaloniMci	n number bahu parsarg maXyanuMdi 
*UlYlYanadumanuMdi/UlYlanadumanuMdi/UlYlanadamanuMdi/UlYlanadumanuMci/UlYlanadamanuMci/UrlanadumanuMdi/UrlanadamanuMdi/UrlanadumanuMci/UrlanadamanuMci	n number bahu parsarg nadumanuMdi 
*UlYlYawaravAwanuMdi/UlYlawaravAwanuMdi/UlYlawarvAwanuMdi/UrlawaravAwanuMdi/UrlawarvAwanuMdi/UlYlawaravAwanuMci/UlYlawarvAwanuMci/UrlawaravAwanuMci/UrlawarvAwanuMci	n number bahu parsarg waravAwanuMdi 
UlYlacotunuMdi/UlYlacotunuMci/UlYlacotuniMci/UrlacotunuMdi/UrlacotunuMci/*UlYlYacotlonuMdi/UlYlacotlonuMdi/UlYlacotlonuMci/UlYlacotloniMci/UrlacotlonuMdi/UrlacotlonuMci	n number bahu parsarg cotlonuMdi 
*UlYlYasWAnamunuMdi/UlYlasWAnamunuMdi/UlYlasWAnaMnuMdi/UrlasWAnamunuMdi/UrlasWAnaMnuMdi/UlYlasWAnamunuMci/UlYlasWAnaMnuMci/UrlasWAnamunuMci/UrlasWAnaMnuMci/UlYlasWAnaMlonuMdi/UlYlasWAnamulonuMdi/UrlasWAnaMlonuMdi/UrlasWAnamulonuMdi/UlYlasWAnaMlonuMci/UlYlasWAnamulonuMci/UrlasWAnaMlonuMci/UrlasWAnamulonuMci	n number bahu parsarg sWAnaMnuMdi 
*UlYlYayaMxu/UlYlayaMxu/UlYlaMxu/UrlayaMxu/UrlaMxu	n number bahu parsarg aMxu 
*UlYlYaMte/UlYlaMte/UlYlaMteV/UrlaMte/UrlaMteV	n number bahu parsarg aMte 
*UlYlYakaMteV/UlYlakaMteV/UlYlakaMte/UrlakaMteV/UrlakaMte/UlYlakanna/UlYlakannA/Urlakanna/UrlakannA	n number bahu parsarg kaMteV 
*UlYlYEna/UlYlEna/UrlEna	n number bahu parsarg Ena 
*UlYlYapAti/UlYlapAti/UrlapAti	n number bahu parsarg pAti 
UlYalAMti/UrlalAti/*UlYlYulAMti/UlYulAMti/UrlulAti	n number bahu parsarg lAMti 
*UlYlYugAnI/UlYlugAnI/UrlukAnI/UrlugAnI/UrlukAnI	n number bahu parsarg gAni 
*UlYlYugA/UlYlugA/UrlugA	n number bahu parsarg gA 
