noun	
veVyyi	
*veVyyi/veyi	n number eka parsarg 0  case d
-	n number eka parsarg I 
-	n number eka parsarg gA 
*veVyyigAdu/veyigAdu	n number eka parsarg gAdu  case d
*veVyyigawweV/veyigawweV	n number eka parsarg gawweV  case d
*veVyyivAdu/veyivAdu	n number eka parsarg vAdu  case d
*veVyyAyana/veyAyana	n number eka parsarg Ayana  case d
*veVyyivAru/veyivAru	n number eka parsarg vAru  case d
*veVyyixi/veyixi	n number eka parsarg xi  case d
*veVyyivi/veyivi	n number eka parsarg vi  case d
*veVyyigAru/veyigAru	n number eka parsarg gAru  case d
*veVyyini/veyini	n number eka parsarg nu 
*veVyyivi/veyivi	n number eka parsarg vu  case d
*veVyyiyoVkka/veyiyoVkka	n number eka parsarg yoVkka 
*veVyyi/veyi	n number eka parsarg obl 
*veVyyini/veVyyinu/veyini/veyinu	n number eka parsarg ni 
*veVyyiki/veVyyiku/veyiki/veyiku	n number eka parsarg ki 
*veVyyiwo/veVyyiwoda/veVyyiwoti/veyiwo/veyiwoda/veyiwoti	n number eka parsarg wo 
veVyyilo/veVyyilona/veyilo/veyilona/*veVyyilopala/veyilopala	n number eka parsarg lo 
veVyyiloni/veyiloni/*veVyyilopali/veyiyaMxali/veyilopali	n number eka parsarg loni 
*veVyyimIxa/veyimIxa	n number eka parsarg mIxa 
*veVyyina/veyina	n number eka parsarg na 
veVyyiniMci/veVyyinuMci/*veVyyinuMdi/veyiniMci/veyinuMci/veyinuMdi	n number eka parsarg niMci 
*veVyyixvArA/veyixvArA/veVyyixvAra/veyixvAra	n number eka parsarg xvArA 
*veVyyivalana/veVyyivalla/veyivalana/veyivalla	n number eka parsarg valana 
*veVyyinibatti/veVyyibatti/veyinibatti	n number eka parsarg batti 
veVyyice/*veVyyicewa/veyice/veyicewa	n number eka parsarg ce 
*veVyyiwopAtu/veyiwopAtu/veVyyiwobAtu/veyiwobAtu	n number eka parsarg wopAtu 
veVyyiwokUdi/*veVyyiwokUda/veVyyiwokUdA/veyiwokUdi/veyiwokUda/veyiwokUdA	n number eka parsarg wokUdi 
*veVyyikosaM/veVyyikE/veyikosaM/veyikE/veVyyArWaM	n number eka parsarg kosaM 
*veVyyikoVraku/veVyyikoVrYaku/veyikoVraku/veyikoVrYaku	n number eka parsarg koVraku 
*veVyyilonuMdi/veVyyilonuMci/veVyyiloniMci/veyilonuMdi/veyilonuMci/veyiloniMci	n number eka parsarg lonuMdi 
*veVyyimIxanuMdi/veVyyimIxanuMci/veVyyimIxaniMci/veyimIxanuMdi/veyimIxanuMci/veyimIxaniMci	n number eka parsarg mIxanuMdi 
*veVyyixAkA/veVyyixAka/veyixAkA/veyixAka	n number eka parsarg xAkA 
*veVyyivaraku/veyivaraku	n number eka parsarg varaku 
*veVyyimIxaki/veVyyimIxaku/veVyyimIxiki/veyimIxaki/veyimIxaku/veyimIxiki	n number eka parsarg mIxaki 
*veVyyixaggara/veVyyixaggira/veyixaggara/veyixaggira	n number eka parsarg xaggara 
*veVyyivaxxa/veVyyoVxxa/veyivaxxa/veyoVxxa	n number eka parsarg vaxxa 
*veVyyikAda/veyikAda	n number eka parsarg kAda 
*veVyyikeVxurugA/veVyyeVxurugA/veyikeVxurugA/veyeVxurugA	n number eka parsarg keVxurugA 
*veVyyimuMxu/veyimuMxu	n number eka parsarg muMxu 
*veVyyiguriMci/veVyyiniguriMci/veVyyinugUrci/veyiguriMci/veyiniguriMci/veyinugUrci	n number eka parsarg guriMci 
veVyyipE/*veVyyipEna/veVyyipEni/veyipE/veyipEna/veyipEni	n number eka parsarg pE 
*veVyyipEki/veyipEki	n number eka parsarg pEki 
*veVyyiguMdA/veyiguMdA	n number eka parsarg guMdA 
veVyyilA/veVyyilAga/*veVyyilAgA/veyilA/veyilAga/veyilAgA	n number eka parsarg lA 
*veVyyivaleV/veVyyivale/veVyyimAxiri/veVyyinipolina/veVyyinibolina/veyivale/veyivaleV/veyimAxiri/veyinipolina/veyinibolina	n number eka parsarg vale 
*veVyyikimalleV/veVyyikimalle/veyikimalleV/veyikimalle	n number eka parsarg kimalle 
*veVyyikUdA/veVyyinigUdA/veVyyinikUdA/veyikUdA/veyinigUdA/veyinikUdA	n number eka parsarg kUdA 
*veVyyixqRtilo/veVyyixruRtilo/veyixqRtilo/veyixruRtilo	n number eka parsarg xqRtilo 
*veVyyilekuMdA/veVyyinilekuMdA/veVyyilekuMda/veVyyinulekuMdA/veyilekuMdA/veyinilekuMdA/veyilekuMda/veyinulekuMdA	n number eka parsarg lekuMdA 
*veVyyikAkuMdA/veVyyinikAkuMdA/veVyyikAkuMda/veVyyinukAkuMdA/veyikAkuMdA/veyinikAkuMdA/veyikAkuMda/veyinukAkuMdA	n number eka parsarg kAkuMdA 
*veVyyimoVxalukoVni/veVyyinimoVxalukoVni/veVyyinumoVxalukoVni/veyimoVxalukoVni/veyinimoVxalukoVni/veyinumoVxalukoVni	n number eka parsarg moVxalukoVni 
*veVyyivEpu/veVyyivepu/veyivEpu/veyivepu/veVyyikesi/veyikesi	n number eka parsarg vEpu 
veVyyipakka/veVyyiprakka/veVyyipakkana/*veVyyiprakkana/veVyyipakkani/veyipakka/veyiprakka/veyipakkana/veyiprakkana/veyipakkani	n number eka parsarg pakka 
veVyyipakkalo/*veVyyiprakkalo/veVyyipakkalona/veVyyipakkaloni/veyipakkalo/veyiprakkalo/veyipakkalona/veyipakkaloni	n number eka parsarg pakkalo 
veVyyiloki/veVyyiloniki/veyiloki/veyiloniki/*veVyyilopalaki/veVyyilopalaku/veVyyilopaliki/veyilopalaki/veyilopalaku/veyilopaliki	n number eka parsarg lopalaki 
veVyyikiMxa/*veVyyikriMxa/veyikiMxa/veyikriMxa/veVyyikriMxana/veVyyikiMxana/veyikriMxana/veyikiMxana	n number eka parsarg kiMxa 
veVyyaduguna/*veVyyikaduguna/veyaduguna/veyikaduguna	n number eka parsarg aduguna 
veVyyikeVlla/*veVyyikalla/veyikeVlla/veyikalla	n number eka parsarg kalla 
veVyyiveVnuka/*veVyyiveVnakAla/veVyyiveVnakAwala/veVyyiveVnakana/veyiveVnuka/veyiveVnakAla/veyiveVnakAwala/veyiveVnakana	n number eka parsarg veVnuka 
veVyyiwaravAwa/veVyyiwarvAwa/*veVyyiwaruvAwa/veVyyiwaravAwana/veVyyiwarvAwana/veVyyiwaruvAwana/veyiwaravAwa/veyiwarvAwa/veyiwaruvAwa/veyiwaravAwana/veyiwarvAwana/veyiwaruvAwana	n number eka parsarg waravAwa 
veVyyeVxuruguMdA/*veVyyikeVxuruguMdA/veyeVxuruguMdA/veyikeVxuruguMdA	n number eka parsarg eVxuruguMdA 
veVyyimaXya/*veVyyimaXyalo/veVyyimaXyana/veyimaXya/veyimaXyalo/veyimaXyana	n number eka parsarg maXya 
*veVyyinaduma/veVyyinadumana/veyinaduma/veyinadumana	n number eka parsarg naduma 
veVyyibaxulugA/veVyyibaxulu/*veVyyikibaxulu/veVyyikubaxulu/veyibaxulugA/veyibaxulu/veyikibaxulu/veyikubaxulu	n number eka parsarg baxulugA 
*veVyyicotlo/veVyyicotulo/veVyyicotuna/veVyyicota/veyicotlo/veyicotulo/veyicotuna/veyicotu	n number eka parsarg cotlo 
*veVyyisWAnamulo/veVyyisWAnaMlo/veVyyiswAnaMlo/veyisWAnaMlo/veyiswAnaMlo	n number eka parsarg sWAnaMlo 
veVyyinerugA/veVyyikunerugA/*veVyyikinerugA/veyinerugA/veyikunerugA/veyikinerugA	n number eka parsarg nerugA 
*veVyyiprakAraM/veVyyiprakAramu/veyiprakAraM/veyiprakAramu	n number eka parsarg prakAraM 
*veVyyixaggaranuMdi/veVyyixaggaranuMci/veVyyixaggiranuMdi/veVyyixaggiranuMci/veyixaggaranuMdi/veyixaggaranuMci/veyixaggiranuMdi/veyixaggiranuMci	n number eka parsarg xaggaranuMdi 
*veVyyivaxxanuMdi/veVyyivaxxanuMci/veVyyivaxxaniMci/veyivaxxanuMdi/veyivaxxanuMci/veyivaxxaniMci	n number eka parsarg vaxxanuMdi 
*veVyyipakkanuMdi/veVyyipakkanuMci/veVyyipakkaniMci/veyipakkanuMdi/veyipakkanuMci/veyipakkaniMci/veVyyipakkalonuMdi/veVyyipakkalonuMci/veVyyipakkaloniMci/veyipakkalonuMdi/veyipakkalonuMci/veyipakkaloniMci	n number eka parsarg pakkanuMdi 
*veVyyilopalanuMdi/veVyyilopalanuMci/veVyyilopalaniMci/veyilopalanuMdi/veyilopalanuMci/veyilopalaniMci	n number eka parsarg lopalanuMdi 
*veVyyibEtanuMdi/veVyyibEtanuMci/veVyyibEtaniMci/veyibEtanuMdi/veyibEtanuMci/veyibEtaniMci	n number eka parsarg bEtanuMdi 
*veVyyipEnuMdi/veVyyipEnuMci/veVyyipEniMci/veyipEnuMdi/veyipEnuMci/veyipEniMci	n number eka parsarg pEnuMdi 
veVyyikiMxanuMdi/veVyyikiMxanuMci/veVyyikiMxaniMci/veyikiMxanuMdi/veyikiMxanuMci/veyikimIxaniMci/*veVyyikriMxanuMdi/veVyyikriMxanuMci/veVyyikriMxaniMci/veyikriMxanuMdi/veyikriMxanuMci/veyikriMxaniMci	n number eka parsarg kriMxanuMdi 
veVyyadugunuMdi/veVyyadugunuMci/*veVyyikadugunuMdi/veVyyikadugunuMci/veVyyikaduguniMci/veyadugunuMdi/veyadugunuMci/veyikadugunuMdi/veyikadugunuMci/veyikaduguniMci	n number eka parsarg adugunuMdi 
*veVyyimuMxunuMdi/veVyyimuMxunuMci/veVyyimuMxuniMci/veyimuMxunuMdi/veyimuMxunuMci/veyimuMxuniMci	n number eka parsarg muMxunuMdi 
veVyyiveVnukanuMdi/*veVyyiveVnakAlanuMdi/veVyyiveVnakAwalanuMdi/veVyyiveVnakanuMdi/veyiveVnukanuMdi/veyiveVnakAlanuMdi/veyiveVnakAwalanuMdi/veyiveVnakanuMdi/veVyyiveVnukanuMci/veVyyiveVnakAlanuMci/veVyyiveVnakAwalanuMci/veVyyiveVnakanuMci/veyiveVnukanuMci/veyiveVnakAlanuMci/veyiveVnakAwalanuMci/veyiveVnakanuMci	n number eka parsarg veVnukanuMdi 
veVyyeVxutinuMdi/veVyyikeVxutinuMdi/veVyyikeVxutinuMci/veVyyeVxutanuMci/veVyyeVxutanuMdi/*veVyyikeVxutanuMdi/veyikeVxutinuMci/veyeVxutanuMci	n number eka parsarg eVxutinuMdi 
*veVyyimaXyanuMdi/veVyyimaXyanuMci/veyimaXyanuMdi/veyimaXyanuMci/veVyyimaXyalonuMdi/veVyyimaXyalonuMci/veyimaXyalonuMdi/veyimaXyalonuMci	n number eka parsarg maXyanuMdi 
*veVyyinadumanuMdi/veVyyinadumanuMci/veyinadumanuMdi/veyinadumanuMci	n number eka parsarg nadumanuMdi 
*veVyyiwaruvAwanuMdi/veVyyiwaravAwanuMdi/veVyyiwarvAwanuMdi/veVyyiwaravAwanuMci/veVyyiwarvAwanuMci/veyiwaravAwanuMdi/veyiwarvAwanuMdi/veyiwaravAwanuMci/veyiwarvAwanuMci  --  added this option	n number eka parsarg waravAwanuMdi 
*veVyyicotlonuMdi/veVyyicotunuMdi/veVyyicotlonuMci/veVyyicotunuMci/veyicotlonuMdi/veyicotunuMdi/veyicotlonuMci/veyicotunuMci	n number eka parsarg cotlonuMdi 
veVyyisWAnaMnuMdi/*veVyyisWAnamunuMdi/veVyyisWAnaMnuMci/veVyyisWAnamunuMci/veyisWAnaMnuMdi/veyisWAnamunuMdi/veyisWAnaMnuMci/veyisWAnamunuMci/veVyyisWAnaMlonuMdi/veVyyisWAnamulonuMdi/veyisWAnaMlonuMdi/veyisWAnamulonuMdi/veVyyisWAnaMlonuMci/veVyyiswAnamulonuMci/veyisWAnaMlonuMci/veyiswAnamulonuMci	n number eka parsarg sWAnaMnuMdi 
veVyyaMxu/veVyyinaMxu/*veVyyiyaMxu/veyaMxu/veyinaMxu/veyiyaMxu	n number eka parsarg aMxu 
*veVyyaMte/veVyyaMteV/veyaMte/veyaMteV	n number eka parsarg aMte 
*veVyyikaMteV/veVyyikaMte/veyikaMteV/veyikaMte/veVyyikannA/veyikannA/veVyyikanna/veyikanna	n number eka parsarg kaMteV 
*veVyyEna/veyEna	n number eka parsarg Ena 
*veVyyipAti/veyipAti	n number eka parsarg pAti 
*veVyyilAMti/veVyyilAti/veyilAMti/veyilAti	n number eka parsarg lAMti 
*veVyyigAnI/veVyyikAnI/veyigAnI/veyikAnI	n number eka parsarg gAni 
*veVyyigA/veyigA	n number eka parsarg gA 
*velu	n number bahu parsarg 0  case d
velU/*velulArA	n number bahu parsarg I  case d
-	n number bahu parsarg gA 
*velagAdu	n number bahu parsarg gAdu  case d
*velagawweV	n number bahu parsarg gawweV  case d
*velavAdu/velodu	n number bahu parsarg vAdu  case d
*velAyana	n number bahu parsarg Ayana  case d
*velavAru/veloru	n number bahu parsarg vAru  case d
*velaxi/velxi	n number bahu parsarg xi  case d
*velavi/velay	n number bahu parsarg vi  case d
*velagAru	n number bahu parsarg gAru  case d
*velaM/velamu	n number bahu parsarg nu  case d
-	n number bahu parsarg vu 
*velayoVkka	n number bahu parsarg yoVkka 
*vela	n number bahu parsarg obl 
*velani/velni/velanu/velnu	n number bahu parsarg ni 
*velaki/velaku	n number bahu parsarg ki 
*velawo/velwo/velawoda/velawoti/velwoti/velwoda	n number bahu parsarg wo 
velalo/*velallo/velalona/velallona	n number bahu parsarg lo 
velaloni/velayaMxali/*velalloni	n number bahu parsarg loni 
*velamIxa	n number bahu parsarg mIxa 
*velana	n number bahu parsarg na 
velaniMci/velniMci/velanuMci/velnuMci/*velanuMdi/velnuMdi	n number bahu parsarg niMci 
*velaxvArA/velaxvAra	n number bahu parsarg xvArA 
*velavalana/velavalla	n number bahu parsarg valana 
*velanubatti/velanibatti	n number bahu parsarg batti 
*velacewa/velcewa/velace/velce	n number bahu parsarg ce 
*velawopAtu/velawobAtu	n number bahu parsarg wopAtu 
velawokUdi/velwokUdi/*velawokUda/velawokUdA/velwokUdA/velawogUdA/velawogUda	n number bahu parsarg wokUdi 
*velakosaM/velakE/velArWaM	n number bahu parsarg kosaM 
*velakoVraku/velakoVrYaku	n number bahu parsarg koVraku 
velalonuMdi/velalonuMci/*velallonuMdi/velallonuMci/velalloniMci/velaloniMci	n number bahu parsarg lonuMdi 
*velamIxanuMdi/velamIxanuMci/velamIxaniMci	n number bahu parsarg mIxanuMdi 
*velaxAkA/velaxAka	n number bahu parsarg xAkA 
*velavaraku	n number bahu parsarg varaku 
*velamIxaki/velamIxaku/velamIxiki	n number bahu parsarg mIxaki 
*velaxaggara/velaxaggira	n number bahu parsarg xaggara 
*velavaxxa/veloVxxa	n number bahu parsarg vaxxa 
*velakAda	n number bahu parsarg kAda 
veleVxurugA/*velakeVxurugA	n number bahu parsarg keVxurugA 
*velamuMxu	n number bahu parsarg muMxu 
*velaguriMci/velagUrci/velanuguriMci/velanigUrci	n number bahu parsarg guriMci 
velapE/velapEni/*velapEna	n number bahu parsarg pE 
*velapEki	n number bahu parsarg pEki 
*velaguMdA	n number bahu parsarg guMdA 
velalA/velulA/*velallAgA/velulAgA/velulAga	n number bahu parsarg lA 
*velavale/velavaleV/velamAxiri/velanupolina/velanubolina	n number bahu parsarg vale 
*velakumalle/velakumalleV	n number bahu parsarg kimalle 
*velukUdA/velakUdA/velugUdA	n number bahu parsarg kUdA 
*velaxqRtilo/velaxruRtilo	n number bahu parsarg xqRtilo 
velulekuMdA/*velulekuMda/veluleka	n number bahu parsarg lekuMdA 
*velukAkuMdA/velugAkuMdA/velukAka/velugAka	n number bahu parsarg kAkuMdA 
*velumoVxalukoVni/velanumoVxalukoVni	n number bahu parsarg moVxalukoVni 
*velavEpu/velavepu/velakesi	n number bahu parsarg vEpu 
velapakka/velapakkana/velaprakka/*velaprakkana	n number bahu parsarg pakka 
velapakkalo/*velaprakkalo	n number bahu parsarg pakkalo 
velaloki/velaloniki/velalloki/velalloniki/velalopalaki/velalopaliki/*velallopaliki/velallopalaku	n number bahu parsarg lopalaki 
velakiMxa/*velakriMxa/velakriMxane/velakiMxane	n number bahu parsarg kiMxa 
veladuguna/*velakaduguna	n number bahu parsarg aduguna 
velakeVlla/*velakalla	n number bahu parsarg kalla 
velaveVnuka/velaveVnaka/*velaveVnakAla/velaveVnukAla/velaveVnakAwala/velaveVnukAwala	n number bahu parsarg veVnuka 
*velawaruvAwa/velawaravAwa/velawarvAwa/velwaravAwa	n number bahu parsarg waravAwa 
veleVxuruguMdA/*velakeVxuruguMdA	n number bahu parsarg eVxuruguMdA 
*velamaXya/velamaXyana/velamaXyalo	n number bahu parsarg maXya 
*velanaduma/velakinaduma	n number bahu parsarg naduma 
velabaxulugA/*velakibaxulugA/velabaxulu/velakibaxulu	n number bahu parsarg baxulugA 
*velacotlo/velacotulo	n number bahu parsarg cotlo 
velasWAnaMlo/velaswAnaMlo/*velasWAnamulo	n number bahu parsarg sWAnaMlo 
velanerugA/velakunerugA/*velakinerugA	n number bahu parsarg nerugA 
*velaprakAraM/velanubatti/velabatti/velanibatti	n number bahu parsarg prakAraM 
*velaxaggaranuMdi/velaxaggiranuMdi/velaxaggaranuMci/velaxaggiranuMci	n number bahu parsarg xaggaranuMdi 
*velavaxxanuMdi/velavaxxanuMci	n number bahu parsarg vaxxanuMdi 
*velapakkanuMdi/velapakkanuMci/velapakkalonuMdi/velapakkalonuMci	n number bahu parsarg pakkanuMdi 
*velalopalanuMdi/vellopalanuMdi/velalopalanuMci/vellopalanuMci/vellopalinuMdi/velalopalinuMci	n number bahu parsarg lopalanuMdi 
*velabEtanuMdi/velabEtanuMci/velabEtaniMci	n number bahu parsarg bEtanuMdi 
*velapEnuMdi/velapEnuMci/velapEniMci	n number bahu parsarg pEnuMdi 
velakiMxanuMdi/velakiMxanuMci/velakiMxaniMci/*velakriMxanuMdi/velakriMxanuMci/velakriMxaniMci	n number bahu parsarg kriMxanuMdi 
*veladugunuMdi/veladugunuMci/veladuguniMci	n number bahu parsarg adugunuMdi 
*velamuMxunuMdi/velamuMxunuMci/velamuMxuniMci	n number bahu parsarg muMxunuMdi 
velaveVnukanuMdi/velaveVnakanuMdi/*velaveVnakAlanuMdi/velaveVnakAlanuMci/velaveVnukanuMci/velaveVnakanuMci/velaveVnakAwalanuMdi/velaveVnakAwalanuMci	n number bahu parsarg veVnukanuMdi 
veleVxutinuMdi/*velakeVxutinuMdi/veleVxutanuMdi/velakeVxutanuMdi/veleVxutinuMci/velakeVxutinuMci/veleVxutanuMci/velakeVxutanuMci	n number bahu parsarg eVxutinuMdi 
*velamaXyanuMdi/velamaXyanuMci/velamaXyaniMci/velamaXyalonuMdi/velamaXyalonuMci/velamaXyaloniMci	n number bahu parsarg maXyanuMdi 
*velanadumanuMdi/velanadamanuMdi/velanadumanuMci/velanadamanuMci	n number bahu parsarg nadumanuMdi 
velawaravAwanuMdi/velawarvAwanuMdi/*velawaruvAwanuMdi/velawaravAwanuMci/velawarvAwanuMci/velawaruvAwanuMci	n number bahu parsarg waravAwanuMdi 
velacotunuMci/velacotunuMdi/velacotlonuMci/velacotloniMci/*velacotlonuMdi/velacotulonuMdi	n number bahu parsarg cotlonuMdi 
*velasWAnamunuMdi/velasWAnaMnuMdi/velasWAnamunuMci/velasWAnaMnuMci/velasWAnaMlonuMdi/velasWAnamulonuMdi/velasWAnaMlonuMci/velasWAnamulonuMci	n number bahu parsarg sWAnaMnuMdi 
*velayaMxu/velaMxu	n number bahu parsarg aMxu 
*velaMte/velaMteV	n number bahu parsarg aMte 
*velakaMteV/velakaMte/velakanna/velakannA	n number bahu parsarg kaMteV 
*velEna	n number bahu parsarg Ena 
*velapAti	n number bahu parsarg pAti 
*velalAMti/velalAti	n number bahu parsarg lAMti 
*velugAnI/velukAnI	n number bahu parsarg gAni 
*velugA	n number bahu parsarg gA 
