noun	
velu	
*velu	n number eka parsarg 0  case d
-	n number eka parsarg I 
-	n number eka parsarg gA 
*veligAdu	n number eka parsarg gAdu  case d
*veligawweV	n number eka parsarg gawweV  case d
*velivAdu	n number eka parsarg vAdu  case d
*velAyana	n number eka parsarg Ayana  case d
*velivAru	n number eka parsarg vAru  case d
*velixi	n number eka parsarg xi  case d
*velivi/veliy	n number eka parsarg vi  case d
*veligAru	n number eka parsarg gAru  case d
*velunu	n number eka parsarg nu 
*veluvu	n number eka parsarg vu  case d
*veliyoVkka	n number eka parsarg yoVkka 
*veli	n number eka parsarg obl 
*velini/velunu	n number eka parsarg ni 
*veliki/veluku	n number eka parsarg ki 
*veliwo/veliwoda/veliwoti/velwoti/velwo	n number eka parsarg wo 
*velilo/velilona/vello/vellona/velilopala/vellopala	n number eka parsarg lo 
*veliloni/velloni/velilopali/vellopali	n number eka parsarg loni 
*velimIxa	n number eka parsarg mIxa 
*velina	n number eka parsarg na 
veliniMci/velinuMci/*velinuMdi	n number eka parsarg niMci 
*velixvArA/velixvAra	n number eka parsarg xvArA 
*velivalana/velivalla	n number eka parsarg valana 
*velinibatti	n number eka parsarg batti 
velice/*velicewa	n number eka parsarg ce 
*veliwopAtu	n number eka parsarg wopAtu 
veliwokUdi/veliwokUda/*veliwokUdA/veluwokUdA/veliwogUdi/veliwogUda/veliwogUdA/veluwogUdA	n number eka parsarg wokUdi 
*velikosaM/velikE/velukosaM/velukosamu/velArWaM	n number eka parsarg kosaM 
*velikoVraku/velikoVrYaku	n number eka parsarg koVraku 
*velilonuMdi/velilonuMci/veliloniMci/vellonuMdi/vellonuMci/velloniMci	n number eka parsarg lonuMdi 
*velimIxanuMdi/velimIxanuMci/velimIxaniMci	n number eka parsarg mIxanuMdi 
*velixAkA/velixAka	n number eka parsarg xAkA 
*velivaraku	n number eka parsarg varaku 
*velimIxaki/velimIxaku/velimIxiki	n number eka parsarg mIxaki 
*velixaggara/velixaggira	n number eka parsarg xaggara 
*velivaxxa/veloVxxa	n number eka parsarg vaxxa 
*velikAda	n number eka parsarg kAda 
*velikeVxurugA/veleVxurugA	n number eka parsarg keVxurugA 
*velimuMxu	n number eka parsarg muMxu 
*veliguriMci/veliniguriMci/velinigUrci/velunuguriMci/velunugUrci	n number eka parsarg guriMci 
velipE/*velipEna/velipEni	n number eka parsarg pE 
*velipEki	n number eka parsarg pEki 
*veliguMdA	n number eka parsarg guMdA 
velilA/velilAga/*velilAgA	n number eka parsarg lA 
velivale/*velivaleV/velimAxiri/velinipoli/velinibolina	n number eka parsarg vale 
velikimalle/*velikimalleV	n number eka parsarg kimalle 
velikUdA/*velinikUdA/velunukUdA/veligUdA/velinigUdA/velunugUdA	n number eka parsarg kUdA 
*velixqRtilo/velixruRtilo	n number eka parsarg xqRtilo 
velulekuMdA/velinilekuMdA/*velulekuMda/veluleka	n number eka parsarg lekuMdA 
*velukAkuMdA/velinikAkuMdA/velugAkuMda/velugAka	n number eka parsarg kAkuMdA 
*velumoVxalukoVni/velinimoVxalukoVni/velinumoVxalukoVni	n number eka parsarg moVxalukoVni 
*velivEpu/velivepu/velikesi	n number eka parsarg vEpu 
velipakka/veliprakka/velipakkana/*veliprakkana/velipakkani	n number eka parsarg pakka 
velipakkalo/*veliprakkalo/velipakkalona/velipakkaloni	n number eka parsarg pakkalo 
*veliloki/veliloniki/velloki/velloniki/velilopalaku/vellopalaku/velilopalaki/vellopaliki/velilopaliki	n number eka parsarg lopalaki 
velikiMxa/*velikriMxa/velikriMxana/velikiMxana	n number eka parsarg kiMxa 
veladuguna/*velikaduguna	n number eka parsarg aduguna 
velikeVlla/*velikalla	n number eka parsarg kalla 
veliveVnuka/*veliveVnakAla/veliveVnakAwala/veliveVnakana	n number eka parsarg veVnuka 
veliwaravAwa/veliwarvAwa/*veliwaruvAwa/veliwaravAwana/veliwarvAwana/veliwaruvAwana	n number eka parsarg waravAwa 
veleVxuruguMdA/*velikeVxuruguMdA	n number eka parsarg eVxuruguMdA 
*velimaXya/velimaXyalo/velimaXyana	n number eka parsarg maXya 
*velinaduma/velinadumana	n number eka parsarg naduma 
velubaxulugA/velibaxulu/*velikibaxulu/velikubaxulu	n number eka parsarg baxulugA 
*velicotlo/velicotulo/velicotuna/velicota	n number eka parsarg cotlo 
*velisWAnamulo/veliswAnaMlo	n number eka parsarg sWAnaMlo 
velinerugA/velikunerugA/*velikinerugA	n number eka parsarg nerugA 
*veliprakAraM/veliprakAramu	n number eka parsarg prakAraM 
*velixaggaranuMdi/velixaggaranuMci/velixaggiranuMdi/velixaggiranuMci	n number eka parsarg xaggaranuMdi 
*velivaxxanuMdi/velivaxxanuMci/velivaxxaniMci	n number eka parsarg vaxxanuMdi 
*velipakkanuMdi/velipakkanuMci/velipakkaniMci/velipakkalonuMdi/velipakkalonuMci/velipakkaloniMci	n number eka parsarg pakkanuMdi 
*velilopalanuMdi/vellopalanuMdi/velilopalanuMci/vellopalanuMci/velilopalaniMci	n number eka parsarg lopalanuMdi 
*velibEtanuMdi/velibEtanuMci/velibEtaniMci	n number eka parsarg bEtanuMdi 
*velipEnuMdi/velipEnuMci/velipEniMci	n number eka parsarg pEnuMdi 
velikiMxanuMdi/velikiMxanuMci/velikiMxaniMci/*velikriMxanuMdi/velikriMxanuMci/velikriMxaniMci	n number eka parsarg kriMxanuMdi 
veladugunuMdi/veladugunuMci/*velikadugunuMdi/velikadugunuMci/velikaduguniMci	n number eka parsarg adugunuMdi 
*velimuMxunuMdi/velimuMxunuMci/velimuMxuniMci	n number eka parsarg muMxunuMdi 
veliveVnukanuMdi/*veliveVnakAlanuMdi/veliveVnakAwalanuMdi/veliveVnakanuMdi/veliveVnukanuMci/veliveVnakAlanuMci/veliveVnakAwalanuMci/veliveVnakanuMci	n number eka parsarg veVnukanuMdi 
veleVxutinuMdi/velikeVxutinuMdi/velikeVxutinuMci/veleVxutinuMci/veleVxutanuMdi/*velikeVxutanuMdi/velikeVxutanuMci/veleVxutanuMci	n number eka parsarg eVxutinuMdi 
*velimaXyanuMdi/velimaXyanuMci/velimaXyalonuMdi/velimaXyalonuMci	n number eka parsarg maXyanuMdi 
*velinadumanuMdi/velinadumanuMci	n number eka parsarg nadumanuMdi 
*veliwaravAwanuMdi/veliwarvAwanuMdi/veliwaravAwanuMci/veliwarvAwanuMci	n number eka parsarg waravAwanuMdi 
*velicotlonuMdi/velicotunuMdi/velicotlonuMci/velicotunuMci	n number eka parsarg cotlonuMdi 
velisWAnaMnuMdi/*velisWAnamunuMdi/velisWAnaMnuMci/velisWAnamunuMci/velisWAnaMlonuMdi/velisWAnamulonuMdi/velisWAnaMlonuMci/velisWAnamulonuMci	n number eka parsarg sWAnaMnuMdi 
velaMxu/velinaMxu/*veliyaMxu	n number eka parsarg aMxu 
velaMte/*velaMteV	n number eka parsarg aMte 
*velikaMteV/velikaMte/velukannA/velukanna/velikannA/velikanna	n number eka parsarg kaMteV 
*velEna	n number eka parsarg Ena 
*velipAti	n number eka parsarg pAti 
*velilAMti/velilAti	n number eka parsarg lAMti 
*velugAnI/velukAnI	n number eka parsarg gAni 
*velugA	n number eka parsarg gA 
*velYlYu/velYlu	n number bahu parsarg 0  case d
velYlulArA/*velYlYU/velYlU	n number bahu parsarg I  case d
-	n number bahu parsarg gA 
*velYlYagAdu/velYlagAdu	n number bahu parsarg gAdu  case d
*velYlYagawweV/velYlagawweV	n number bahu parsarg gawweV  case d
*velYlYavAdu/velYlavAdu/velYlodu	n number bahu parsarg vAdu  case d
*velYlYAyana/velYlAyana	n number bahu parsarg Ayana  case d
*velYlYavAru/velYlavAru/velYloru	n number bahu parsarg vAru  case d
*velYlaxi/velYlaxi	n number bahu parsarg xi  case d
*velYlYavi/velYlay	n number bahu parsarg vi  case d
*velYlYagAru/velYlagAru	n number bahu parsarg gAru  case d
*velYlYaM/velYlaM/velYlamu	n number bahu parsarg nu  case d
*velYlYu/velYlu	n number bahu parsarg vu 
*velYlYayoVkka/velYlayoVkka	n number bahu parsarg yoVkka 
*velYlYa/velYla	n number bahu parsarg obl 
*velYlYani/velYlani/velYlanu	n number bahu parsarg ni 
*velYlYaki/velYlaki/velYlaku	n number bahu parsarg ki 
*velYlYawo/velYlawo/velYlawoda/velYlawoti	n number bahu parsarg wo 
*velYlYalo/velYlalo/velYlallo/velYlallona/velYlalona/velYlalopala	n number bahu parsarg lo 
*velYlYalloni/velYlalloni/velYlaloni/velYlalopali/velYlayaMxali	n number bahu parsarg loni 
*velYlYamIxa/velYlamIxa	n number bahu parsarg mIxa 
*velYlYana/velYlana	n number bahu parsarg na 
velYlaniMci/velYlanuMci/*velYlYanuMdi/velYlanuMdi	n number bahu parsarg niMci 
*velYlYaxvArA/velYlaxvArA/velYlaxvAra	n number bahu parsarg xvArA 
*velYlYavalana/velYlavalana/velYlavalla	n number bahu parsarg valana 
*velYlYanubatti/velYlanubatti	n number bahu parsarg batti 
*velYlYacewa/velYlacewa/velYlace	n number bahu parsarg ce 
*velYlYawopAtu/velYlawopAtu/velYlawobAtu	n number bahu parsarg wopAtu 
*velYlYawokUdi/velYlawokUdi/velYlawogUdi/velYlawokUda/velYlawogUdA/velYlawokUdA	n number bahu parsarg wokUdi 
*velYlYakosaM/velYlakosaM/velYlakE/velYlArWaM	n number bahu parsarg kosaM 
*velYlYakoVraku/velYlakoVraku/velYlakoVrYaku	n number bahu parsarg koVraku 
*velYlYalonuMdi/velYlalonuMdi/velYlalonuMci/velYlaloniMci	n number bahu parsarg lonuMdi 
*velYlYamIxanuMdi/velYlamIxanuMdi/velYlamIxanuMci/velYlamIxaniMci	n number bahu parsarg mIxanuMdi 
*velYlYaxAkA/velYlaxAkA/velYlaxAka	n number bahu parsarg xAkA 
*velYlYavaraku/velYlavaraku	n number bahu parsarg varaku 
*velYlYamIxaki/velYlamIxaki/velYlamIxaku/velYlamIxiki	n number bahu parsarg mIxaki 
*velYlYaxaggara/velYlaxaggara/velYlaxaggira	n number bahu parsarg xaggara 
*velYlYavaxxa/velYlavaxxa/velYloVxxa	n number bahu parsarg vaxxa 
*velYlYakAda/velYlakAda	n number bahu parsarg kAda 
velYleVxurugA/*velYlYakeVxurugA/velYlakeVxurugA	n number bahu parsarg keVxurugA 
*velYlYamuMxu/velYlamuMxu	n number bahu parsarg muMxu 
*velYlYaguriMci/velYlaguriMci/velYlagUrci/velYlanuguriMci/velYlanigUrci	n number bahu parsarg guriMci 
velYlapE/velYlapEni/*velYlYapEna/velYlapEna	n number bahu parsarg pE 
*velYlYapEki/velYlapEki	n number bahu parsarg pEki 
*velYlYaguMdA/velYlaguMdA	n number bahu parsarg guMdA 
velYlalA/velYlalAga/*velYlYalAgA/velYlalAgA	n number bahu parsarg lA 
velYlavale/*velYlYavaleV/velYlavaleV/velYlamAxiri/velYlanupoli/velYlanubolina	n number bahu parsarg vale 
*velYlYakumalle/velYlakumalle/velYlakumalleV	n number bahu parsarg kimalle 
*velYlYanukUdA/velYlanukUdA/velYlukUdA/velYlugUdA/velYlanugUdA	n number bahu parsarg kUdA 
*velYlYaxqRtilo/velYlaxqRtilo/velYlaxruRtilo	n number bahu parsarg xqRtilo 
*velYlYulekuMdA/velYlulekuMdA/velYlanulekuMdA/velYluleka	n number bahu parsarg lekuMdA 
velYlukAkuMdA/*velYlYukAkuMda/velYlukAkuMda/velYlukAka/velYlugAkuMdA/velYlugAkuMda/velYlugAka	n number bahu parsarg kAkuMdA 
*velYlYumoVxalukoVni/velYlumoVxalukoVni/velYlanumoVxalukoVni	n number bahu parsarg moVxalukoVni 
*velYlYavEpu/velYlavEpu/velYlavepu/velYlakesi	n number bahu parsarg vEpu 
velYlapakka/velYlapakkana/*velYlYaprakka/velYlaprakka/velYlaprakkana	n number bahu parsarg pakka 
velYlapakkalo/*velYlYaprakkalo/velYlaprakkalo	n number bahu parsarg pakkalo 
*velYlYaloki/velYlaloki/velYlaloniki/velYlalopalaki/velYlalopaliki/velYlalopaliki/velYlalopalaku	n number bahu parsarg lopalaki 
velYlakiMxa/*velYlYakriMxa/velYlakriMxa/velYlakriMxane/velYlakiMxane	n number bahu parsarg kiMxa 
velYladuguna/*velYlYakaduguna/velYlakaduguna	n number bahu parsarg aduguna 
velYlakeVlla/*velYlYakalla/velYlakalla	n number bahu parsarg kalla 
velYlaveVnuka/velYlaveVnaka/*velYlYaveVnakAla/velYlaveVnakAla/velYlaveVnukAla/velYlaveVnakAwala/velYlaveVnukAwala	n number bahu parsarg veVnuka 
velYlawaravAwa/velYlawarvAwa/*velYlYawaruvAwa/velYlawaruvAwa	n number bahu parsarg waravAwa 
velYleVxuruguMdA/*velYlYakeVxuruguMdA/velYlakeVxuruguMdA	n number bahu parsarg eVxuruguMdA 
*velYlYamaXya/velYlamaXya/velYlamaXyana/velYlamaXyalo	n number bahu parsarg maXya 
*velYlYanaduma/velYlanaduma/velYlakinaduma	n number bahu parsarg naduma 
velYlabaxulugA/velYlakibaxulugA/velYlabaxulu/*velYlYakibaxulu/velYlakibaxulu/velYlanubaxulu	n number bahu parsarg baxulugA 
*velYlYacotlo/velYlacotlo/velYlacotulo	n number bahu parsarg cotlo 
velYlasWAnaMlo/velYlaswAnaMlo/*velYlYasWAnamulo/velYlasWAnamulo	n number bahu parsarg sWAnaMlo 
velYlanerugA/velYlakunerugA/*velYlYakinerugA/velYlakinerugA	n number bahu parsarg nerugA 
*velYlYaprakAraM/velYlaprakAraM/velYlanubatti/velYlabatti/velYlanibatti	n number bahu parsarg prakAraM 
*velYlYaxaggaranuMdi/velYlaxaggaranuMdi/velYlaxaggiranuMdi/velYlaxaggaranuMci/velYlaxaggiranuMci	n number bahu parsarg xaggaranuMdi 
*velYlYavaxxanuMdi/velYlavaxxanuMdi/velYlavaxxanuMci	n number bahu parsarg vaxxanuMdi 
*velYlYapakkanuMdi/velYlapakkanuMdi/velYlapakkanuMci/velYlapakkalonuMdi/velYlapakkalonuMci	n number bahu parsarg pakkanuMdi 
*velYlYalopalanuMdi/velYlalopalanuMdi/velYlalopalanuMci/velYlalopalinuMdi/velYlalopalinuMci	n number bahu parsarg lopalanuMdi 
*velYlYabEtanuMdi/velYlabEtanuMdi/velYlabEtanuMci/velYlabEtaniMci	n number bahu parsarg bEtanuMdi 
*velYlYapEnuMdi/velYlapEnuMdi/velYlapEnuMci/velYlapEniMci	n number bahu parsarg pEnuMdi 
velYlakiMxanuMdi/velYlakiMxanuMci/velYlakiMxaniMci/*velYlYakriMxanuMdi/velYlakriMxanuMdi/velYlakriMxanuMci/velYlakriMxaniMci	n number bahu parsarg kriMxanuMdi 
*velYlYadugunuMdi/velYladugunuMdi/velYladugunuMci/velYladuguniMci	n number bahu parsarg adugunuMdi 
*velYlYamuMxunuMdi/velYlamuMxunuMdi/velYlamuMxunuMci/velYlamuMxuniMci	n number bahu parsarg muMxunuMdi 
velYlaveVnukanuMdi/velYlaveVnakanuMdi/*velYlYaveVnakAlanuMdi/velYlaveVnakAlanuMdi/velYlaveVnakAlanuMci/velYlaveVnukanuMci/velYlaveVnakanuMci/velYlaveVnakAwalanuMdi/velYlaveVnakAwalanuMci	n number bahu parsarg veVnukanuMdi 
velYleVxutinuMdi/velYlakeVxutinuMdi/velYleVxutanuMdi/*velYlYakeVxutanuMdi/velYlakeVxutanuMdi/velYleVxutinuMci/velYlakeVxutinuMci/velYleVxutanuMci/velYlakeVxutanuMci	n number bahu parsarg eVxutinuMdi 
*velYlYamaXyanuMdi/velYlamaXyanuMdi/velYlamaXyanuMci/velYlamaXyaniMci/velYlamaXyalonuMdi/velYlamaXyalonuMci/velYlamaXyaloniMci	n number bahu parsarg maXyanuMdi 
*velYlYanadumanuMdi/velYlanadumanuMdi/velYlanadamanuMdi/velYlanadumanuMci/velYlanadumaniMci/velYlanadamanuMci	n number bahu parsarg nadumanuMdi 
*velYlYawaravAwanuMdi/velYlawaravAwanuMdi/velYlawarvAwanuMdi/velYlawaravAwanuMci/velYlawarvAwanuMci	n number bahu parsarg waravAwanuMdi 
velYlacotunuMdi/velYlacotunuMci/velYlacotlonuMci/velYlacotloniMci/*velYlYacotlonuMdi/velYlacotlonuMdi	n number bahu parsarg cotlonuMdi 
*velYlYasWAnamunuMdi/velYlasWAnamunuMdi/velYlasWAnaMnuMdi/velYlasWAnamunuMci/velYlasWAnaMnuMci/velYlasWAnaMlonuMdi/velYlasWAnamulonuMdi/velYlasWAnaMlonuMci/velYlasWAnamulonuMci	n number bahu parsarg sWAnaMnuMdi 
*velYlYayaMxu/velYlayaMxu/velYlaMxu	n number bahu parsarg aMxu 
velYlaMte/*velYlYaMteV/velYlaMteV	n number bahu parsarg aMte 
*velYlYakaMteV/velYlakaMteV/velYlakaMte/velYlakanna/velYlakannA	n number bahu parsarg kaMteV 
*velYlYEna/velYlEna	n number bahu parsarg Ena 
*velYlYapAti/velYlapAti	n number bahu parsarg pAti 
*velYlYalAMti/velYlalAMti/velYlalAti	n number bahu parsarg lAMti 
*velYlYugAnI/velYlugAnI/velYlukAnI	n number bahu parsarg gAni 
*velYlYugA/velYlugA	n number bahu parsarg gA 
