noun	
wiragali	
*wiragali	n number eka parsarg 0  case d
-	n number eka parsarg I 
-	n number eka parsarg gA 
*wiragaligAdu	n number eka parsarg gAdu  case d
*wiragaligawweV	n number eka parsarg gawweV  case d
*wiragalivAdu	n number eka parsarg vAdu  case d
*wiragalAyana	n number eka parsarg Ayana  case d
*wiragalivAru	n number eka parsarg vAru  case d
*wiragalixi/wiragalxi	n number eka parsarg xi  case d
*wiragalivi/wiragaliy	n number eka parsarg vi  case d
*wiragaligAru	n number eka parsarg gAru  case d
*wiragalini	n number eka parsarg nu 
*wiragalivi	n number eka parsarg vu  case d
*wiragaliyoVkka	n number eka parsarg yoVkka 
wiragati/*wiragali	n number eka parsarg obl 
*wiragalini/wiragalni/wiragatini	n number eka parsarg ni 
*wiragaliki/wiragatiki	n number eka parsarg ki 
*wiragaliwo/wiragaliwoda/wiragaliwoti/wiragaliwoni/wiragatiwo/wiragatiwoda/wiragatiwoti/wiragatiwoni	n number eka parsarg wo 
wiragalilo/wiragalilona/*wiragalilopala/wiragatlo/wiragatilo/wiragatilona/wiragatilopala/wiragatlo	n number eka parsarg lo 
wiragaliloni/*wiragalilopali/wiragaliyaMxali/wiragatiloni/wiragatilopali/wiragatiyaMxali	n number eka parsarg loni 
*wiragalimIxa	n number eka parsarg mIxa 
*wiragalina	n number eka parsarg na 
wiragaliniMci/wiragalinuMci/*wiragalinuMdi	n number eka parsarg niMci 
*wiragalixvArA/wiragalixvAra	n number eka parsarg xvArA 
*wiragalivalana/wiragalivalla	n number eka parsarg valana 
*wiragalinibatti/wiragalnibatti	n number eka parsarg batti 
wiragalice/*wiragalicewa	n number eka parsarg ce 
*wiragaliwopAtu/wiragaliwobAtu	n number eka parsarg wopAtu 
*wiragaliwokUdi/wiragaliwokUda/wiragaliwokUdA/wiragaliwogUdi/wiragaliwogUdA	n number eka parsarg wokUdi 
*wiragalikosaM/wiragalikE/wiragalArWaM	n number eka parsarg kosaM 
*wiragalikoVraku/wiragalikoVrYaku	n number eka parsarg koVraku 
*wiragalilonuMdi/wiragalilonuMci/wiragaliloniMci	n number eka parsarg lonuMdi 
*wiragalimIxanuMdi/wiragalimIxanuMci/wiragalimIxaniMci/wiragalimIxinuMdi	n number eka parsarg mIxanuMdi 
*wiragalixAkA/wiragalixAka	n number eka parsarg xAkA 
*wiragalivaraku	n number eka parsarg varaku 
*wiragalimIxaki/wiragalimIxaku/wiragalimIxiki	n number eka parsarg mIxaki 
*wiragalixaggara/wiragalixaggira	n number eka parsarg xaggara 
*wiragalivaxxa/wiragaloVxxa	n number eka parsarg vaxxa 
*wiragalikAda	n number eka parsarg kAda 
*wiragalikeVxurugA/wiragaleVxurugA	n number eka parsarg keVxurugA 
*wiragalimuMxu	n number eka parsarg muMxu 
*wiragaliguriMci/wiragaliniguriMci/wiragalinigUrci	n number eka parsarg guriMci 
wiragalipE/*wiragalipEna/wiragalipEni	n number eka parsarg pE 
*wiragalipEki	n number eka parsarg pEki 
*wiragaliguMdA	n number eka parsarg guMdA 
wiragalilA/wiragalilAga/*wiragalilAgA	n number eka parsarg lA 
wiragalivale/*wiragalivaleV/wiragalimAxiri/wiragalinipolina/wiragalinibolina	n number eka parsarg vale 
wiragalikimalle/*wiragalikimalleV	n number eka parsarg kimalle 
*wiragalikUdA/wiragalnikUdA/wiragalinukUdA/wiragaligUdA/wiragalnigUdA	n number eka parsarg kUdA 
*wiragalixqRtilo/wiragalixruRtilo	n number eka parsarg xqRtilo 
*wiragalilekuMdA/wiragalinilekuMdA/wiragalileka/wiragalinilekuMda	n number eka parsarg lekuMdA 
*wiragalikAkuMdA/wiragalinikAkuMdA/wiragalikAka/wiragaligAka	n number eka parsarg kAkuMdA 
*wiragalimoVxalukoVni/wiragalinimoVxalukoVni/wiragalinumoVxalukoVni	n number eka parsarg moVxalukoVni 
*wiragalivEpu/wiragalivepu/wiragalikesi	n number eka parsarg vEpu 
wiragalipakka/wiragaliprakka/wiragalipakkana/*wiragaliprakkana/wiragalipakkani	n number eka parsarg pakka 
wiragalipakkalo/*wiragaliprakkalo/wiragalipakkalona/wiragalipakkaloni	n number eka parsarg pakkalo 
wiragaliloki/wiragaliloniki/*wiragalilopalaki/wiragalilopalaku/wiragalilopaliki/wiragatilopalaku/wiragatilopaliki/wiragatilopalaki	n number eka parsarg lopalaki 
wiragalikiMxa/*wiragalikriMxa/wiragalikriMxana/wiragalikiMxana	n number eka parsarg kiMxa 
wiragaladuguna/*wiragalikaduguna/wiragatikaduguna	n number eka parsarg aduguna 
wiragalikeVlla/*wiragalikalla	n number eka parsarg kalla 
wiragaliveVnuka/*wiragaliveVnakAla/wiragaliveVnakAwala/wiragaliveVnakana	n number eka parsarg veVnuka 
wiragaliwaravAwa/wiragaliwarvAwa/*wiragaliwaruvAwa/wiragaliwaravAwana/wiragaliwarvAwana/wiragaliwaruvAwana	n number eka parsarg waravAwa 
wiragaleVxuruguMdA/*wiragalikeVxuruguMdA	n number eka parsarg eVxuruguMdA 
wiragalimaXya/*wiragalimaXyalo/wiragalimaXyana	n number eka parsarg maXya 
*wiragalinaduma/wiragalinadumana	n number eka parsarg naduma 
wiragalibaxulugA/wiragalibaxulu/*wiragalikibaxulu/wiragalikubaxulu	n number eka parsarg baxulugA 
wiragalicotlo/*wiragalicotulo/wiragalicotuna/wiragalicota	n number eka parsarg cotlo 
wiragalisWAnaMlo/wiragaliswAnaMlo/*wiragalisWAnamulo	n number eka parsarg sWAnaMlo 
wiragalinerugA/wiragalikunerugA/*wiragalikinerugA	n number eka parsarg nerugA 
*wiragaliprakAraM/wiragaliprakAramu	n number eka parsarg prakAraM 
*wiragalixaggaranuMdi/wiragalixaggaranuMci/wiragalixaggiranuMdi/wiragalixaggiranuMci	n number eka parsarg xaggaranuMdi 
*wiragalivaxxanuMdi/wiragalivaxxanuMci/wiragalivaxxaniMci	n number eka parsarg vaxxanuMdi 
*wiragalipakkanuMdi/wiragalipakkanuMci/wiragalipakkaniMci/wiragalipakkalonuMdi/wiragalipakkalonuMci/wiragalipakkaloniMci	n number eka parsarg pakkanuMdi 
*wiragalilopalanuMdi/wiragalilopalanuMci/wiragalilopalaniMci	n number eka parsarg lopalanuMdi 
*wiragalibEtanuMdi/wiragalibEtanuMci/wiragalibEtaniMci	n number eka parsarg bEtanuMdi 
*wiragalipEnuMdi/wiragalipEnuMci/wiragalipEniMci	n number eka parsarg pEnuMdi 
wiragalikiMxanuMdi/wiragalikiMxanuMci/wiragalikiMxaniMci/*wiragalikriMxanuMdi/wiragalikriMxanuMci/wiragalikriMxaniMci	n number eka parsarg kriMxanuMdi 
wiragaladugunuMdi/wiragaladugunuMci/*wiragalikadugunuMdi/wiragalikadugunuMci/wiragalikaduguniMci	n number eka parsarg adugunuMdi 
*wiragalimuMxunuMdi/wiragalimuMxunuMci/wiragalimuMxuniMci	n number eka parsarg muMxunuMdi 
wiragaliveVnukanuMdi/*wiragaliveVnakAlanuMdi/wiragaliveVnakAwalanuMdi/wiragaliveVnakanuMdi/wiragaliveVnukanuMci/wiragaliveVnakAlanuMci/wiragaliveVnakAwalanuMci/wiragaliveVnakanuMci	n number eka parsarg veVnukanuMdi 
wiragaleVxutinuMdi/*wiragalikeVxutinuMdi/wiragalikeVxutinuMci/wiragaleVxutinuMci	n number eka parsarg eVxutinuMdi 
*wiragalimaXyanuMdi/wiragalimaXyanuMci/wiragalimaXyalonuMdi/wiragalimaXyalonuMci	n number eka parsarg maXyanuMdi 
*wiragalinadumanuMdi/wiragalinadumanuMci	n number eka parsarg nadumanuMdi 
wiragaliwaravAwanuMdi/wiragaliwarvAwanuMdi/wiragaliwaravAwanuMci/wiragaliwarvAwanuMci/*wiragaliwaruvAwanuMdi	n number eka parsarg waravAwanuMdi 
*wiragalicotlonuMdi/wiragalicotunuMdi/wiragalicotlonuMci/wiragalicotunuMci	n number eka parsarg cotlonuMdi 
wiragalisWAnaMnuMdi/*wiragalisWAnamunuMdi/wiragalisWAnaMnuMci/wiragalisWAnamunuMci/wiragalisWAnaMlonuMdi/wiragalisWAnamulonuMdi/wiragalisWAnaMlonuMci/wiragalisWAnamulonuMci	n number eka parsarg sWAnaMnuMdi 
wiragalaMxu/wiragalinaMxu/*wiragaliyaMxu	n number eka parsarg aMxu 
wiragalaMte/*wiragalaMteV	n number eka parsarg aMte 
*wiragalikaMteV/wiragalikaMte/wiragalikanna/wiragalikannA	n number eka parsarg kaMteV 
*wiragalEna	n number eka parsarg Ena 
*wiragalipAti	n number eka parsarg pAti 
*wiragalilAMti/wiragalilAti	n number eka parsarg lAMti 
*wiragaligAnI/wiragalikAnI	n number eka parsarg gAni 
*wiragaligA	n number eka parsarg gA 
wiragalYlu/*wiragalYlYu   	n number bahu parsarg 0  case d
wiragalYlU/wiragalYlalArA/*wiragalYlYalArA	n number bahu parsarg I  case d
-	n number bahu parsarg gA 
*wiragalYlYagAdu/wiragalYlagAdu   	n number bahu parsarg gAdu  case d
*wiragalYlYagawweV/wiragalYlagawweV   	n number bahu parsarg gawweV  case d
*wiragalYlYavAdu/wiragalYlavAdu/wiragalYlodu   	n number bahu parsarg vAdu  case d
*wiragalYlYAyana/wiragalYlAyana	n number bahu parsarg Ayana  case d
*wiragalYlYavAru/wiragalYlavAru/wiragalYloru   	n number bahu parsarg vAru  case d
*wiragalYlYaxi/wiragalYlaxi  	n number bahu parsarg xi  case d
*wiragalYlYavi/wiragalYlavi  	n number bahu parsarg vi  case d
*wiragalYlYagAru/wiragalYlagAru   	n number bahu parsarg gAru  case d
*wiragalYlYaM/wiragalYlaM/wiragalYlamu    	n number bahu parsarg nu  case d
*wiragalYlYu/wiragalYlu                   	n number bahu parsarg vu 
*wiragalYlYayoVkka/wiragalYlayoVkka    	n number bahu parsarg yoVkka 
*wiragalYlYa/wiragalYla       	n number bahu parsarg obl 
*wiragalYlYani/wiragalYlani/wiragalYlanu   	n number bahu parsarg ni 
*wiragalYlYaki/wiragalYlaki/wiragalYlaku   	n number bahu parsarg ki 
*wiragalYlYawo/wiragalYlawo/wiragalYlawoti/wiragalYlawoda   	n number bahu parsarg wo 
wiragalYlalo/*wiragalYlYalopala/wiragalYlalopala/wiragalYlalona/wiragalYlYalo	n number bahu parsarg lo 
wiragalYlaloni/*wiragalYlYalopali/wiragalYlalopali/wiragalYlayaMxali	n number bahu parsarg loni 
*wiragalYlYamIxa/wiragalYlamIxa	n number bahu parsarg mIxa 
*wiragalYlYana/wiragalYlana	n number bahu parsarg na 
wiragalYlaniMci/wiragalYlanuMci/*wiragalYlYanuMdi/wiragalYlanuMdi	n number bahu parsarg niMci 
*wiragalYlYaxvArA/wiragalYlaxvArA/wiragalYlaxvAra	n number bahu parsarg xvArA 
*wiragalYlYavalana/wiragalYlavalana/wiragalYlavalla	n number bahu parsarg valana 
*wiragalYlYanubatti/wiragalYlanubatti/wiragalYlanibatti/wiragalYlYanubatti	n number bahu parsarg batti 
*wiragalYlYacewa/wiragalYlacewa/wiragalYlace	n number bahu parsarg ce 
wiragalYlawobAtu/wiragalYlawopAtu/*wiragalYlYawopAtu	n number bahu parsarg wopAtu 
wiragalYlawogUdi/wiragalYlawokUdi/*wiragalYlYawokUdi/wiragalYlawokUda/wiragalYlawokUdA/wiragalYlYawokUdA	n number bahu parsarg wokUdi 
*wiragalYlYakosaM/wiragalYlakosaM/wiragalYlakE/wiragalYlArWaM/wiragalYlArWaM	n number bahu parsarg kosaM 
*wiragalYlYakoVraku/wiragalYlakoVraku/wiragalYlakoVrYaku	n number bahu parsarg koVraku 
wiragalYlalonuMci/*wiragalYlYalonuMdi/wiragalYlalonuMdi/wiragalYlaloniMci	n number bahu parsarg lonuMdi 
*wiragalYlYamIxanuMdi/wiragalYlamIxanuMdi/wiragalYlamIxanuMci/wiragalYlamIxaniMci	n number bahu parsarg mIxanuMdi 
*wiragalYlYaxAkA/wiragalYlaxAkA/wiragalYlaxAka	n number bahu parsarg xAkA 
*wiragalYlYavaraku/wiragalYlavaraku	n number bahu parsarg varaku 
*wiragalYlYamIxaki/wiragalYlamIxaki/wiragalYlamIxaku/wiragalYlamIxiki	n number bahu parsarg mIxaki 
*wiragalYlYaxaggara/wiragalYlaxaggara/wiragalYlaxaggira	n number bahu parsarg xaggara 
*wiragalYlYavaxxa/wiragalYlavaxxa/wiragalYloVxxa	n number bahu parsarg vaxxa 
*wiragalYlYakAda/wiragalYlakAda	n number bahu parsarg kAda 
wiragalYleVxurugA/wiragalYlakeVxurugA/*wiragalYlYakeVxurugA	n number bahu parsarg keVxurugA 
*wiragalYlYamuMxu/wiragalYlamuMxu	n number bahu parsarg muMxu 
*wiragalYlYaguriMci/wiragalYlaguriMci/wiragalYlagUrci/wiragalYlanuguriMci/wiragalYlanigUrci	n number bahu parsarg guriMci 
wiragalYlapE/wiragalYlapEni/wiragalYlapEna/*wiragalYlYapEna	n number bahu parsarg pE 
*wiragalYlYapEki/wiragalYlapEki	n number bahu parsarg pEki 
*wiragalYlYaguMdA/wiragalYlaguMdA	n number bahu parsarg guMdA 
wiragalYlalA/wiragalYlalAga/wiragalYlalAgA/*wiragalYlYalAgA	n number bahu parsarg lA 
*wiragalYlYavaleV/wiragalYlavale/wiragalYlavaleV/wiragalYlamAxiri/wiragalYlanupoli/wiragalYlanubolina	n number bahu parsarg vale 
wiragalYlakumalle/wiragalYlakumalleV/*wiragalYlYakumalleV	n number bahu parsarg kimalle 
wiragalYlanukUdA/wiragalYlakUdA/*wiragalYlYukUdA/wiragalYlanugUdA/wiragalYlugUdA	n number bahu parsarg kUdA 
*wiragalYlYaxqRtilo/wiragalYlaxqRtilo/wiragalYlaxruRtilo	n number bahu parsarg xqRtilo 
*wiragalYlYulekuMdA/wiragalYlulekuMdA/wiragalYluleka	n number bahu parsarg lekuMdA 
*wiragalYlYukAkuMdA/wiragalYlukAkuMdA/wiragalYlukAka/wiragalYlugAka	n number bahu parsarg kAkuMdA 
*wiragalYlYumoVxalukoVni/wiragalYlumoVxalukoVni/wiragalYlanumoVxalukoVni	n number bahu parsarg moVxalukoVni 
*wiragalYlYavEpu/wiragalYlavEpu/wiragalYlavepu/wiragalYlakesi	n number bahu parsarg vEpu 
wiragalYlapakka/wiragalYlapakkana/wiragalYlaprakka/*wiragalYlYaprakkana/wiragalYlaprakkana	n number bahu parsarg pakka 
wiragalYlapakkalo/wiragalYlaprakkalo/*wiragalYlYaprakkalo	n number bahu parsarg pakkalo 
wiragallaloki/wiragallaloniki/wiragalYlalopalaki/*wiragalYlYalopalaki/wiragalYlalopaliki/wiragalYlalopalaku	n number bahu parsarg lopalaki 
wiragalYlakiMxa/wiragalYlakriMxa/*wiragalYlYakriMxa/wiragalYlakriMxana/wiragalYlakiMxana	n number bahu parsarg kiMxa 
wiragalYladuguna/wiragalYlakaduguna/*wiragalYlYakaduguna	n number bahu parsarg aduguna 
wiragalYlakeVlla/wiragalYlakalla/*wiragalYlYakalla	n number bahu parsarg kalla 
wiragalYlaveVnuka/wiragalYlaveVnaka/wiragalYlaveVnakAla/*wiragalYlYaveVnakAla/wiragalYlaveVnukAla/wiragalYlaveVnakAwala/wiragalYlaveVnukAwala	n number bahu parsarg veVnuka 
wiragalYlawaravAwa/wiragalYlawarvAwa/wiragalYlawaruvAwa/*wiragalYlYawaruvAwa	n number bahu parsarg waravAwa 
wiragalYleVxuruguMdA/wiragalYlakeVxuruguMdA/*wiragalYlYakeVxuruguMdA	n number bahu parsarg eVxuruguMdA 
wiragalYlamaXya/wiragalYlamaXyana/wiragalYlamaXyalo/*wiragalYlYamaXyalo	n number bahu parsarg maXya 
wiragalYlanaduma/wiragalYlakinaduma/*wiragalYlYakinaduma	n number bahu parsarg naduma 
wiragalYlabaxulugA/wiragalYlakibaxulugA/wiragalYlabaxulu/wiragalYlakibaxulu/wiragalYlnubaxulu/*wiragalYlYakibaxulu	n number bahu parsarg baxulugA 
*wiragalYlYacotlo/wiragalYlacotlo/wiragalYlacotulo	n number bahu parsarg cotlo 
wiragalYlasWAnaMlo/wiragalYlaswAnaMlo/wiragalYlasWAnamulo/*wiragalYlYasWAnamulo	n number bahu parsarg sWAnaMlo 
wiragalYlanerugA/wiragalYlakunerugA/wiragalYlakinerugA/*wiragalYlYakinerugA	n number bahu parsarg nerugA 
*wiragalYlYaprakAraM/wiragalYlaprakAraM/wiragalYlanubatti/wiragalYlabatti/wiragalYlanibatti	n number bahu parsarg prakAraM 
wiragalYlaxaggaranuMdi/*wiragalYlYaxaggaranuMdi/wiragalYlaxaggiranuMdi/wiragalYlaxaggaranuMci/wiragalYlaxaggiranuMci	n number bahu parsarg xaggaranuMdi 
wiragalYlavaxxanuMdi/*wiragalYlYavaxxanuMdi/wiragalYlavaxxanuMci	n number bahu parsarg vaxxanuMdi 
wiragalYlapakkanuMdi/*wiragalYlYapakkanuMdi/wiragalYlapakkanuMci/wiragalYlapakkalonuMdi/wiragalYlYapakkalonuMdi/wiragalYlapakkalonuMci	n number bahu parsarg pakkanuMdi 
wiragalYlalopalanuMdi/*wiragalYlYalopalanuMdi/wiragalYlalopalanuMci/wiragalYlalopalinuMdi/wiragalYlalopalinuMci	n number bahu parsarg lopalanuMdi 
wiragalYlabEtanuMdi/*wiragalYlYabEtanuMdi/wiragalYlabEtanuMci/wiragalYlabEtaniMci	n number bahu parsarg bEtanuMdi 
wiragalYlapEnuMdi/*wiragalYlYapEnuMdi/wiragalYlapEnuMci/wiragalYlapEniMci	n number bahu parsarg pEnuMdi 
wiragalYlakiMxanuMdi/wiragalYlYakiMxanuMdi/wiragalYlakiMxanuMci/wiragalYlakiMxaniMci/wiragalYlakriMxanuMdi/*wiragalYlYakriMxanuMdi/wiragalYlakriMxanuMci/wiragalYlakriMxaniMci	n number bahu parsarg kriMxanuMdi 
wiragalYladugunuMdi/*wiragalYlYadugunuMdi/wiragalYladugunuMci/wiragalYladuguniMci	n number bahu parsarg adugunuMdi 
*wiragalYlYamuMxunuMdi/wiragalYlamuMxunuMdi/wiragalYlamuMxunuMci/wiragalYlamuMxuniMci	n number bahu parsarg muMxunuMdi 
wiragalYlaveVnukanuMdi/wiragalYlaveVnakanuMdi/wiragalYlaveVnakAlanuMdi/*wiragalYlYaveVnakAlanuMdi/wiragalYlYaveVnakAlanuMci/wiragalYlaveVnakAlanuMci/wiragalYlaveVnukanuMci/wiragalYlaveVnakanuMci/wiragalYlaveVnakAwalanuMdi/wiragalYlaveVnakAwalanuMci	n number bahu parsarg veVnukanuMdi 
wiragalYleVxutinuMdi/*wiragalYlYakeVxutinuMdi/wiragalYlakeVxutinuMdi/wiragalYleVxutanuMdi/wiragalYlakeVxutanuMdi/wiragalYleVxutinuMci/wiragalYlakeVxutinuMci/wiragalYleVxutanuMci/wiragalYlakeVxutanuMci	n number bahu parsarg eVxutinuMdi 
*wiragalYlYamaXyanuMdi/wiragalYlamaXyanuMdi/wiragalYlamaXyanuMci/wiragalYlamaXyaniMci/wiragalYlYamaXyalonuMdi/wiragalYlamaXyalonuMdi/wiragalYlamaXyalonuMci/wiragalYlamaXyaloniMci	n number bahu parsarg maXyanuMdi 
*wiragalYlYanadumanuMdi/wiragalYlanadumanuMdi/wiragalYlanadamanuMdi/wiragalYlanadumanuMci/wiragalYlanadamanuMci	n number bahu parsarg nadumanuMdi 
*wiragalYlYawaravAwanuMdi/wiragalYlawaravAwanuMdi/wiragalYlawarvAwanuMdi/wiragalYlawaravAwanuMci/wiragalYlawarvAwanuMci	n number bahu parsarg waravAwanuMdi 
wiragalYlacotunuMdi/wiragalYlacotunuMci/wiragalYlacotlonuMci/wiragalYlacotloniMci/*wiragalYlYacotlonuMdi/wiragalYlacotlonuMdi/wiragalYlacotulonuMci	n number bahu parsarg cotlonuMdi 
*wiragalYlYasWAnamunuMdi/wiragalYlasWAnamunuMdi/wiragalYlasWAnaMnuMdi/wiragalYlasWAnamunuMci/wiragalYlasWAnaMnuMci/wiragalYlasWAnaMlonuMdi/wiragalYlYasWAnamulonuMdi/wiragalYlasWAnamulonuMdi/wiragalYlasWAnaMlonuMci/wiragalYlYasWAnamulonuMci/wiragalYlasWAnamulonuMci	n number bahu parsarg sWAnaMnuMdi 
*wiragalYlYayaMxu/wiragalYlayaMxu/wiragalYlaMxu	n number bahu parsarg aMxu 
wiragalYlaMte/*wiragalYlYaMteV/wiragalYlaMteV	n number bahu parsarg aMte 
*wiragalYlYakaMteV/wiragalYlakaMteV/wiragalYlakaMte/wiragalYlakanna/wiragalYlakannA	n number bahu parsarg kaMteV 
*wiragalYlYEna/wiragalYlEna	n number bahu parsarg Ena 
wiragalYlapAti/*wiragalYlYapAti	n number bahu parsarg pAti 
*wiragalYlYalAMti/wiragalYlalAMti/wiragalYlalAti	n number bahu parsarg lAMti 
*wiragalYlYugAnI/wiragalYlugAnI/wiragalYlukAnI	n number bahu parsarg gAni 
wiragalYlugA/*wiragalYlYugA	n number bahu parsarg gA 
