noun	
xAri	
*xAri	n number eka parsarg 0 
-	n number eka parsarg I 
-	n number eka parsarg gA 
*xArigAdu	n number eka parsarg gAdu 
*xArigawweV	n number eka parsarg gawweV 
*xArivAdu	n number eka parsarg vAdu 
*xArAyana	n number eka parsarg Ayana 
*xArivAru	n number eka parsarg vAru 
*xArixi	n number eka parsarg xi 
*xArivi/xAriy	n number eka parsarg vi 
*xArigAru	n number eka parsarg gAru 
*xArini/xArinu	n number eka parsarg nu 
xArivu/*xArivi	n number eka parsarg vu 
*xAriyoVkka	n number eka parsarg yoVkka 
*xAri	n number eka parsarg obl 
*xArini/xArinu	n number eka parsarg ni 
*xAriki/xAriku	n number eka parsarg ki 
*xAriwo/xAriwoda/xAriwoti	n number eka parsarg wo 
*xArilo/xArilona/xArilopala	n number eka parsarg lo 
xAriloni/*xArilopali/xAriyaMxali	n number eka parsarg loni 
*xArimIxa	n number eka parsarg mIxa 
*xArina	n number eka parsarg na 
xAriniMci/xArinuMci/*xArinuMdi	n number eka parsarg niMci 
*xArixvArA/xArixvAra	n number eka parsarg xvArA 
*xArivalana/xArivalla	n number eka parsarg valana 
*xArinibatti/xArnibatti	n number eka parsarg batti 
xArice/*xAricewa	n number eka parsarg ce 
*xAriwopAtu/xAriwobAtu	n number eka parsarg wopAtu 
*xAriwokUdi/xAriwokUda/xAriwokUdA/xAriwogUdi/xAriwogUda/xAriwogUdA	n number eka parsarg wokUdi 
*xArikosaM/xArikE/xArArWaM	n number eka parsarg kosaM 
*xArikoVraku/xArikoVrYaku	n number eka parsarg koVraku 
*xArilonuMdi/xArilonuMci/xAriloniMci	n number eka parsarg lonuMdi 
*xArimIxanuMdi/xArimIxanuMci/xArimIxaniMci	n number eka parsarg mIxanuMdi 
*xArixAkA/xArixAka	n number eka parsarg xAkA 
*xArivaraku	n number eka parsarg varaku 
*xArimIxaki/xArimIxaku/xArimIxiki	n number eka parsarg mIxaki 
*xArixaggara/xArixaggira	n number eka parsarg xaggara 
*xArivaxxa/xAroVxxa/xAriyoVxxa	n number eka parsarg vaxxa 
*xArikAda	n number eka parsarg kAda 
*xArikeVxurugA/xAreVxurugA	n number eka parsarg keVxurugA 
*xArimuMxu	n number eka parsarg muMxu 
*xAriguriMci/xAriniguriMci/xArinigUrci	n number eka parsarg guriMci 
xAripE/*xAripEna/xAripEni	n number eka parsarg pE 
*xAripEki	n number eka parsarg pEki 
*xAriguMdA	n number eka parsarg guMdA 
xArilA/xArilAga/*xArilAgA	n number eka parsarg lA 
xArivale/*xArivaleV/xArimAxiri/xArinipolina/xArinibolina	n number eka parsarg vale 
*xArikimalle/xArikimalleV	n number eka parsarg kimalle 
*xArikUdA/xArinikUdA/xArinukUdA/xArigUdA/xArinigUdA	n number eka parsarg kUdA 
*xArixqRtilo/xArixruRtilo	n number eka parsarg xqRtilo 
xArilekuMdA/xArinilekuMdA/*xArilekuMda/xArinulekuMdA	n number eka parsarg lekuMdA 
xArikAkuMdA/xArinikAkuMdA/*xArikAkuMda/xArikAka/xArigAka/xArigAkuMdA	n number eka parsarg kAkuMdA 
*xArimoVxalukoVni/xArinimoVxalukoVni/xArinumoVxalukoVni	n number eka parsarg moVxalukoVni 
*xArivEpu/xArivepu/xArikesi	n number eka parsarg vEpu 
xAripakka/xAriprakka/xAripakkana/*xAriprakkana/xAripakkani	n number eka parsarg pakka 
*xAripakkalo/xAriprakkalo/xAripakkalona/xAripakkaloni	n number eka parsarg pakkalo 
xAriloki/xAriloniki/*xArilopalaki/xArilopalaku/xArilopaliki	n number eka parsarg lopalaki 
xArikiMxa/*xArikriMxa/xArikriMxana/xArikiMxana	n number eka parsarg kiMxa 
xAraduguna/*xArikaduguna	n number eka parsarg aduguna 
xArikeVlla/*xArikalla	n number eka parsarg kalla 
xAriveVnuka/xAriveVnaka/xAriveVnakAwala/*xAriveVnakAla/xAriveVnakana	n number eka parsarg veVnuka 
xAriwaravAwa/xAriwarvAwa/*xAriwaruvAwa/xAriwaravAwana/xAriwarvAwana/xAriwaruvAwana	n number eka parsarg waravAwa 
xAreVxuruguMdA/*xArikeVxuruguMdA	n number eka parsarg eVxuruguMdA 
xArimaXya/*xArimaXyalo/xArimaXyana	n number eka parsarg maXya 
*xArinaduma/xArinadumana	n number eka parsarg naduma 
xAribaxulugA/xAribaxulu/xArikibaxulu/*xArikubaxulu 	n number eka parsarg baxulugA 
xAricotlo/*xAricotulo/xAricotuna/xAricota	n number eka parsarg cotlo 
xArisWAnaMlo/xAriswAnaMlo/*xArisWAnamulo	n number eka parsarg sWAnaMlo 
xArinerugA/xArikunerugA/*xArikinerugA	n number eka parsarg nerugA 
*xAriprakAraM/xAriprakAramu	n number eka parsarg prakAraM 
*xArixaggaranuMdi/xArixaggaranuMci/xArixaggiranuMdi/xArixaggiranuMci	n number eka parsarg xaggaranuMdi 
*xArivaxxanuMdi/xArivaxxanuMci/xArivaxxaniMci	n number eka parsarg vaxxanuMdi 
*xAripakkanuMdi/xAripakkanuMci/xAripakkaniMci/xAripakkalonuMdi/xAripakkalonuMci/xAripakkaloniMci	n number eka parsarg pakkanuMdi 
*xArilopalanuMdi/xArilopalinuMdi/xArilopalanuMci/xArilopalinuMci/xArilopalaniMci	n number eka parsarg lopalanuMdi 
*xAribEtanuMdi/xAribEtanuMci/xAribEtaniMci	n number eka parsarg bEtanuMdi 
*xAripEnuMdi/xAripEnuMci/xAripEniMci	n number eka parsarg pEnuMdi 
xArikiMxanuMdi/xArikiMxanuMci/xArikiMxaniMci/*xArikriMxanuMdi/xArikriMxanuMci/xArikriMxaniMci	n number eka parsarg kriMxanuMdi 
xAradugunuMdi/xAradugunuMci/*xArikadugunuMdi/xArikadugunuMci/xArikaduguniMci	n number eka parsarg adugunuMdi 
*xArimuMxunuMdi/xArimuMxunuMci/xArimuMxuniMci	n number eka parsarg muMxunuMdi 
xAriveVnukanuMdi/*xAriveVnakAlanuMdi/xAriveVnakAwalanuMdi/xAriveVnakanuMdi/xAriveVnukanuMci/xAriveVnakAlanuMci/xAriveVnakAwalanuMci/xAriveVnakanuMci	n number eka parsarg veVnukanuMdi 
xAreVxutinuMdi/xArikeVxutinuMdi/xArikeVxutinuMci/xAreVxutanuMci/*xArikeVxutanuMdi/xAreVxutanuMdi	n number eka parsarg eVxutinuMdi 
*xArimaXyanuMdi/xArimaXyanuMci/xArimaXyalonuMdi/xArimaXyalonuMci	n number eka parsarg maXyanuMdi 
*xArinadumanuMdi/xArinadumanuMci	n number eka parsarg nadumanuMdi 
*xAriwaruvAwanuMdi/xAriwaravAwanuMdi/xAriwarvAwanuMdi/xAriwaravAwanuMci/xAriwarvAwanuMci	n number eka parsarg waravAwanuMdi 
*xAricotlonuMdi/xAricotunuMdi/xAricotlonuMci/xAricotunuMci	n number eka parsarg cotlonuMdi 
xArisWAnaMnuMdi/*xArisWAnamunuMdi/xArisWAnaMnuMci/xArisWAnamunuMci/xArisWAnaMlonuMdi/xArisWAnamulonuMdi/xArisWAnaMlonuMci/xArisWAnamulonuMci	n number eka parsarg sWAnaMnuMdi 
xAraMxu/xArinaMxu/*xAriyaMxu	n number eka parsarg aMxu 
xAraMte/*xAraMteV	n number eka parsarg aMte 
*xArikaMteV/xArikaMte/xArikanna/xArikannA	n number eka parsarg kaMteV 
*xArEna/xAriyEna	n number eka parsarg Ena 
*xAripAti	n number eka parsarg pAti 
*xArilAMti/xArilAti	n number eka parsarg lAMti 
*xArigAnI/xArikAnI	n number eka parsarg gAni 
*xArigA	n number eka parsarg gA 
xArlu/*xArulu	n number bahu parsarg 0 
xArlU/*xArulArA/xArulAra	n number bahu parsarg I 
xArlagAdu/*xArulagAdu	n number bahu parsarg gA 
xArlagawweV/*xArulagawweV	n number bahu parsarg gAdu 
xArlavAdu/*xArulavAdu	n number bahu parsarg gawweV 
xArlAyana/*xArulAyana	n number bahu parsarg vAdu 
xArlavAru/*xArulavAru	n number bahu parsarg Ayana 
xArlaxi/*xArulaxi	n number bahu parsarg vAru 
xArlavi/*xArulavi/xArlay/xArulay	n number bahu parsarg xi 
xArlagAru/*xArulagAru	n number bahu parsarg vi 
xArlaM/xArlamu/*xArulaM/xArulamu	n number bahu parsarg gAru 
xArlu/*xArulu	n number bahu parsarg nu 
*xArulayoVkka	n number bahu parsarg vu 
xArla/xArlayoVkka/xArula/*xArulayoVkka	n number bahu parsarg yoVkka 
xArlani/xArlanu/xArulani/*xArulanu/xArilni	n number bahu parsarg obl 
xArlaki/xArlaku/*xArulaki/xArulaku	n number bahu parsarg ni 
xArlawo/xArlawoda/xArlawoti/xArlawoni/*xArulawo/xArulawoda/xArulawoti/xArulawoni	n number bahu parsarg ki 
xArlalo/xArulalo/xArlalona/xArulalona/xArlalopala/*xArulalopala	n number bahu parsarg wo 
xArlaloni/xArulaloni/xArlalopali/xArulayaMxali/*xArulalopali	n number bahu parsarg lo 
xArlamIxa/*xArulamIxa	n number bahu parsarg loni 
xArlana/*xArulana	n number bahu parsarg mIxa 
xArlaniMci/xArulaniMci/xArlanuMci/xArulanuMci/*xArulanuMdi/xArlanuMdi	n number bahu parsarg na 
xArlaxvArA/xArlaxvAra/*xArulaxvArA/xArulaxvAra	n number bahu parsarg niMci 
xArlavalana/xArlavalla/*xArulavalana/xArulavalla	n number bahu parsarg xvArA 
*xArulanubatti/xArlanubatti/xArulnibatti/xArlanibatti	n number bahu parsarg valana 
xArlacewa/xArlace/xArulace/*xArulacewa	n number bahu parsarg batti 
xArlawopAtu/xArlawobAtu/*xArulawopAtu/xArulawobAtu	n number bahu parsarg ce 
xArlawokUdi/*xArulawokUdi/xArlawokUda/xArulawokUdA/xArulawokUdA/xArulawogUdi/xArlawogUdi/xArlawogUdA/xArulawogUdA	n number bahu parsarg wopAtu 
xArlakosaM/xArlakE/*xArulakosaM/xArulakE/xArlArWaM	n number bahu parsarg wokUdi 
xArlakoVraku/xArlakoVrYaku/*xArulakoVraku/xArulakoVrYaku	n number bahu parsarg kosaM 
xArlalonuMdi/xArlalonuMci/*xArulalonuMdi/xArulalonuMci/xArulaloniMci/xArlaloniMci	n number bahu parsarg koVraku 
xArlamIxanuMdi/xArlamIxanuMci/xArlamIxaniMci/*xArulamIxanuMdi/xArulamIxanuMci/xArulamIxaniMci	n number bahu parsarg lonuMdi 
xArlaxAkA/xArlaxAka/xArulaxAkA/*xArulaxAka	n number bahu parsarg mIxanuMdi 
xArlavaraku/*xArulavaraku	n number bahu parsarg xAkA 
xArlamIxaki/xArlamIxaku/xArulamIxiki/*xArulamIxaki/xArulamIxaku/xArlamIxiki	n number bahu parsarg varaku 
xArlaxaggara/xArlaxaggira/*xArulaxaggara/xArulaxaggira	n number bahu parsarg mIxaki 
xArlavaxxa/xArloVxxa/*xArulavaxxa/xAruloVxxa	n number bahu parsarg xaggara 
xArlakAda/*xArulakAda	n number bahu parsarg vaxxa 
xArleVxurugA/xArlakeVxurugA/xAruleVxurugA/*xArulakeVxurugA	n number bahu parsarg kAda 
xArlamuMxu/*xArulamuMxu	n number bahu parsarg keVxurugA 
xArlaguriMci/xArlagUrci/xArlanuguriMci/xArulanigUrci/xArulaniguriMci/*xArulanuguriMci	n number bahu parsarg muMxu 
xArlapE/xArlapEni/xArlapEna/xArulapE/xArulapEni/*xArulapEna	n number bahu parsarg guriMci 
xArlapEki/*xArulapEki	n number bahu parsarg pE 
xArlaguMdA/*xArulaguMdA	n number bahu parsarg pEki 
xArulalA/*xArulalAgA/xArullA/xArlalA/xArlalAgA/xArullAgA	n number bahu parsarg guMdA 
xArlavale/xArlavaleV/xArlamAxiri/xArlanupolina/xArlanubolina/xArulavale/*xArulavaleV/xArulamAxiri/xArulanupolina/xArulanubolina	n number bahu parsarg lA 
xArlakumalle/xArulakumalle/xArlakumalleV/*xArulakumalleV	n number bahu parsarg vale 
xArlukUdA/xArlugUdA/xArlugUda/xArlakUda/*xArulukUdA/xArulugUdA/xArulugUda/xArulakUda	n number bahu parsarg kimalle 
xArlaxqRtilo/xArlaxruRtilo/*xArulaxqRtilo/xArulaxruRtilo	n number bahu parsarg kUdA 
xArlulekuMdA/xArlanulekuMdA/xArluleka/*xArululekuMdA/xArulanulekuMdA/xArululeka	n number bahu parsarg xqRtilo 
xArlukAkuMdA/xArlanukAkuMda/xArlukAka/xArlugAka/*xArulukAkuMdA/xArulanukAkuMda/xArulukAka/xArulugAka	n number bahu parsarg lekuMdA 
xArlumoVxalukoVni/xArlanumoVxalukoVni/*xArulumoVxalukoVni/xArulanumoVxalukoVni	n number bahu parsarg kAkuMdA 
xArlavEpu/xArlavepu/*xArulavEpu/xArulavepu/xArulakesi/xArlakesi	n number bahu parsarg moVxalukoVni 
xArlapakka/xArlapakkana/xArulaprakka/*xArulaprakkana	n number bahu parsarg vEpu 
xArlapakkalo/xArlaprakkalo/xArulapakkalo/*xArulaprakkalo	n number bahu parsarg pakka 
xArlaloki/xArlaloniki/xArulaloniki/*xArulaloki	n number bahu parsarg pakkalo 
xArlalopalaki/xArlalopaliki/*xArulalopaliki/xArulalopalaku	n number bahu parsarg lopalaki 
xArlakiMxa/xArlakriMxa/xArulakiMxa/*xArulakriMxa/xArlakriMxana/xArlakiMxana/xArulakriMxana/xArulakiMxana	n number bahu parsarg kiMxa 
xArladuguna/xArlakaduguna/xAruladuguna/*xArulakaduguna	n number bahu parsarg aduguna 
xArlakeVlla/xArlakalla/*xArulakeVlla/xArulakalla	n number bahu parsarg kalla 
xArlaveVnuka/xArlaveVnaka/xArlaveVnakAla/xArulaveVnukAla/xArulaveVnuka/xArulaveVnaka/*xArulaveVnakAla/xArulaveVnukAla/xArlaveVnakAwala/xArulaveVnukAwala/xArulaveVnakAwala/xArulaveVnukAwala	n number bahu parsarg veVnuka 
xArlawaravAwa/xArlawarvAwa/xArulawaravAwa/xArulawarvAwa/*xArulawaruvAwa	n number bahu parsarg waravAwa 
xArleVxuruguMdA/xArlakeVxuruguMdA/xAruleVxuruguMdA/*xArulakeVxuruguMdA	n number bahu parsarg eVxuruguMdA 
xArlamaXya/xArlamaXyana/xArlamaXyalo/xArulamaXya/xArulamaXyana/*xArulamaXyalo	n number bahu parsarg maXya 
xArlanaduma/xArlakinaduma/xArulanaduma/*xArulakinaduma	n number bahu parsarg naduma 
xArlabaxulugA/xArlakibaxulugA/xArlabaxulu/xArlakibaxulu/xArulabaxulu/xArulakubaxulu/*xArulakibaxulu	n number bahu parsarg baxulugA 
xArlacotlo/xArlacotulo/*xArulacotlo/xArulacotulo	n number bahu parsarg cotlo 
xArlasWAnaMlo/xArlaswAnaMlo/*xArulasWAnamulo/xArulasWAnaMlo/xArulaswAnaMlo/xArlasWAnamulo	n number bahu parsarg sWAnaMlo 
xArlanerugA/xArlakunerugA/xArlakinerugA/xArulanerugA/xArulakunerugA/*xArulakinerugA	n number bahu parsarg nerugA 
xArlaprakAraM/xArlanubatti/xArlabatti/xArlanibatti/*xArulaprakAraM/xArulanubatti/xArulabatti/xArulanibatti	n number bahu parsarg prakAraM 
xArlaxaggaranuMdi/xArlaxaggiranuMdi/xArlaxaggaranuMci/xArlaxaggiranuMci/*xArulaxaggaranuMdi/xArulaxaggiranuMdi/xArulaxaggaranuMci/xArulaxaggiranuMci	n number bahu parsarg xaggaranuMdi 
xArlavaxxanuMdi/xArlavaxxanuMci/*xArulavaxxanuMdi/xArulavaxxanuMci	n number bahu parsarg vaxxanuMdi 
xArlapakkanuMdi/xArlapakkanuMci/*xArulapakkanuMdi/xArulapakkanuMci/xArlapakkalonuMdi/xArlapakkalonuMci/xArulapakkalonuMdi/xArulapakkalonuMci	n number bahu parsarg pakkanuMdi 
xArlalopalanuMdi/xArlalopalanuMci/xArlalopalinuMdi/xArulalopalinuMci/*xArulalopalanuMdi/xArulalopalanuMci/xArulalopalinuMdi/xArulalopalinuMci	n number bahu parsarg lopalanuMdi 
xArlabEtanuMdi/xArlabEtanuMci/xArlabEtaniMci/*xArulabEtanuMdi/xArulabEtanuMci/xArulabEtaniMci	n number bahu parsarg bEtanuMdi 
xArlapEnuMdi/xArlapEnuMci/xArlapEniMci/*xArulapEnuMdi/xArulapEnuMci/xArulapEniMci	n number bahu parsarg pEnuMdi 
xArlakiMxanuMdi/xArlakiMxanuMci/xArlakiMxaniMci/xArulakiMxanuMdi/xArulakiMxanuMci/xArulakiMxaniMci/xArlakriMxanuMdi/xArlakriMxanuMci/xArlakriMxaniMci/*xArulakriMxanuMdi/xArulakriMxanuMci/xArulakriMxaniMci	n number bahu parsarg kriMxanuMdi 
xArladugunuMdi/xArladugunuMci/xArladuguniMci/*xAruladugunuMdi/xAruladugunuMci/xAruladuguniMci	n number bahu parsarg adugunuMdi 
xArlamuMxunuMdi/xArlamuMxunuMci/xArlamuMxuniMci/*xArulamuMxunuMdi/xArulamuMxunuMci/xArulamuMxuniMci	n number bahu parsarg muMxunuMdi 
xArlaveVnukanuMdi/xArlaveVnakanuMdi/xArlaveVnakAlanuMdi/xArulaveVnukanuMdi/xArulaveVnakanuMdi/*xArulaveVnakAlanuMdi/xArlaveVnakAlanuMci/xArlaveVnukanuMci/xArlaveVnakanuMci/xArulaveVnakAlanuMci/xArulaveVnukanuMci/xArulaveVnakanuMci/xArlaveVnakAwalanuMdi/xArlaveVnakAwalanuMci/xArulaveVnakAwalanuMdi/xArulaveVnakAwalanuMci	n number bahu parsarg veVnukanuMdi 
xArleVxutinuMdi/xArlakeVxutinuMdi/xAruleVxutinuMdi/xArulakeVxutinuMdi/xAruleVxutanuMdi/*xArulakeVxutanuMdi/xArleVxutanuMdi/xArlakeVxutanuMdi/xArleVxutinuMci/xArlakeVxutinuMci/xAruleVxutinuMci/xArulakeVxutinuMci/xAruleVxutanuMci/xArulakeVxutanuMci/xArleVxutanuMci/xArlakeVxutanuMci	n number bahu parsarg eVxutinuMdi 
xArlamaXyanuMdi/xArlamaXyanuMci/xArlamaXyaniMci/*xArulamaXyanuMdi/xArulamaXyanuMci/xArulamaXyaniMci/xArlamaXyalonuMdi/xArlamaXyalonuMci/xArlamaXyaloniMci/xArulamaXyalonuMdi/xArulamaXyalonuMci/xArulamaXyaloniMci	n number bahu parsarg maXyanuMdi 
xArlanadumanuMdi/xArlanadamanuMdi/*xArulanadumanuMdi/xArulanadamanuMdi/xArlanadumanuMci/xArlanadamanuMci/xArulanadumanuMci/xArulanadamanuMci	n number bahu parsarg nadumanuMdi 
xArlawaravAwanuMdi/xArlawarvAwanuMdi/xArulawaravAwanuMdi/*xArulawaruvAwanuMdi/xArulawarvAwanuMdi/xArlawaravAwanuMci/xArlawarvAwanuMci/xArulawaravAwanuMci/xArulawarvAwanuMci	n number bahu parsarg waravAwanuMdi 
xArlacotunuMdi/xArlacotunuMci/xArlacotuniMci/xArulacotunuMdi/xArulacotunuMci/xArulacotuniMci/xArlacotlonuMci/xArlacotloniMci/xArlacotulonuMci/xArlacotulonuMdi/xArulacotlonuMci/xArulacotloniMci/xArulacotulonuMci/*xArulacotulonuMdi	n number bahu parsarg cotlonuMdi 
xArlasWAnamunuMdi/xArlasWAnaMnuMdi/*xArulasWAnamunuMdi/xArulasWAnaMnuMdi/xArlasWAnamunuMci/xArlasWAnaMnuMci/xArulasWAnamunuMci/xArulasWAnaMnuMci/xArlasWAnaMlonuMdi/xArlasWAnamulonuMdi/xArulasWAnaMlonuMdi/xArulasWAnamulonuMdi/xArlasWAnaMlonuMci/xArlasWAnamulonuMci/xArulasWAnaMlonuMci/xArulasWAnamulonuMci	n number bahu parsarg sWAnaMnuMdi 
xArlayaMxu/xArlaMxu/*xArulayaMxu/xArulaMxu	n number bahu parsarg aMxu 
xArlaMte/xArlaMteV/xArulaMte/*xArulaMteV	n number bahu parsarg aMte 
xArlakaMteV/xArlakaMte/*xArulakaMteV/xArulakaMte/xArlakanna/xArlakannA/xArulakanna/xArulakannA	n number bahu parsarg kaMteV 
xArlEna/*xArulEna	n number bahu parsarg Ena 
xArlapAti/*xArulapAti	n number bahu parsarg pAti 
xArlulAMti/xArlulAti/*xArululAMti/xArululAti	n number bahu parsarg lAMti 
*xArlugAnI/xArlukAnI	n number bahu parsarg gAni 
xArlugA/*xArulugA	n number bahu parsarg gA 
