noun	
xrAyi	
*xrAyi	n number eka parsarg 0 
-	n number eka parsarg I 
-	n number eka parsarg gA 
*xrAyigAdu/xrAwigAdu	n number eka parsarg gAdu 
*xrAyigawweV/xrAwigawweV	n number eka parsarg gawweV 
*xrAyivAdu/xrAwivAdu	n number eka parsarg vAdu 
*xrAyAyana/xrAwAyana	n number eka parsarg Ayana 
*xrAyivAru/xrAwivAru	n number eka parsarg vAru 
*xrAyixi/xrAwixi	n number eka parsarg xi 
*xrAyivi	n number eka parsarg vi 
*xrAyigAru/xrAwigAru	n number eka parsarg gAru 
*xrAyini	n number eka parsarg nu 
*xrAyivi	n number eka parsarg vu 
xrAwiyoVkka/*xrAyiyoVkka	n number eka parsarg yoVkka 
*xrAwi	n number eka parsarg obl 
*xrAyini/xrAwini	n number eka parsarg ni 
*xrAyiki/xrAyiku/xrAwiki/xrAwiku	n number eka parsarg ki 
*xrAyiwo/xrAyiwoda/xrAwiwo/xrAwiwoda	n number eka parsarg wo 
*xrAyilo/xrAyilona/xrAwilo/xrAwilona/xrAyilopala/xrAwilopala	n number eka parsarg lo 
xrAyiloni/xrAwiloni/*xrAyilopali/xrAwiyaMxali/xrAwilopali	n number eka parsarg loni 
*xrAyimIxa/xrAwimIxa	n number eka parsarg mIxa 
*xrAyina/xrAwina	n number eka parsarg na 
xrAyiniMci/xrAyinuMci/*xrAyinuMdi/xrAwiniMci/xrAwinuMci/xrAwinuMdi	n number eka parsarg niMci 
*xrAyixvAxrA/xrAwixvAxrA/xrAyixvAra/xrAwixvAra	n number eka parsarg xvArA 
*xrAyivalana/xrAyivalla/xrAwivalana/xrAwivalla	n number eka parsarg valana 
*xrAyinibatti/xrAyibatti/xrAwinibatti	n number eka parsarg batti 
xrAyice/*xrAyicewa/xrAwice/xrAwicewa	n number eka parsarg ce 
*xrAyiwopAtu/xrAwiwopAtu	n number eka parsarg wopAtu 
*xrAyiwokUdi/xrAyiwokUda/xrAyiwokUdA/xrAwiwogUdi/xrAwiwogUdA/xrAyiwogUdA/xrAwiwokUdi	n number eka parsarg wokUdi 
*xrAyikosaM/xrAyikE/xrAwikosaM/xrAwikE/xrAyArWaM	n number eka parsarg kosaM 
*xrAyikoVraku/xrAyikoVrYaku/xrAwikoVraku/xrAwikoVrYaku	n number eka parsarg koVraku 
*xrAyilonuMdi/xrAyilonuMci/xrAwilonuMdi/xrAwilonuMci	n number eka parsarg lonuMdi 
*xrAyimIxanuMdi/xrAyimIxanuMci/xrAwimIxanuMdi/xrAwimIxanuMci	n number eka parsarg mIxanuMdi 
*xrAyixAkA/xrAyixAka/xrAwixAkA/xrAwixAka	n number eka parsarg xAkA 
*xrAyivaraku/xrAwivaraku	n number eka parsarg varaku 
*xrAyimIxaki/xrAyimIxaku/xrAwimIxaki/xrAwimIxaku	n number eka parsarg mIxaki 
*xrAyixaggara/xrAwixaggara/xrAyixaggira/xrAwixaggira	n number eka parsarg xaggara 
*xrAyivaxxa/xrAwivaxxa	n number eka parsarg vaxxa 
*xrAyikAda/xrAwikAda	n number eka parsarg kAda 
*xrAyikeVxurugA/xrAyeVxurugA/xrAwikeVxurugA	n number eka parsarg keVxurugA 
*xrAyimuMxu/xrAwimuMxu	n number eka parsarg muMxu 
*xrAyiguriMci/xrAyiniguriMci/xrAwiguriMci/xrAwiniguriMci	n number eka parsarg guriMci 
xrAyipE/*xrAyipEna/xrAwipE/xrAwipEna	n number eka parsarg pE 
*xrAyipEki/xrAwipEki	n number eka parsarg pEki 
*xrAyiguMdA/xrAwiguMdA	n number eka parsarg guMdA 
xrAyilA/xrAyilAga/*xrAyilAgA/xrAwilA/xrAwilAga/xrAwilAgA	n number eka parsarg lA 
*xrAyivale/xrAyimAxiri/xrAyinipoli/xrAwivale/xrAwimAxiri/xrAwinipoli	n number eka parsarg vale 
*xrAyikimalle/xrAwikimalle/xrAyikimalleV/xrAwikimalleV	n number eka parsarg kimalle 
*xrAyikUdA/xrAyinikUdA/xrAwinikUdA/xrAyigUdA/xrAwinigUdA	n number eka parsarg kUdA 
*xrAyixqRtilo/xrAyixruRtilo/xrAwixqRtilo/xrAwixruRtilo	n number eka parsarg xqRtilo 
*xrAyilekuMdA/xrAyileka/xrAwinilekuMdA	n number eka parsarg lekuMdA 
*xrAyikAkuMdA/xrAyikAka/xrAwinigAka/rayigAka/xrAwinikAkuMdA	n number eka parsarg kAkuMdA 
*xrAyimoVxalukoVni/xrAyinimoVxalukoVni/xrAwinimoVxalukoVni	n number eka parsarg moVxalukoVni 
*xrAyivEpu/xrAwivEpu/xrAyikesi/xrAwikesi	n number eka parsarg vEpu 
xrAyipakka/*xrAyiprakka/xrAyipakkana/xrAwipakka/xrAwiprakka/xrAwipakkana	n number eka parsarg pakka 
xrAyipakkalo/*xrAyiprakkalo/xrAwipakkalo/xrAwiprakkalo	n number eka parsarg pakkalo 
*xrAyiloki/xrAwiloki/xrAyiloniki/xrAwiloniki/xrAyilopaliki/xrAyilopalaki/xrAyilopalaku/xrAwilopalaki/xrAwilopalaku/xrAwilopaliki	n number eka parsarg lopalaki 
xrAyikiMxa/*xrAyikriMxa/xrAwikiMxa/xrAwikriMxa/xrAyikriMxane/xrAyikiMxane/xrAwikriMxane/xrAwikiMxane	n number eka parsarg kiMxa 
xrAyaduguna/*xrAyikaduguna/xrAwikaduguna/xrAwaduguna	n number eka parsarg aduguna 
xrAyikeVlla/*xrAyikalla/xrAwikeVlla/xrAwikalla	n number eka parsarg kalla 
xrAyiveVnuka/*xrAyiveVnakAla/xrAyiveVnakAwala/xrAwiveVnuka/xrAwiveVnakAla/xrAwiveVnakAwala	n number eka parsarg veVnuka 
xrAyiwaravAwa/xrAyiwarvAwa/*xrAyiwaruvAwa/xrAwiwaravAwa/xrAwiwarvAwa/xrAwiwaruvAwa	n number eka parsarg waravAwa 
xrAyeVxuruguMdA/*xrAyikeVxuruguMdA/xrAweVxuruguMdA/xrAwikeVxuruguMdA	n number eka parsarg eVxuruguMdA 
*xrAyimaXya/xrAyimaXyalo/xrAyimaXyana/xrAwimaXya/xrAwimaXyalo/xrAwimaXyana	n number eka parsarg maXya 
*xrAyinaduma/xrAwinaduma	n number eka parsarg naduma 
xrAyibaxulugA/xrAyibaxulu/*xrAyikibaxulu/xrAwibaxulu/xrAwikibaxulu	n number eka parsarg baxulugA 
*xrAyicotlo/xrAyicotulo/xrAyicotuna/xrAwicotulo/xrAwicotlo/xrAwicotuna	n number eka parsarg cotlo 
*xrAyisWAnaMlo/xrAyiswAnaMlo/xrAwisWAnaMlo/xrAwiswAnaMlo	n number eka parsarg sWAnaMlo 
xrAyinerugA/xrAyikunerugA/*xrAyikinerugA/xrAwikinerugA	n number eka parsarg nerugA 
*xrAyiprakAraM/xrAyiprakAramu/xrAwiprakAramu/xrAyinibatti/xrAwiprakAraM/xrAwinibatti	n number eka parsarg prakAraM 
*xrAyixaggaranuMdi/xrAyixaggaranuMci/xrAwixaggaranuMdi/xrAwixaggaranuMci	n number eka parsarg xaggaranuMdi 
*xrAyivaxxanuMdi/xrAyivaxxanuMci/xrAwivaxxanuMdi/xrAwivaxxanuMci	n number eka parsarg vaxxanuMdi 
*xrAyipakkanuMdi/xrAyipakkanuMci/xrAwipakkanuMdi/xrAwipakkanuMci/xrAyipakkalonuMdi/xrAyipakkalonuMci/xrAwipakkalonuMdi/xrAwipakkalonuMci	n number eka parsarg pakkanuMdi 
*xrAyilopalanuMdi/xrAyilopalanuMci/xrAwilopalanuMdi/xrAwilopalanuMci	n number eka parsarg lopalanuMdi 
*xrAyibEtanuMdi/xrAyibEtanuMci/xrAwibEtanuMdi/xrAwibEtanuMci	n number eka parsarg bEtanuMdi 
*xrAyipEnuMdi/xrAyipEnuMci/xrAwipEnuMdi/xrAwipEnuMci	n number eka parsarg pEnuMdi 
xrAyikiMxanuMdi/xrAyikiMxanuMci/xrAwikiMxanuMdi/xrAwikiMxanuMci/*xrAyikriMxanuMdi/xrAyikriMxanuMci/xrAwikriMxanuMdi/xrAwikriMxanuMci	n number eka parsarg kriMxanuMdi 
xrAyadugunuMdi/xrAyadugunuMci/*xrAyikadugunuMdi/xrAyikadugunuMci/xrAwikadugunuMdi/xrAwikadugunuMci	n number eka parsarg adugunuMdi 
*xrAyimuMxunuMdi/xrAyimuMxunuMci/xrAwimuMxunuMdi/xrAwimuMxunuMci	n number eka parsarg muMxunuMdi 
xrAyiveVnukanuMdi/*xrAyiveVnakAlanuMdi/xrAyiveVnakAwalanuMdi/xrAwiveVnakanuMdi/xrAwiveVnakanuMci/xrAyiveVnukanuMci/xrAyiveVnakAlanuMci/xrAyiveVnakAwalanuMci/xrAwiveVnakAlanuMdi/xrAwiveVnakAlanuMci	n number eka parsarg veVnukanuMdi 
xrAyeVxutinuMdi/xrAyeVxutanuMdi/xrAyikeVxutinuMdi/xrAwikeVxutinuMci/xrAwikeVxutinuMdi/*xrAwikeVxutanuMdi	n number eka parsarg eVxutinuMdi 
*xrAyimaXyanuMdi/xrAyimaXyanuMci/xrAwimaXyanuMdi/xrAwimaXyanuMci/xrAyimaXyalonuMdi/xrAyimaXyalonuMci/xrAwimaXyalonuMdi/xrAwimaXyalonuMci	n number eka parsarg maXyanuMdi 
*xrAyinadumanuMdi/xrAyinadumanuMci/xrAwinadumanuMdi/xrAwinadumanuMci	n number eka parsarg nadumanuMdi 
*xrAyiwarvAwanuMdi/xrAwiwaravAwanuMdi/xrAyiwaravAwanuMci/xrAyiwarvAwanuMci/xrAwiwaravAwanuMci	n number eka parsarg waravAwanuMdi 
*xrAyicotlonuMdi/xrAyicotunuMdi/xrAwicotlonuMdi/xrAwicotunuMdi/xrAyicotlonuMci/xrAwicotlonuMci/xrAwicotunuMci	n number eka parsarg cotlonuMdi 
xrAyisWAnaMnuMdi/xrAwisWAnaMnuMdi/*xrAyisWAnamunuMdi/xrAyisWAnaMnuMci/xrAwisWAnaMnuMci/xrAwisWAnamunuMci/xrAyisWAnamulonuMdi/xrAyisWAnaMlonuMci/xrAyisWAnaMlonuMci/xrAwisWAnamulonuMci	n number eka parsarg sWAnaMnuMdi 
*xrAyaMxu/xrAyinaMxu/xrAwinaMxu/xrAwiyaMxu	n number eka parsarg aMxu 
*xrAyaMte/xrAwaMte/xrAyaMteV/xrAwaMteV	n number eka parsarg aMte 
*xrAyikaMteV/xrAyikaMte/xrAwikaMte/xrAwikaMteV/xrAyikannA/xrAwikannA/xrAyikanna/xrAwikanna	n number eka parsarg kaMteV 
*xrAyEna/xrAyiyEna	n number eka parsarg Ena 
*xrAyipAti/xrAwipAti	n number eka parsarg pAti 
*xrAyilAMti/xrAyilAti	n number eka parsarg lAMti 
*xrAyigAnI/xrAyikAnI	n number eka parsarg gAni 
*xrAyigA/xrAwigA	n number eka parsarg gA 
xrAyilu/*xrAlYlYu/xrAlYlu	n number bahu parsarg 0 
xrAyilU/*xrAlYlYU/xrAlYlU/xrAlYlulAxrA	n number bahu parsarg I 
-	n number bahu parsarg gA 
xrAyilagAdu/*xrAlYlYagAdu/xrAlYlagAdu	n number bahu parsarg gAdu 
xrAyilagawweV/*xrAlYlYagawweV/xrAlYlagawweV	n number bahu parsarg gawweV 
xrAyilavAdu/*xrAlYlYavAdu/xrAlYlavAdu	n number bahu parsarg vAdu 
xrAyilAyana/*xrAlYlYAyana/xrAlYlAyana	n number bahu parsarg Ayana 
xrAyilavAru/*xrAlYlYavAru/xrAlYlavAru	n number bahu parsarg vAru 
xrAyilaxi/*xrAlYlYaxi/xrAlYlaxi	n number bahu parsarg xi 
*xrAlYlYavi/xrAlYlavi/xrAlYlay	n number bahu parsarg vi 
xrAyilagAru/*xrAlYlYagAru/xrAlYlagAru	n number bahu parsarg gAru 
*xrAlYlYaM/xrAlYlaM/xrAlYlamu	n number bahu parsarg nu 
xrAyilu/*xrAlYlYu/xrAlYlu	n number bahu parsarg vu 
*xrAlYlYayoVkka/xrAlYlayoVkka	n number bahu parsarg yoVkka 
*xrAlYlYa/xrAlYla	n number bahu parsarg obl 
*xrAlYlYani/xrAlYlani/xrAlYlanu/xrAyilni	n number bahu parsarg ni 
*xrAlYlYaki/xrAlYlaki/xrAlYlaku	n number bahu parsarg ki 
*xrAlYlYawo/xrAlYlawo/xrAlYlawoda	n number bahu parsarg wo 
*xrAlYlYallo/xrAlYlallo/xrAlYlalo/xrAlYlalopala/xrAlYlalona	n number bahu parsarg lo 
*xrAlYlYaloni/xrAlYlaloni/xrAlYlalopali/xrAlYlayaMxali	n number bahu parsarg loni 
*xrAlYlYamIxa/xrAlYlamIxa	n number bahu parsarg mIxa 
*xrAlYlYamIna/xrAlYlamIna	n number bahu parsarg na 
xrAlYlaniMci/xrAlYlanuMci/*xrAlYlYanuMdi/xrAlYlanuMdi	n number bahu parsarg niMci 
*xrAlYlYaxvAxrA/xrAlYlaxvAxrA/xrAlYlaxvAra	n number bahu parsarg xvArA 
*xrAlYlYavalana/xrAlYlavalana/xrAlYlavalla	n number bahu parsarg valana 
*xrAlYlYanubatti/xrAlYlanubatti/xrAlYlanibatti	n number bahu parsarg batti 
*xrAlYlYacewa/xrAlYlacewa/xrAlYlace	n number bahu parsarg ce 
*xrAlYlYawopAtu/xrAlYlawopAtu/xrAlYlawobAtu	n number bahu parsarg wopAtu 
*xrAlYlYawokUdi/xrAlYlawokUdi/xrAlYlawokUda/xrAlYlawokUdA	n number bahu parsarg wokUdi 
*xrAlYlYakosaM/xrAlYlakosaM/xrAlYlakE/xrAlYlArWaM	n number bahu parsarg kosaM 
*xrAlYlYakoVraku/xrAlYlakoVraku/xrAlYlakoVrYaku	n number bahu parsarg koVraku 
*xrAlYlYalonuMdi/xrAlYlalonuMdi/xrAlYlalonuMci/xrAlYlallonuMdi/xrAlYlallonuMci/xrAlYlalloniMci/xrAlYlaloniMci	n number bahu parsarg lonuMdi 
*xrAlYlYamIxanuMdi/xrAlYlamIxanuMdi/xrAlYlamIxanuMci/xrAlYlamIxaniMci	n number bahu parsarg mIxanuMdi 
*xrAlYlYaxAkA/xrAlYlaxAkA/xrAlYlaxAka	n number bahu parsarg xAkA 
*xrAlYlYavaraku/xrAlYlavaraku	n number bahu parsarg varaku 
*xrAlYlYamIxaki/xrAlYlamIxaki/xrAlYlamIxaku	n number bahu parsarg mIxaki 
*xrAlYlYaxaggara/xrAlYlaxaggara/xrAlYlaxaggira	n number bahu parsarg xaggara 
*xrAlYlYavaxxa/xrAlYlavaxxa/xrAlYloVxxa	n number bahu parsarg vaxxa 
xrAyilakAda/*xrAlYlYakAda/xrAlYlakAda	n number bahu parsarg kAda 
xrAlYleVxurugA/*xrAlYlYakeVxurugA/xrAlYlakeVxurugA	n number bahu parsarg keVxurugA 
*xrAlYlYamuMxu/xrAlYlamuMxu	n number bahu parsarg muMxu 
*xrAlYlYaguriMci/xrAlYlaguriMci/xrAlYlagUrci/xrAlYlanuguriMci/xrAlYlanugUrci	n number bahu parsarg guriMci 
xrAlYlapE/*xrAlYlYapEna/xrAlYlapEna	n number bahu parsarg pE 
xrAyilapEki/xrAlYlapayiki/*xrAlYlYapEki	n number bahu parsarg pEki 
xrAyilaguMdA/*xrAlYlYaguMda/xrAlYlaguMda	n number bahu parsarg guMdA 
xrAlYlalA/xrAlYlallA/xrAlYlalAga/*xrAlYlYalAgA/xrAlYlalAgA/xrAlYlallAga/xrAlYlallAgA	n number bahu parsarg lA 
*xrAlYlYavale/xrAlYlavale/xrAlYlavaleV/xrAlYlamAxiri/xrAlYlanupoli/xrAlYlanipoli	n number bahu parsarg vale 
*xrAlYlYakumalle/xrAlYlakumalle/xrAlYlakumalleV/xrAlYlakimalleV/xrAlYlakimalle	n number bahu parsarg kimalle 
*xrAlYlYukUdA/xrAlYlukUdA/xrAlYlugUdA/xrAlYlanikUdA/xrAlYlanukUdA/xrAlYlanigUdA	n number bahu parsarg kUdA 
*xrAlYlYaxqRtilo/xrAlYlaxqRtilo/xrAlYlaxruRtilo	n number bahu parsarg xqRtilo 
xrAyilulekuMdA/*xrAlYlYulekuMda/xrAlYlulekuMda/xrAlYluleka	n number bahu parsarg lekuMdA 
xrAyilukAkuMdA/*xrAlYlYukAkuMda/xrAlYlukAkuMda/xrAlYlukAka/xrAlYlugAka	n number bahu parsarg kAkuMdA 
*xrAlYlYumoVxalukoVni/xrAlYlumoVxalukoVni/xrAlYlanumoVxalukoVni	n number bahu parsarg moVxalukoVni 
*xrAlYlYavEpu/xrAlYlavEpu/xrAlYlavepu/xrAlYlakesi	n number bahu parsarg vEpu 
xrAlYlapakka/*xrAlYlYaprakka/xrAlYlaprakka/xrAlYlapakkana/xrAlYlaprakkana	n number bahu parsarg pakka 
xrAlYlapakkalo/*xrAlYlYaprakkalo/xrAlYlaprakkalo	n number bahu parsarg pakkalo 
*xrAlYlYaloki/xrAlYlaloki/xrAlYlaloniki/xrAlYlalopalaki/xrAlYlalopaliki/xrAlYlalopalaku	n number bahu parsarg lopalaki 
xrAlYlakiMxa/*xrAlYlYakriMxa/xrAlYlakriMxa/xrAyilakriMxa/xrAlYlakriMxa/xrAlYlakiMxana/xrAlYlakriMxana/xrAyilakiMxana/xrAlYlakiMxana	n number bahu parsarg kiMxa 
xrAlYladuguna/*xrAlYlYakaduguna/xrAlYlakaduguna	n number bahu parsarg aduguna 
xrAyilakalla/*xrAlYlYakalla/xrAlYlakalla/xrAyilakeVlla/xrAlYlakeVlla	n number bahu parsarg kalla 
xrAlYlaveVnuka/xrAlYlaveVnaka/*xrAlYlYaveVnakAla/xrAlYlaveVnakAla/xrAlYlaveVnakAwala/xrAlYlaveVnukAwala	n number bahu parsarg veVnuka 
xrAlYlawaravAwa/*xrAlYlYawaruvAwa/xrAlYlawaruvAwa/xrAlYlawarvAwa/xrAlYlawarvAwana	n number bahu parsarg waravAwa 
xrAlYleVxuruguMdA/*xrAlYlYakeVxuruguMda/xrAlYlakeVxuruguMda	n number bahu parsarg eVxuruguMdA 
*xrAlYlYamaXya/xrAlYlamaXya/xrAlYlamaXyana/xrAlYlamaXyalo	n number bahu parsarg maXya 
*xrAlYlYanaduma/xrAlYlanaduma/xrAlYlanadama	n number bahu parsarg naduma 
xrAlYlabaxulugA/*xrAlYlYabaxulu/xrAlYlabaxulu	n number bahu parsarg baxulugA 
*xrAlYlYacotlo/xrAlYlacotlo/xrAlYlacotulo	n number bahu parsarg cotlo 
xrAlYlasWAnaMlo/xrAlYlasWAnamulo/xrAlYlaswAnaMlo/*xrAlYlYaswAnamulo/xrAlYlaswAnamulo	n number bahu parsarg sWAnaMlo 
xrAyilanerugA/xrAlYlanerugA/xrAlYlakunerugA/*xrAlYlYakinerugA/xrAlYlakinerugA	n number bahu parsarg nerugA 
*xrAlYlYaprakAraM/xrAlYlaprakAraM/xrAlYlanubatti/xrAlYlabatti	n number bahu parsarg prakAraM 
*xrAlYlYaxaggaranuMdi/xrAlYlaxaggaranuMdi/xrAlYlaxaggiranuMdi/xrAlYlaxaggaranuMci/xrAlYlaxaggaraniMci	n number bahu parsarg xaggaranuMdi 
*xrAlYlYavaxxanuMdi/xrAlYlavaxxanuMdi/xrAlYlavaxxanuMci/xrAlYlavaxxaniMci	n number bahu parsarg vaxxanuMdi 
*xrAlYlYapakkanuMdi/xrAlYlapakkanuMdi/xrAlYlapakkanuMci/xrAlYlapakkaniMci/xrAlYlapakkalonuMdi/xrAlYlapakkalonuMci/xrAlYlapakkaloniMci	n number bahu parsarg pakkanuMdi 
*xrAlYlYalopalanuMdi/xrAlYlalopalanuMdi/xrAlYlalopatanuMdi/xrAlYlalopalanuMci/xrAlYlalopalinuMci/xrAlYlalopalinuMdi/xrAlYlalopalaniMci	n number bahu parsarg lopalanuMdi 
*xrAlYlYabEtanuMdi/xrAlYlabEtanuMdi/xrAlYlabEtanuMci/xrAlYlabEtaniMci	n number bahu parsarg bEtanuMdi 
*xrAlYlYapEnuMdi/xrAlYlapEnuMdi/xrAlYlapEnuMci/xrAlYlapEniMci	n number bahu parsarg pEnuMdi 
xrAlYlakiMxanuMdi/xrAlYlakiMxanuMci/xrAlYlakiMxaniMci/*xrAlYlYakriMxanuMdi/xrAlYlakriMxanuMdi/xrAlYlakriMxanuMci/xrAlYlakriMxaniMci	n number bahu parsarg kriMxanuMdi 
xrAlYladugunuMdi/*xrAlYlYakadugunuMdi/xrAlYlakadugunuMdi/xrAlYladugunuMci/xrAlYlakadugunuMci/xrAlYladuguniMci/xrAlYlakaduguniMci	n number bahu parsarg adugunuMdi 
*xrAlYlYamuMxunuMdi/xrAlYlamuMxunuMdi/xrAlYlamuMxunuMci/xrAlYlamuMxuniMci	n number bahu parsarg muMxunuMdi 
xrAlYlaveVnakanuMdi/xrAlYlaveVnukanuMdi/*xrAlYlYaveVnakAlanuMdi/xrAlYlaveVnakAlanuMdi/xrAlYlaveVnukanuMci/xrAlYlaveVnakanuMci/xrAlYlaveVnakAlanuMci/xrAlYlaveVnakAwalanuMci/xrAlYlaveVnakAwalanuMdi	n number bahu parsarg veVnukanuMdi 
xrAlYleVxutinuMdi/xrAlYleVxutanuMdi/*xrAlYlYakeVxutinuMdi/xrAlYlakeVxutinuMdi/xrAlYleVxutinuMci/xrAlYleVxutinuMci/xrAlYlakeVxutinuMci	n number bahu parsarg eVxutinuMdi 
*xrAlYlYamaXyanuMdi/xrAlYlamaXyanuMdi/xrAlYlamaXyanuMci/xrAlYlamaXyaniMci/xrAlYlamaXyalonuMdi/xrAlYlamaXyalonuMci/xrAlYlamaXyaloniMci	n number bahu parsarg maXyanuMdi 
*xrAlYlYanadumanuMdi/xrAlYlanadumanuMdi/xrAlYlanadamanuMdi/xrAlYlanadumanuMci/xrAlYlanadumaniMci	n number bahu parsarg nadumanuMdi 
*xrAlYlYawaravAwanuMdi/xrAlYlawaravAwanuMdi/xrAlYlawarvAwanuMdi/xrAlYlawaravAwanuMci/xrAlYlawarvAwanuMci/xrAlYlawarvAwaniMci/xrAlYlawaravAwaniMci	n number bahu parsarg waravAwanuMdi 
xrAlYlacotunuMci/xrAlYlacotunuMdi/xrAlYlacotuniMci/xrAlYlacotlonuMci/*xrAlYlYacotlonuMdi/xrAlYlacotlonuMdi/xrAlYlacotulonuMci/xrAlYlacotulonuMdi	n number bahu parsarg cotlonuMdi 
*xrAlYlYasWAnamunuMdi/xrAlYlasWAnamunuMdi/xrAlYlasWAnaMnuMdi/xrAlYlaswAnaMnuMdi/xrAlYlaswAnamunuMdi/xrAlYlasWAnamunuMci/xrAlYlasWAnamuniMci/xrAlYlaswAnaMniMci/xrAlYlaswAnaMnuMci/xrAlYlasWAnaMlonuMdi/xrAlYlaswAnamulonuMdi/xrAlYlasWAnaMlonuMci/xrAlYlasWAnaMloniMci/xrAlYlaswAnamuloniMci/xrAlYlaswAnamulonuMci	n number bahu parsarg sWAnaMnuMdi 
*xrAlYlYayaMxu/xrAlYlayaMxu/xrAlYlaMxu	n number bahu parsarg aMxu 
*xrAlYlYaMte/xrAlYlaMte/xrAlYlaMteV	n number bahu parsarg aMte 
*xrAlYlYakaMteV/xrAlYlakaMteV/xrAlYlakaMte/xrAlYlakanna/xrAlYlakannA	n number bahu parsarg kaMteV 
*xrAlYlYEna/xrAlYlEna	n number bahu parsarg Ena 
*xrAlYlYapAti/xrAlYlapAti	n number bahu parsarg pAti 
*xrAlYlYalAMti/xrAlYlalAMti/xrAlYlalAti	n number bahu parsarg lAMti 
*xrAlYlugAnI/xrAlYlugAnI/xrAlYlukAnI	n number bahu parsarg gAni 
*xrAlYlYugA/xrAlYlugA	n number bahu parsarg gA 
