noun	
illu	
*illu	n number eka parsarg 0  case d
-	n number eka parsarg I 
-	n number eka parsarg gA 
*iMtigAdu	n number eka parsarg gAdu  case d
*iMtigawweV	n number eka parsarg gawweV  case d
*iMtivAdu	n number eka parsarg vAdu  case d
*iMtAyana	n number eka parsarg Ayana  case d
*iMtivAru	n number eka parsarg vAru  case d
*iMtixi	n number eka parsarg xi  case d
*iMtivi/iMtiy	n number eka parsarg vi  case d
*illugAru	n number eka parsarg gAru  case d
*illunu	n number eka parsarg nu 
*iMtivi	n number eka parsarg vu  case d
*iMtiyoVkka	n number eka parsarg yoVkka 
*iMti	n number eka parsarg obl 
*iMtini/illunu	n number eka parsarg ni 
*iMtiki/illuku	n number eka parsarg ki 
*iMtiwo/iMtiwoda/iMtiwoti/illuwoti/illuwo	n number eka parsarg wo 
iMtilo/iMtilona/iMtlo/iMtlona/*iMtilopala/iMtlopala/illulo	n number eka parsarg lo 
*iMtiloni/iMtloni/iMtilopali/iMtlopali	n number eka parsarg loni 
*iMtimIxa	n number eka parsarg mIxa 
iMtina/*iMta	n number eka parsarg na 
iMtiniMci/iMtinuMci/*iMtinuMdi	n number eka parsarg niMci 
*iMtixvArA/iMtixvAra	n number eka parsarg xvArA 
*iMtivalana/iMtivalla	n number eka parsarg valana 
*iMtinibatti	n number eka parsarg batti 
iMtice/*iMticewa	n number eka parsarg ce 
*iMtiwopAtu	n number eka parsarg wopAtu 
*iMtiwokUdi/iMtiwokUda/iMtiwokUdA/illuwokUdA/iMtiwogUdi/iMtiwogUda/iMtiwogUdA/illuwogUdA	n number eka parsarg wokUdi 
*iMtikosaM/iMtikE/illukosaM/illukosamu/iMtArWaM	n number eka parsarg kosaM 
*iMtikoVraku/iMtikoVrYaku	n number eka parsarg koVraku 
*iMtilonuMdi/iMtilonuMci/iMtiloniMci/iMtlonuMdi/iMtlonuMci/iMtloniMci/iMtloMci	n number eka parsarg lonuMdi 
*iMtimIxanuMdi/iMtimIxanuMci/iMtimIxaniMci	n number eka parsarg mIxanuMdi 
*iMtixAkA/iMtixAka	n number eka parsarg xAkA 
*iMtivaraku	n number eka parsarg varaku 
*iMtimIxaki/iMtimIxaku/iMtimIxiki	n number eka parsarg mIxaki 
*iMtixaggara/iMtixaggira	n number eka parsarg xaggara 
*iMtivaxxa/iMtoVxxa	n number eka parsarg vaxxa 
*iMtikAda	n number eka parsarg kAda 
*iMtikeVxurugA/illeVxurugA/iMteVxurugA	n number eka parsarg keVxurugA 
*iMtimuMxu	n number eka parsarg muMxu 
*iMtiguriMci/iMtiniguriMci/iMtinigUrci/illunuguriMci/illunugUrci	n number eka parsarg guriMci 
iMtipE/*iMtipEna/iMtipEni	n number eka parsarg pE 
*iMtipEki	n number eka parsarg pEki 
*iMtiguMdA	n number eka parsarg guMdA 
iMtilA/illulA/illulAga/*illulAgA/iMtilAga/iMtilAgA	n number eka parsarg lA 
iMtivale/iMtivaleV/iMtimAxiri/iMtinipoli/*iMtinibolina	n number eka parsarg vale 
*iMtikimalle/iMtikimalleV	n number eka parsarg kimalle 
iMtikUdA/iMtinikUdA/*illunukUdA/iMtigUdA/iMtinigUdA/illunugUdA	n number eka parsarg kUdA 
*iMtixqRtilo/iMtixruRtilo	n number eka parsarg xqRtilo 
*illulekuMdA/iMtinilekuMdA/illulekuMda/illuleka	n number eka parsarg lekuMdA 
*illukAkuMdA/iMtinikAkuMdA/illugAkuMda/illugAka	n number eka parsarg kAkuMdA 
*illumoVxalukoVni/iMtinimoVxalukoVni/iMtinumoVxalukoVni	n number eka parsarg moVxalukoVni 
*iMtivEpu/iMtivepu/iMtikesi	n number eka parsarg vEpu 
iMtipakka/*iMtiprakka/iMtipakkana/iMtiprakkana/iMtipakkani	n number eka parsarg pakka 
iMtipakkalo/*iMtiprakkalo/iMtipakkalona/iMtipakkaloni	n number eka parsarg pakkalo 
iMtiloki/iMtiloniki/iMtloki/iMtloniki/iMtilopalaku/illulopalaku/*iMtilopalaki/illulopaliki/iMtilopaliki	n number eka parsarg lopalaki 
iMtikiMxa/*iMtikriMxa/iMtikriMxana/iMtikiMxana	n number eka parsarg kiMxa 
illaduguna/*iMtikaduguna	n number eka parsarg aduguna 
iMtikeVlla/*iMtikalla	n number eka parsarg kalla 
iMtiveVnuka/*iMtiveVnakAla/iMtiveVnakAwala/iMtiveVnakana	n number eka parsarg veVnuka 
iMtiwaravAwa/iMtiwarvAwa/*iMtiwaruvAwa/iMtiwaravAwana/iMtiwarvAwana/iMtiwaruvAwana	n number eka parsarg waravAwa 
illeVxuruguMdA/*iMtikeVxuruguMdA	n number eka parsarg eVxuruguMdA 
*iMtimaXya/iMtimaXyalo/iMtimaXyana	n number eka parsarg maXya 
*iMtinaduma/iMtinadumana	n number eka parsarg naduma 
illubaxulugA/iMtibaxulu/*iMtikibaxulu/iMtikubaxulu	n number eka parsarg baxulugA 
*iMticotlo/iMticotulo/iMticotuna/iMticota	n number eka parsarg cotlo 
*iMtisWAnaMlo/iMtiswAnaMlo	n number eka parsarg sWAnaMlo 
iMtinerugA/iMtikunerugA/*iMtikinerugA	n number eka parsarg nerugA 
*iMtiprakAraM/iMtiprakAramu	n number eka parsarg prakAraM 
*iMtixaggaranuMdi/iMtixaggaranuMci/iMtixaggiranuMdi/iMtixaggiranuMci	n number eka parsarg xaggaranuMdi 
*iMtivaxxanuMdi/iMtivaxxanuMci/iMtivaxxaniMci	n number eka parsarg vaxxanuMdi 
*iMtipakkanuMdi/iMtipakkanuMci/iMtipakkaniMci/iMtipakkalonuMdi/iMtipakkalonuMci/iMtipakkaloniMci	n number eka parsarg pakkanuMdi 
*iMtilopalanuMdi/iMtilopalnuMdi/iMtilopalanuMci/iMtilopalnuMci/iMtilopalaniMci	n number eka parsarg lopalanuMdi 
*iMtibEtanuMdi/iMtibEtanuMci/iMtibEtaniMci	n number eka parsarg bEtanuMdi 
*iMtipEnuMdi/iMtipEnuMci/iMtipEniMci	n number eka parsarg pEnuMdi 
iMtikiMxanuMdi/iMtikiMxanuMci/iMtikiMxaniMci/*iMtikriMxanuMdi/iMtikriMxanuMci/iMtikriMxaniMci	n number eka parsarg kriMxanuMdi 
illadugunuMdi/illadugunuMci/*iMtikadugunuMdi/iMtikadugunuMci/iMtikaduguniMci	n number eka parsarg adugunuMdi 
*iMtimuMxunuMdi/iMtimuMxunuMci/iMtimuMxuniMci	n number eka parsarg muMxunuMdi 
iMtiveVnukanuMdi/*iMtiveVnakAlanuMdi/iMtiveVnakAwalanuMdi/iMtiveVnakanuMdi/iMtiveVnukanuMci/*iMtiveVnakAlanuMci/iMtiveVnakAwalanuMci/iMtiveVnakanuMci	n number eka parsarg veVnukanuMdi 
illeVxutinuMdi/iMtikeVxutinuMdi/iMtikeVxutinuMci/illeVxutinuMci/illeVxutanuMdi/*iMtikeVxutanuMdi/iMtikeVxutanuMci/illeVxutanuMci	n number eka parsarg eVxutinuMdi 
*iMtimaXyanuMdi/iMtimaXyanuMci/iMtimaXyalonuMdi/iMtimaXyalonuMci	n number eka parsarg maXyanuMdi 
*iMtinadumanuMdi/iMtinadumanuMci	n number eka parsarg nadumanuMdi 
*iMtiwaravAwanuMdi/iMtiwarvAwanuMdi/iMtiwaravAwanuMci/iMtiwarvAwanuMci	n number eka parsarg waravAwanuMdi 
*iMticotlonuMdi/iMticotunuMdi/iMticotlonuMci/iMticotunuMci	n number eka parsarg cotlonuMdi 
iMtisWAnaMnuMdi/*iMtisWAnamunuMdi/iMtisWAnaMnuMci/iMtisWAnamunuMci/iMtisWAnaMlonuMdi/iMtisWAnamulonuMdi/iMtisWAnaMlonuMci/iMtisWAnamulonuMci	n number eka parsarg sWAnaMnuMdi 
illaMxu/iMtinaMxu/*iMtiyaMxu	n number eka parsarg aMxu 
*illaMte/illaMteV	n number eka parsarg aMte 
*iMtikaMteV/iMtikaMte/illukannA/illukanna/iMtikannA/iMtikanna	n number eka parsarg kaMteV 
*illEna	n number eka parsarg Ena 
*illupAti/iMtipAti	n number eka parsarg pAti 
iMtilAMti/illulAti/*illulAMti	n number eka parsarg lAMti 
*illugAnI/illukAnI	n number eka parsarg gAni 
*illugA	n number eka parsarg gA 
*ilYlYu/ilYlu/iMdlu	n number bahu parsarg 0  case d
ilYlulArA/*ilYlYU/ilYlU/iMdlulArA/iMdlU	n number bahu parsarg I  case d
-	n number bahu parsarg gA 
*ilYlYagAdu/ilYlagAdu/iMdlagAdu	n number bahu parsarg gAdu  case d
*ilYlYagawweV/ilYlagawweV/iMdlagawweV	n number bahu parsarg gawweV  case d
*ilYlYavAdu/ilYlavAdu/ilYlodu/iMdlavAdu/iMdlodu	n number bahu parsarg vAdu  case d
*ilYlYAyana/ilYlAyana/iMdlAyana	n number bahu parsarg Ayana  case d
*ilYlYavAru/ilYlavAru/ilYloru/iMdlavAru/iMdloru	n number bahu parsarg vAru  case d
*ilYlYaxi/ilYlaxi/iMdlaxi	n number bahu parsarg xi  case d
*ilYlYavi/ilYlavi/ilYlay/iMdlavi/iMdlay	n number bahu parsarg vi  case d
*ilYlYagAru/ilYlagAru/iMdlagAru	n number bahu parsarg gAru  case d
*ilYlYaM/ilYlaM/ilYlamu/iMdlaM/iMdlamu	n number bahu parsarg nu  case d
-	n number bahu parsarg vu 
iMdlayoVkka/*ilYlYayoVkka/ilYlayoVkka	n number bahu parsarg yoVkka 
*ilYlYa/ilYla/iMdla	n number bahu parsarg obl 
*ilYlYani/ilYlani/ilYlanu/iMdlani/iMdlanu/illulni	n number bahu parsarg ni 
*ilYlYaki/ilYlaki/ilYlaku/iMdlaki/iMdlaku	n number bahu parsarg ki 
*ilYlYawo/ilYlawo/ilYlawoda/ilYlawoti/iMdlawo/iMdlawoda/iMdlawoti	n number bahu parsarg wo 
ilYlalo/ilYlallo/ilYlallona/*ilYlYalopala/ilYlalopala/iMdlalo/iMdlallo/iMdlallona/iMdlalona/iMdlalopala	n number bahu parsarg lo 
ilYlalloni/*ilYlYalopali/ilYlalopali/iMdlalloni/iMdlaloni/iMdlalopali/iMdlayaMxali	n number bahu parsarg loni 
*ilYlYamIxa/iMdlamIxa	n number bahu parsarg mIxa 
*ilYlYana/ilYlana/iMdlana	n number bahu parsarg na 
ilYlaniMci/ilYlanuMci/*ilYlYanuMdi/ilYlanuMdi/iMdlaniMci/iMdlanuMci/iMdlanuMdi	n number bahu parsarg niMci 
*ilYlYaxvArA/ilYlaxvArA/ilYlaxvAra/iMdlaxvArA/iMdlaxvAra	n number bahu parsarg xvArA 
*ilYlYavalana/ilYlavalana/ilYlavalla/iMdlavalana/iMdlavalla	n number bahu parsarg valana 
*ilYlYanubatti/ilYlanubatti/iMdlanubatti	n number bahu parsarg batti 
*ilYlYacewa/ilYlacewa/ilYlace/iMdlacewa/iMdlace	n number bahu parsarg ce 
*ilYlYawopAtu/ilYlawopAtu/ilYlawobAtu/iMdlawopAtu/iMdlawobAtu	n number bahu parsarg wopAtu 
*ilYlYawokUdi/ilYlawokUdi/ilYlawogUdi/ilYlawokUda/ilYlawogUdA/ilYlawokUdA/iMdlawokUdi/iMdlawogUdi/iMdlawokUda/iMdlawogUdA/iMdlawokUdA	n number bahu parsarg wokUdi 
*ilYlYakosaM/ilYlakosaM/ilYlakE/iMdlakosaM/iMdlakE/ilYlArWaM	n number bahu parsarg kosaM 
*ilYlYakoVraku/ilYlakoVraku/ilYlakoVrYaku/iMdlakoVraku/iMdlakoVrYaku	n number bahu parsarg koVraku 
*ilYlYalonuMdi/ilYlalonuMdi/ilYlalonuMci/ilYlaloniMci/iMdlalonuMdi/iMdlalonuMci/iMdlalonuMdi/iMdlalonuMci/iMdlaloniMci/iMdlaloniMci	n number bahu parsarg lonuMdi 
*ilYlYamIxanuMdi/ilYlamIxanuMdi/ilYlamIxanuMci/ilYlamIxaniMci/iMdlamIxanuMdi/iMdlamIxanuMci/iMdlamIxaniMci	n number bahu parsarg mIxanuMdi 
*ilYlYaxAkA/ilYlaxAkA/ilYlaxAka/iMdlaxAkA/iMdlaxAka	n number bahu parsarg xAkA 
*ilYlYavaraku/ilYlavaraku/iMdlavaraku	n number bahu parsarg varaku 
*ilYlYamIxaki/ilYlamIxaki/ilYlamIxaku/ilYlamIxiki/iMdlamIxaki/iMdlamIxaku/iMdlamIxiki	n number bahu parsarg mIxaki 
*ilYlYaxaggara/ilYlaxaggara/ilYlaxaggira/iMdlaxaggara/iMdlaxaggira	n number bahu parsarg xaggara 
*ilYlYavaxxa/ilYlavaxxa/ilYloVxxa/iMdlavaxxa/iMdloVxxa	n number bahu parsarg vaxxa 
*ilYlYakAda/ilYlakAda/iMdlakAda	n number bahu parsarg kAda 
ilYleVxurugA/*ilYlYakeVxurugA/ilYlakeVxurugA/iMdleVxurugA/iMdlakeVxurugA	n number bahu parsarg keVxurugA 
*ilYlYamuMxu/ilYlamuMxu/iMdlamuMxu	n number bahu parsarg muMxu 
*ilYlYaguriMci/ilYlaguriMci/ilYlagUrci/ilYlanuguriMci/ilYlanigUrci/iMdlaguriMci/iMdlagUrci/iMdlanuguriMci/iMdlanigUrci	n number bahu parsarg guriMci 
ilYlapE/ilYlapEni/*ilYlYapEna/ilYlapEna/iMdlapE/iMdlapEni/iMdlapEna	n number bahu parsarg pE 
*ilYlYapEki/ilYlapEki/iMdlapEki	n number bahu parsarg pEki 
*ilYlYaguMdA/ilYlaguMdA/iMdlaguMdA	n number bahu parsarg guMdA 
ilYlalA/ilYlalAga/*ilYlYalAgA/ilYlalAgA/iMdlalA/iMdlalAga/iMdlalAgA	n number bahu parsarg lA 
*ilYlYavale/ilYlavale/ilYlavaleV/ilYlamAxiri/ilYlanupoli/ilYlanubolina/iMdlavale/iMdlavaleV/iMdlamAxiri/iMdlanupoli/iMdlanubolina	n number bahu parsarg vale 
*ilYlYakumalle/ilYlakumalle/ilYlakumalleV/iMdlakumalle/iMdlakumalleV	n number bahu parsarg kimalle 
ilYlanukUdA/*ilYlYukUdA/ilYlukUdA/ilYlugUdA/ilYlanugUdA/iMdlanukUdA/iMdlukUdA/iMdlugUdA/iMdlanugUdA	n number bahu parsarg kUdA 
*ilYlYaxqRtilo/ilYlaxqRtilo/ilYlaxruRtilo/iMdlaxqRtilo/iMdlaxruRtilo	n number bahu parsarg xqRtilo 
*ilYlYulekuMdA/ilYlulekuMdA/ilYlanulekuMdA/ilYluleka/iMdlulekuMdA/iMdlanulekuMdA/iMdluleka	n number bahu parsarg lekuMdA 
*ilYlYukAkuMdA/ilYlukAkuMdA/ilYlukAkuMda/ilYlukAka/ilYlugAkuMdA/ilYlugAkuMda/ilYlugAka/iMdlukAkuMdA/iMdlukAkuMda/iMdlukAka/iMdlugAkuMdA/iMdlugAkuMda/iMdlugAka	n number bahu parsarg kAkuMdA 
*ilYlYumoVxalukoVni/ilYlumoVxalukoVni/ilYlanumoVxalukoVni/iMdlumoVxalukoVni/iMdlanumoVxalukoVni	n number bahu parsarg moVxalukoVni 
*ilYlYavEpu/ilYlavEpu/ilYlavepu/ilYlakesi/iMdlavEpu/iMdlavepu/iMdlakesi	n number bahu parsarg vEpu 
ilYlapakka/ilYlapakkana/ilYlaprakka/*ilYlYaprakkana/ilYlaprakkana/iMdlapakka/iMdlapakkana/iMdlaprakka/iMdlaprakkana	n number bahu parsarg pakka 
ilYlapakkalo/*ilYlYaprakkalo/ilYlaprakkalo/iMdlapakkalo/iMdlaprakkalo	n number bahu parsarg pakkalo 
ilYlaloki/ilYlaloniki/iMdlaloki/iMdlaloniki/ilYlalopalaku/*ilYlYalopaliki/ilYlalopaliki/iMdlalopalaku/iMdlalopaliki	n number bahu parsarg lopalaki 
ilYlakiMxa/*ilYlYakriMxa/ilYlakriMxa/iMdlakiMxa/iMdlakriMxa/ilYlakriMxane/ilYlakiMxane/iMdlakriMxane/iMdlakiMxane	n number bahu parsarg kiMxa 
ilYladuguna/*ilYlYakaduguna/ilYlakaduguna/iMdladuguna/iMdlakaduguna	n number bahu parsarg aduguna 
ilYlakeVlla/*ilYlYakalla/ilYlakalla/iMdlakeVlla/iMdlakalla	n number bahu parsarg kalla 
ilYlaveVnuka/ilYlaveVnaka/*ilYlYaveVnakAla/ilYlaveVnakAla/ilYlaveVnukAla/ilYlaveVnakAwala/ilYlaveVnukAwala/iMdlaveVnuka/iMdlaveVnaka/iMdlaveVnakAla/iMdlaveVnukAla/iMdlaveVnakAwala/iMdlaveVnukAwala	n number bahu parsarg veVnuka 
*ilYlYawaravAwa/ilYlawaravAwa/ilYlawarvAwa/iMdlawarvAwa/iMdlawaravAwa	n number bahu parsarg waravAwa 
ilYleVxuruguMdA/*ilYlYakeVxuruguMdA/ilYlakeVxuruguMdA/iMdleVxuruguMdA/iMdlakeVxuruguMdA	n number bahu parsarg eVxuruguMdA 
*ilYlYamaXya/ilYlamaXya/ilYlamaXyana/ilYlamaXyalo/iMdlamaXya/iMdlamaXyana/iMdlamaXyalo	n number bahu parsarg maXya 
*ilYlanaduma/ilYlanaduma/ilYlakinaduma/iMdlanaduma/iMdlakinaduma	n number bahu parsarg naduma 
ilYlabaxulugA/ilYlakibaxulugA/ilYlabaxulu/*ilYlYakibaxulu/ilYlakibaxulu/ilYlnubaxulu/iMdlabaxulugA/iMdlakibaxulugA/iMdlabaxulu/iMdlakibaxulu/iMdlakubaxulu/iMdlanubaxulu	n number bahu parsarg baxulugA 
*ilYlYacotlo/ilYlacotlo/ilYlacotulo/iMdlacotlo/iMdlacotulo	n number bahu parsarg cotlo 
ilYlasWAnaMlo/ilYlaswAnaMlo/*ilYlYasWAnamulo/ilYlasWAnamulo/iMdlasWAnaMlo/iMdlaswAnaMlo/iMdlasWAnamulo	n number bahu parsarg sWAnaMlo 
ilYlanerugA/ilYlakunerugA/*ilYlYakinerugA/ilYlakinerugA/iMdlanerugA/iMdlakunerugA/iMdlakinerugA	n number bahu parsarg nerugA 
*ilYlYaprakAraM/ilYlaprakAraM/ilYlanubatti/ilYlabatti/ilYlanibatti/iMdlaprakAraM/iMdlanubatti/iMdlabatti/iMdlanibatti	n number bahu parsarg prakAraM 
*ilYlYaxaggaranuMdi/ilYlaxaggaranuMdi/ilYlaxaggiranuMdi/ilYlaxaggaranuMci/ilYlaxaggiranuMci/iMdlaxaggaranuMdi/iMdlaxaggiranuMdi/iMdlaxaggaranuMci/iMdlaxaggiranuMci	n number bahu parsarg xaggaranuMdi 
*ilYlYavaxxanuMdi/ilYlavaxxanuMdi/ilYlavaxxanuMci/iMdlavaxxanuMdi/iMdlavaxxanuMci	n number bahu parsarg vaxxanuMdi 
*ilYlYapakkanuMdi/ilYlapakkanuMdi/ilYlapakkanuMci/iMdlapakkanuMdi/iMdlapakkanuMci/ilYlapakkalonuMdi/ilYlapakkalonuMci/iMdlapakkalonuMdi/iMdlapakkalonuMci	n number bahu parsarg pakkanuMdi 
*ilYlYalopalanuMdi/ilYlalopalanuMdi/ilYlalopalanuMci/ilYlalopalinuMdi/ilYlalopalinuMci/iMdlalopalanuMdi/iMdlalopalanuMci/iMdlalopalinuMdi/iMdlalopalinuMci	n number bahu parsarg lopalanuMdi 
*ilYlYabEtanuMdi/ilYlabEtanuMdi/ilYlabEtanuMci/ilYlabEtaniMci/iMdlabEtanuMdi/iMdlabEtanuMci/iMdlabEtaniMci	n number bahu parsarg bEtanuMdi 
*ilYlapEnuMdi/ilYlapEnuMdi/ilYlapEnuMci/ilYlapEniMci/iMdlapEnuMdi/iMdlapEnuMci/iMdlapEniMci	n number bahu parsarg pEnuMdi 
ilYlYakiMxanuMdi/ilYlakiMxanuMdi/ilYlakiMxanuMci/ilYlakiMxaniMci/iMdlakiMxanuMdi/iMdlakiMxanuMci/iMdlakiMxaniMci/*ilYlYakriMxanuMdi/ilYlakriMxanuMdi/ilYlakriMxanuMci/ilYlakriMxaniMci/iMdlakriMxanuMdi/iMdlakriMxanuMci/iMdlakriMxaniMci	n number bahu parsarg kriMxanuMdi 
*ilYlYadugunuMdi/ilYladugunuMdi/ilYladugunuMci/ilYladuguniMci/iMdladugunuMdi/iMdladugunuMci/iMdladuguniMci	n number bahu parsarg adugunuMdi 
*ilYlYamuMxunuMdi/ilYlamuMxunuMdi/ilYlamuMxunuMci/ilYlamuMxuniMci/iMdlamuMxunuMdi/iMdlamuMxunuMci/iMdlamuMxuniMci	n number bahu parsarg muMxunuMdi 
ilYlaveVnukanuMdi/ilYlaveVnakanuMdi/*ilYlYaveVnakAlanuMdi/ilYlaveVnakAlanuMdi/iMdlaveVnukanuMdi/iMdlaveVnakanuMdi/iMdlaveVnakAlanuMdi/ilYlaveVnakAlanuMci/ilYlaveVnukanuMci/ilYlaveVnakanuMci/ilYlaveVnakAwalanuMdi/ilYlaveVnakAwalanuMci/iMdlaveVnakAlanuMci/iMdlaveVnukanuMci/iMdlaveVnakanuMci/iMdlaveVnakAwalanuMdi/iMdlaveVnakAwalanuMci	n number bahu parsarg veVnukanuMdi 
ilYleVxutinuMdi/ilYlakeVxutinuMdi/ilYleVxutanuMdi/*ilYlYakeVxutanuMdi/ilYlakeVxutanuMdi/ilYleVxutinuMci/ilYlakeVxutinuMci/ilYleVxutanuMci/ilYlakeVxutanuMci/iMdleVxutinuMdi/iMdlakeVxutinuMdi/iMdleVxutanuMdi/iMdlakeVxutanuMdi/iMdleVxutinuMci/iMdlakeVxutinuMci/iMdleVxutanuMci/iMdlakeVxutanuMci	n number bahu parsarg eVxutinuMdi 
*ilYlYamaXyanuMdi/ilYlamaXyanuMdi/ilYlamaXyanuMci/ilYlamaXyaniMci/iMdlamaXyanuMdi/iMdlamaXyanuMci/iMdlamaXyaniMci/ilYlamaXyalonuMdi/ilYlamaXyalonuMci/ilYlamaXyaloniMci/iMdlamaXyalonuMdi/iMdlamaXyalonuMci/iMdlamaXyaloniMci	n number bahu parsarg maXyanuMdi 
*ilYlYanadumanuMdi/ilYlanadumanuMdi/ilYlanadamanuMdi/ilYlanadumanuMci/ilYlanadumaniMci/ilYlanadamanuMci/iMdlanadumanuMdi/iMdlanadamanuMdi/iMdlanadumanuMci/iMdlanadumaniMci/iMdlanadamanuMci	n number bahu parsarg nadumanuMdi 
*ilYlYawaravAwanuMdi/ilYlawaravAwanuMdi/ilYlawarvAwanuMdi/ilYlawaravAwanuMci/ilYlawarvAwanuMci/iMdlawaravAwanuMdi/iMdlawarvAwanuMdi/iMdlawaravAwanuMci/iMdlawarvAwanuMci	n number bahu parsarg waravAwanuMdi 
ilYlacotunuMdi/ilYlacotunuMci/ilYlacotlonuMci/ilYlacotloniMci/*ilYlYacotlonuMdi/ilYlacotlonuMdi/iMdlacotunuMdi/iMdlacotunuMci/iMdlacotlonuMci/iMdlacotloniMci/iMdlacotlonuMdi	n number bahu parsarg cotlonuMdi 
*ilYlYasWAnamunuMdi/ilYlasWAnamunuMdi/ilYlasWAnaMnuMdi/ilYlasWAnamunuMci/ilYlasWAnaMnuMci/iMdlasWAnamunuMdi/iMdlasWAnaMnuMdi/iMdlasWAnamunuMci/iMdlasWAnaMnuMci/ilYlasWAnaMlonuMdi/ilYlasWAnamulonuMdi/iMdlasWAnaMlonuMdi/iMdlasWAnamulonuMdi/ilYlasWAnaMlonuMci/ilYlasWAnamulonuMci/iMdlasWAnaMlonuMci/iMdlasWAnamulonuMci	n number bahu parsarg sWAnaMnuMdi 
*ilYlYayaMxu/ilYlayaMxu/ilYlaMxu/iMdlayaMxu/iMdlaMxu	n number bahu parsarg aMxu 
*ilYlYaMte/ilYlaMte/ilYlaMteV/iMdlaMte/iMdlaMteV	n number bahu parsarg aMte 
*ilYlYakaMteV/ilYlakaMteV/ilYlakaMte/ilYlakanna/ilYlakannA/iMdlakaMteV/iMdlakaMte/iMdlakanna/iMdlakannA	n number bahu parsarg kaMteV 
*ilYlYEna/ilYlEna/iMdlEna	n number bahu parsarg Ena 
*ilYlYapAti/ilYlapAti/iMdlapAti	n number bahu parsarg pAti 
*ilYlYalAMti/ilYlalAMti/ilYlalAti/iMdlalAMti/iMdlalAti	n number bahu parsarg lAMti 
*ilYlYugAnI/ilYlugAnI/ilYlukAnI/iMdlugAnI/iMdlukAnI	n number bahu parsarg gAni 
*ilYlYugA/ilYlugA/iMdlugA	n number bahu parsarg gA 
